ts,avg_nb_vehicules_in_per_hour,nb_trucks_in,nb_cars_in,avg_waiting_in,avg_nb_vehicules_out_per_hour,nb_trucks_out,nb_cars_out,avg_waiting_out,avg_temperature,pressure,precipitation_MM,windspeed_Kmph
2020-01-01 00:00:00+01:00,69,8,61,8.03614801962393,60,6,54,13.20628140081713,4,1032,0.0,6
2020-01-01 01:00:00+01:00,45,5,40,6.873871357402149,43,4,39,7.555366152542149,4,1032,0.0,6
2020-01-01 02:00:00+01:00,45,6,39,6.873871357402149,43,4,39,7.555366152542149,4,1032,0.0,6
2020-01-01 03:00:00+01:00,69,9,60,8.03614801962393,60,6,54,13.20628140081713,4,1032,0.0,6
2020-01-01 04:00:00+01:00,116,14,102,18.218284224266565,102,10,92,15.767603823718561,4,1032,0.0,6
2020-01-01 05:00:00+01:00,204,26,178,18.97564860124531,207,25,182,19.46313193794564,4,1032,0.0,6
2020-01-01 06:00:00+01:00,255,29,226,18.276992505016963,236,28,208,11.423053117408324,4,1032,0.0,6
2020-01-01 07:00:00+01:00,393,45,348,11.209446952834304,381,43,338,20.33707664399945,4,1032,0.0,6
2020-01-01 08:00:00+01:00,413,49,364,19.953327551024692,386,45,341,23.082433245575533,4,1032,0.0,6
2020-01-01 09:00:00+01:00,277,32,245,22.842683015901265,266,25,241,19.44559969107549,4,1032,0.0,6
2020-01-01 10:00:00+01:00,227,26,201,21.978956980369183,222,27,195,23.940731731626443,4,1032,0.0,6
2020-01-01 11:00:00+01:00,278,34,244,21.643694281450568,266,25,241,19.44559969107549,4,1032,0.0,6
2020-01-01 12:00:00+01:00,227,26,201,21.978956980369183,222,27,195,23.940731731626443,4,1032,0.0,6
2020-01-01 13:00:00+01:00,233,29,204,22.38619160570368,205,20,185,18.29833304368066,4,1032,0.0,6
2020-01-01 14:00:00+01:00,233,31,202,22.38619160570368,205,20,185,18.29833304368066,4,1032,0.0,6
2020-01-01 15:00:00+01:00,257,34,223,23.082421553922877,236,28,208,11.423053117408324,4,1032,0.0,6
2020-01-01 16:00:00+01:00,277,32,245,22.842683015901265,266,25,241,19.44559969107549,4,1032,0.0,6
2020-01-01 17:00:00+01:00,388,46,342,18.513167788987648,388,49,339,18.513167788987648,4,1032,0.0,6
2020-01-01 18:00:00+01:00,419,57,362,14.863975805015587,413,48,365,19.953327551024692,4,1032,0.0,6
2020-01-01 19:00:00+01:00,298,39,259,21.055661887973457,280,33,247,24.45889409905205,4,1032,0.0,6
2020-01-01 20:00:00+01:00,300,34,266,17.719869170359154,289,31,258,21.030269491813637,4,1032,0.0,6
2020-01-01 21:00:00+01:00,229,26,203,20.440115346834332,207,25,182,19.46313193794564,4,1032,0.0,6
2020-01-01 22:00:00+01:00,162,18,144,16.65184232996673,154,17,137,25.102227050596255,4,1032,0.0,6
2020-01-01 23:00:00+01:00,116,15,101,18.218284224266565,102,10,92,15.767603823718561,4,1032,0.0,6
2020-01-02 00:00:00+01:00,68,5,63,14.701855472363336,81,12,69,16.076626545182606,7,1029,0.0,6
2020-01-02 01:00:00+01:00,51,4,47,7.252205043556333,51,7,44,7.252205043556333,7,1029,0.0,6
2020-01-02 02:00:00+01:00,46,3,43,9.245167395738047,53,6,47,8.976459755768028,7,1029,0.0,6
2020-01-02 03:00:00+01:00,76,6,70,16.686685835236233,76,12,64,16.686685835236233,7,1029,0.0,6
2020-01-02 04:00:00+01:00,119,10,109,22.46945513312648,128,18,110,19.601953989978306,7,1029,0.0,6
2020-01-02 05:00:00+01:00,219,16,203,21.009686825041197,234,28,206,19.754580108435302,7,1029,0.0,6
2020-01-02 06:00:00+01:00,258,21,237,21.93153719781745,277,36,241,24.920160895876304,7,1029,0.0,6
2020-01-02 07:00:00+01:00,442,37,405,20.352399635415985,437,56,381,22.67431624563715,7,1029,0.0,6
2020-01-02 08:00:00+01:00,465,36,429,19.650501243200726,459,57,402,21.314720332142485,7,1029,0.0,6
2020-01-02 09:00:00+01:00,296,23,273,20.454116986907042,324,45,279,20.507764200909268,7,1029,0.0,6
2020-01-02 10:00:00+01:00,271,22,249,24.814459053724722,269,33,236,17.49919499982951,7,1029,0.0,6
2020-01-02 11:00:00+01:00,292,22,270,18.509650933155072,301,45,256,16.897732473063776,7,1029,0.0,6
2020-01-02 12:00:00+01:00,239,18,221,13.74553452780325,273,43,230,23.61851837889036,7,1029,0.0,6
2020-01-02 13:00:00+01:00,249,19,230,20.976233072746222,262,36,226,18.255168653975332,7,1029,0.0,6
2020-01-02 14:00:00+01:00,275,24,251,24.67224255888931,264,42,222,20.665980174270672,7,1029,0.0,6
2020-01-02 15:00:00+01:00,266,20,246,24.416240816629376,286,39,247,20.398524223626136,7,1029,0.0,6
2020-01-02 16:00:00+01:00,307,27,280,19.62844127124222,305,47,258,19.342371998402466,7,1029,0.0,6
2020-01-02 17:00:00+01:00,405,31,374,18.172278090342537,429,69,360,21.355504409446556,7,1029,0.0,6
2020-01-02 18:00:00+01:00,493,38,455,23.14736404920122,480,77,403,21.905802263169644,7,1029,0.0,6
2020-01-02 19:00:00+01:00,337,30,307,21.494538760895587,354,46,308,21.22371738501729,7,1029,0.0,6
2020-01-02 20:00:00+01:00,343,27,316,18.604951737824955,350,42,308,21.39774246689966,7,1029,0.0,6
2020-01-02 21:00:00+01:00,247,20,227,18.30797612224211,249,30,219,20.976233072746222,7,1029,0.0,6
2020-01-02 22:00:00+01:00,179,14,165,19.18236787964663,187,28,159,20.5323189366488,7,1029,0.0,6
2020-01-02 23:00:00+01:00,117,9,108,21.891304075969387,134,18,116,14.701306049248211,7,1029,0.0,6
2020-01-03 00:00:00+01:00,46,4,42,9.245167395738047,47,4,43,10.718407092962304,10,1024,0.0,18
2020-01-03 01:00:00+01:00,29,2,27,3.1672610972900266,28,2,26,4.026144260024548,10,1024,0.0,18
2020-01-03 02:00:00+01:00,29,2,27,3.1672610972900266,28,2,26,4.026144260024548,10,1024,0.0,18
2020-01-03 03:00:00+01:00,44,4,40,6.744796902616623,47,4,43,10.718407092962304,10,1024,0.0,18
2020-01-03 04:00:00+01:00,76,7,69,16.686685835236233,74,8,66,19.513800836509724,10,1024,0.0,18
2020-01-03 05:00:00+01:00,142,14,128,21.623487252479663,143,14,129,22.510370466296816,10,1024,0.0,18
2020-01-03 06:00:00+01:00,167,17,150,21.39117903937357,169,16,153,18.567569965901342,10,1024,0.0,18
2020-01-03 07:00:00+01:00,264,28,236,20.665980174270672,258,23,235,21.93153719781745,10,1024,0.0,18
2020-01-03 08:00:00+01:00,273,25,248,23.61851837889036,283,24,259,21.015453076893927,10,1024,0.0,18
2020-01-03 09:00:00+01:00,184,17,167,20.655558446800804,182,15,167,17.128604685093855,10,1024,0.0,18
2020-01-03 10:00:00+01:00,153,13,140,14.915022999208679,154,13,141,23.457384968254527,10,1024,0.0,18
2020-01-03 11:00:00+01:00,182,19,163,17.128604685093855,182,15,167,17.128604685093855,10,1024,0.0,18
2020-01-03 12:00:00+01:00,153,13,140,14.915022999208679,154,13,141,23.457384968254527,10,1024,0.0,18
2020-01-03 13:00:00+01:00,150,16,134,17.939622434692456,158,13,145,21.67102174389251,10,1024,0.0,18
2020-01-03 14:00:00+01:00,153,15,138,14.915022999208679,154,13,141,23.457384968254527,10,1024,0.0,18
2020-01-03 15:00:00+01:00,167,18,149,21.39117903937357,169,16,153,18.567569965901342,10,1024,0.0,18
2020-01-03 16:00:00+01:00,185,20,165,20.160625004949942,179,16,163,19.18236787964663,10,1024,0.0,18
2020-01-03 17:00:00+01:00,266,28,238,24.416240816629376,258,24,234,21.93153719781745,10,1024,0.0,18
2020-01-03 18:00:00+01:00,273,25,248,23.61851837889036,283,24,259,21.015453076893927,10,1024,0.0,18
2020-01-03 19:00:00+01:00,200,18,182,19.256012935412965,193,19,174,21.558071117560736,10,1024,0.0,18
2020-01-03 20:00:00+01:00,201,19,182,22.51450761920508,193,19,174,21.558071117560736,10,1024,0.0,18
2020-01-03 21:00:00+01:00,154,14,140,23.457384968254527,147,16,131,20.208056467665056,10,1024,0.0,18
2020-01-03 22:00:00+01:00,112,11,101,14.898852003445265,104,10,94,11.935148455597123,10,1024,0.0,18
2020-01-03 23:00:00+01:00,78,8,70,16.41986115786707,77,7,70,16.632320143368542,10,1024,0.0,18
2020-01-04 00:00:00+01:00,53,3,50,12.671576687621188,56,2,54,11.681432660358455,7,1032,0.0,13
2020-01-04 01:00:00+01:00,34,2,32,4.1719622498891535,37,2,35,3.5125252112896685,7,1032,0.0,13
2020-01-04 02:00:00+01:00,35,2,33,5.369702870779087,35,2,33,5.369702870779087,7,1032,0.0,13
2020-01-04 03:00:00+01:00,51,3,48,13.024781207847502,56,3,53,11.681432660358455,7,1032,0.0,13
2020-01-04 04:00:00+01:00,69,4,65,11.382640456570568,74,4,70,9.886934519670994,7,1032,0.0,13
2020-01-04 05:00:00+01:00,90,5,85,10.477669283936715,92,5,87,9.485995969760566,7,1032,0.0,13
2020-01-04 06:00:00+01:00,142,8,134,19.57947604189084,152,9,143,18.686880121910534,7,1032,0.0,13
2020-01-04 07:00:00+01:00,208,12,196,18.807092053665322,225,14,211,16.518156382279376,7,1032,0.0,13
2020-01-04 08:00:00+01:00,296,19,277,18.406113827007673,299,15,284,16.471342376610473,7,1032,0.0,13
2020-01-04 09:00:00+01:00,297,19,278,17.48190242862812,316,20,296,17.068110656006358,7,1032,0.0,13
2020-01-04 10:00:00+01:00,273,18,255,23.139691796211615,282,18,264,20.995138580232226,7,1032,0.0,13
2020-01-04 11:00:00+01:00,212,12,200,14.709005856097448,225,14,211,16.518156382279376,7,1032,0.0,13
2020-01-04 12:00:00+01:00,221,14,207,21.310706623471727,223,11,212,18.802339292525456,7,1032,0.0,13
2020-01-04 13:00:00+01:00,233,15,218,15.034753042734176,243,14,229,15.58217691478424,7,1032,0.0,13
2020-01-04 14:00:00+01:00,212,13,199,14.709005856097448,225,14,211,16.518156382279376,7,1032,0.0,13
2020-01-04 15:00:00+01:00,258,17,241,20.847323082118503,264,17,247,17.866837611646663,7,1032,0.0,13
2020-01-04 16:00:00+01:00,251,14,237,17.440368481170164,264,17,247,17.866837611646663,7,1032,0.0,13
2020-01-04 17:00:00+01:00,287,16,271,13.917461050382924,302,17,285,20.352052927472357,7,1032,0.0,13
2020-01-04 18:00:00+01:00,267,16,251,24.84759596655304,283,14,269,18.945435241048195,7,1032,0.0,13
2020-01-04 19:00:00+01:00,212,12,200,14.709005856097448,225,14,211,16.518156382279376,7,1032,0.0,13
2020-01-04 20:00:00+01:00,202,13,189,21.075229783177793,207,10,197,18.76558942906742,7,1032,0.0,13
2020-01-04 21:00:00+01:00,181,11,170,16.606730094694083,187,10,177,15.611538170802525,7,1032,0.0,13
2020-01-04 22:00:00+01:00,145,9,136,19.922746131926434,151,7,144,19.14578123638998,7,1032,0.0,13
2020-01-04 23:00:00+01:00,70,3,67,11.628132043946147,74,4,70,9.886934519670994,7,1032,0.0,13
2020-01-05 00:00:00+01:00,49,2,47,12.126419816698254,65,2,63,10.13470849860639,8,1037,0.0,5
2020-01-05 01:00:00+01:00,32,1,31,4.0395468395825125,42,1,41,10.321824814537676,8,1037,0.0,5
2020-01-05 02:00:00+01:00,32,1,31,4.0395468395825125,42,1,41,10.321824814537676,8,1037,0.0,5
2020-01-05 03:00:00+01:00,49,1,48,12.126419816698254,65,2,63,10.13470849860639,8,1037,0.0,5
2020-01-05 04:00:00+01:00,68,2,66,8.84385076442631,84,3,81,7.6306798135980785,8,1037,0.0,5
2020-01-05 05:00:00+01:00,84,3,81,7.6306798135980785,115,3,112,14.522258078721798,8,1037,0.0,5
2020-01-05 06:00:00+01:00,136,5,131,17.36617287321582,145,6,139,19.922746131926434,8,1037,0.0,5
2020-01-05 07:00:00+01:00,202,7,195,21.075229783177793,244,8,236,18.556057346091794,8,1037,0.0,5
2020-01-05 08:00:00+01:00,267,10,257,24.84759596655304,335,11,324,21.63506552863301,8,1037,0.0,5
2020-01-05 09:00:00+01:00,288,11,277,15.693687299637316,307,10,297,16.74476305242919,8,1037,0.0,5
2020-01-05 10:00:00+01:00,234,9,225,18.523045519331724,293,11,282,17.329297501722674,8,1037,0.0,5
2020-01-05 11:00:00+01:00,192,7,185,17.31696395349906,265,11,254,17.981103781954623,8,1037,0.0,5
2020-01-05 12:00:00+01:00,199,7,192,19.11274068140836,239,8,231,18.056937917326703,8,1037,0.0,5
2020-01-05 13:00:00+01:00,202,8,194,21.075229783177793,265,8,257,17.981103781954623,8,1037,0.0,5
2020-01-05 14:00:00+01:00,199,7,192,19.11274068140836,239,8,231,18.056937917326703,8,1037,0.0,5
2020-01-05 15:00:00+01:00,218,9,209,17.36015147829793,232,9,223,19.09590246733257,8,1037,0.0,5
2020-01-05 16:00:00+01:00,227,9,218,13.349035543905368,284,11,273,16.935782048371557,8,1037,0.0,5
2020-01-05 17:00:00+01:00,258,9,249,20.847323082118503,352,15,337,18.547693732895546,8,1037,0.0,5
2020-01-05 18:00:00+01:00,241,10,231,17.853279648834448,253,8,245,17.73107046839405,8,1037,0.0,5
2020-01-05 19:00:00+01:00,204,8,196,20.27930898180519,267,10,257,24.84759596655304,8,1037,0.0,5
2020-01-05 20:00:00+01:00,183,6,177,15.872019474492381,209,7,202,16.60419034744366,8,1037,0.0,5
2020-01-05 21:00:00+01:00,169,6,163,20.526675282456768,218,8,210,17.36015147829793,8,1037,0.0,5
2020-01-05 22:00:00+01:00,124,5,119,14.467255533674502,138,5,133,15.03091255444847,8,1037,0.0,5
2020-01-05 23:00:00+01:00,68,2,66,8.84385076442631,84,3,81,7.6306798135980785,8,1037,0.0,5
2020-01-06 00:00:00+01:00,76,6,70,16.686685835236233,81,10,71,16.076626545182606,6,1033,0.0,5
2020-01-06 01:00:00+01:00,53,5,48,8.976459755768028,55,5,50,8.909875597117273,6,1033,0.0,5
2020-01-06 02:00:00+01:00,55,5,50,8.909875597117273,55,5,50,8.909875597117273,6,1033,0.0,5
2020-01-06 03:00:00+01:00,83,8,75,18.699193296190067,81,9,72,16.076626545182606,6,1033,0.0,5
2020-01-06 04:00:00+01:00,134,13,121,14.701306049248211,136,17,119,16.594078125250377,6,1033,0.0,5
2020-01-06 05:00:00+01:00,247,25,222,18.30797612224211,239,22,217,13.74553452780325,6,1033,0.0,5
2020-01-06 06:00:00+01:00,309,33,276,17.68578168988432,300,31,269,19.621479548992166,6,1033,0.0,5
2020-01-06 07:00:00+01:00,443,44,399,13.62175880122913,458,51,407,24.591159780297854,6,1033,0.0,5
2020-01-06 08:00:00+01:00,510,54,456,19.94640789038923,510,49,461,19.94640789038923,6,1033,0.0,5
2020-01-06 09:00:00+01:00,311,31,280,16.325599187415413,328,34,294,17.860857228116767,6,1033,0.0,5
2020-01-06 10:00:00+01:00,266,24,242,24.416240816629376,271,28,243,24.814459053724722,6,1033,0.0,5
2020-01-06 11:00:00+01:00,332,30,302,21.454526645627976,337,34,303,21.494538760895587,6,1033,0.0,5
2020-01-06 12:00:00+01:00,281,26,255,17.665733770068634,275,34,241,24.67224255888931,6,1033,0.0,5
2020-01-06 13:00:00+01:00,275,30,245,24.67224255888931,275,34,241,24.67224255888931,6,1033,0.0,5
2020-01-06 14:00:00+01:00,275,30,245,24.67224255888931,275,34,241,24.67224255888931,6,1033,0.0,5
2020-01-06 15:00:00+01:00,303,33,270,15.98015338859148,296,29,267,20.454116986907042,6,1033,0.0,5
2020-01-06 16:00:00+01:00,335,33,302,21.419812345615075,320,37,283,21.04137400974582,6,1033,0.0,5
2020-01-06 17:00:00+01:00,480,51,429,21.905802263169644,478,59,419,19.93054974447541,6,1033,0.0,5
2020-01-06 18:00:00+01:00,493,48,445,23.14736404920122,495,62,433,22.447345833209692,6,1033,0.0,5
2020-01-06 19:00:00+01:00,352,36,316,20.33829699034963,352,38,314,20.33829699034963,6,1033,0.0,5
2020-01-06 20:00:00+01:00,347,34,313,19.399384547744187,356,40,316,20.092398613710877,6,1033,0.0,5
2020-01-06 21:00:00+01:00,266,25,241,24.416240816629376,271,28,243,24.814459053724722,6,1033,0.0,5
2020-01-06 22:00:00+01:00,194,17,177,21.593451125557873,194,23,171,21.593451125557873,6,1033,0.0,5
2020-01-06 23:00:00+01:00,138,12,126,20.21600799483387,132,15,117,19.37004764296085,6,1033,0.0,5
2020-01-07 00:00:00+01:00,53,5,48,8.976459755768028,63,6,57,14.929801273937542,8,1026,0.0,13
2020-01-07 01:00:00+01:00,33,2,31,5.985660510090718,39,3,36,6.782457974710225,8,1026,0.0,13
2020-01-07 02:00:00+01:00,33,2,31,5.985660510090718,39,3,36,6.782457974710225,8,1026,0.0,13
2020-01-07 03:00:00+01:00,50,4,46,13.688855833793909,61,5,56,12.362973378192347,8,1026,0.0,13
2020-01-07 04:00:00+01:00,86,7,79,21.204994436842384,99,8,91,10.779955578794215,8,1026,0.0,13
2020-01-07 05:00:00+01:00,163,15,148,20.41127666656249,172,15,157,19.644113972447897,8,1026,0.0,13
2020-01-07 06:00:00+01:00,201,19,182,22.51450761920508,215,22,193,23.830284677030114,8,1026,0.0,13
2020-01-07 07:00:00+01:00,318,31,287,21.634505447676812,333,33,300,26.7685298712925,8,1026,0.0,13
2020-01-07 08:00:00+01:00,326,31,295,15.279514269305528,356,32,324,20.092398613710877,8,1026,0.0,13
2020-01-07 09:00:00+01:00,216,18,198,21.273439412003903,247,27,220,18.30797612224211,8,1026,0.0,13
2020-01-07 10:00:00+01:00,173,14,159,20.37647841384157,204,23,181,12.517560993101368,8,1026,0.0,13
2020-01-07 11:00:00+01:00,212,20,192,18.597605283865732,252,25,227,18.51064847889223,8,1026,0.0,13
2020-01-07 12:00:00+01:00,181,17,164,20.051163259817507,199,17,182,21.764655927821806,8,1026,0.0,13
2020-01-07 13:00:00+01:00,187,15,172,20.5323189366488,193,17,176,21.558071117560736,8,1026,0.0,13
2020-01-07 14:00:00+01:00,184,16,168,20.655558446800804,199,17,182,21.764655927821806,8,1026,0.0,13
2020-01-07 15:00:00+01:00,207,17,190,21.877297854955202,215,20,195,23.830284677030114,8,1026,0.0,13
2020-01-07 16:00:00+01:00,224,21,203,16.30248157536985,241,20,221,21.076687701702674,8,1026,0.0,13
2020-01-07 17:00:00+01:00,309,28,281,17.68578168988432,344,32,312,17.416933285982235,8,1026,0.0,13
2020-01-07 18:00:00+01:00,335,33,302,21.419812345615075,349,36,313,16.300891984453436,8,1026,0.0,13
2020-01-07 19:00:00+01:00,241,20,221,21.076687701702674,261,26,235,21.270868579361668,8,1026,0.0,13
2020-01-07 20:00:00+01:00,233,22,211,20.426009043155588,267,23,244,13.385499595100717,8,1026,0.0,13
2020-01-07 21:00:00+01:00,193,17,176,21.558071117560736,203,19,184,24.82410288636225,8,1026,0.0,13
2020-01-07 22:00:00+01:00,123,11,112,19.074654696202938,141,14,127,21.00935462418931,8,1026,0.0,13
2020-01-07 23:00:00+01:00,95,8,87,11.735389228725284,99,9,90,10.779955578794215,8,1026,0.0,13
2020-01-08 00:00:00+01:00,72,9,63,11.114251740675064,74,8,66,17.73542510561878,11,1026,0.0,12
2020-01-08 01:00:00+01:00,48,6,42,9.13890902221218,46,5,41,7.79278142701588,11,1026,0.0,12
2020-01-08 02:00:00+01:00,48,6,42,9.13890902221218,46,5,41,7.79278142701588,11,1026,0.0,12
2020-01-08 03:00:00+01:00,74,9,65,17.73542510561878,74,8,66,17.73542510561878,11,1026,0.0,12
2020-01-08 04:00:00+01:00,125,15,110,14.698947587184879,119,13,106,15.009648975035175,11,1026,0.0,12
2020-01-08 05:00:00+01:00,224,27,197,23.328062540910114,214,26,188,24.48806340301503,11,1026,0.0,12
2020-01-08 06:00:00+01:00,271,31,240,21.366756148139427,271,29,242,21.366756148139427,11,1026,0.0,12
2020-01-08 07:00:00+01:00,425,52,373,19.3794475610605,400,50,350,24.218092797619367,11,1026,0.0,12
2020-01-08 08:00:00+01:00,445,54,391,16.661198829462172,414,41,373,19.17568950621098,11,1026,0.0,12
2020-01-08 09:00:00+01:00,293,40,253,20.77933514509894,289,33,256,21.030269491813637,11,1026,0.0,12
2020-01-08 10:00:00+01:00,246,28,218,23.31403953539513,230,25,205,17.60723498396665,11,1026,0.0,12
2020-01-08 11:00:00+01:00,295,33,262,15.580078135965431,293,28,265,20.77933514509894,11,1026,0.0,12
2020-01-08 12:00:00+01:00,248,31,217,22.98129959572143,230,25,205,17.60723498396665,11,1026,0.0,12
2020-01-08 13:00:00+01:00,246,27,219,23.31403953539513,230,25,205,17.60723498396665,11,1026,0.0,12
2020-01-08 14:00:00+01:00,246,27,219,23.31403953539513,230,25,205,17.60723498396665,11,1026,0.0,12
2020-01-08 15:00:00+01:00,271,30,241,21.366756148139427,271,29,242,21.366756148139427,11,1026,0.0,12
2020-01-08 16:00:00+01:00,300,37,263,17.719869170359154,287,31,256,21.022527027479835,11,1026,0.0,12
2020-01-08 17:00:00+01:00,420,49,371,17.615164094757546,420,49,371,17.615164094757546,11,1026,0.0,12
2020-01-08 18:00:00+01:00,451,58,393,15.27543247912955,406,45,361,23.347397986470767,11,1026,0.0,12
2020-01-08 19:00:00+01:00,320,41,279,20.77950754083946,295,29,266,15.580078135965431,11,1026,0.0,12
2020-01-08 20:00:00+01:00,324,37,287,25.318103431421573,293,32,261,20.77933514509894,11,1026,0.0,12
2020-01-08 21:00:00+01:00,248,31,217,22.98129959572143,230,25,205,17.60723498396665,11,1026,0.0,12
2020-01-08 22:00:00+01:00,171,19,152,19.53129553547978,154,15,139,25.102227050596255,11,1026,0.0,12
2020-01-08 23:00:00+01:00,125,16,109,14.698947587184879,119,13,106,15.009648975035175,11,1026,0.0,12
2020-01-09 00:00:00+01:00,63,5,58,14.929801273937542,61,8,53,12.362973378192347,12,1024,0.1,14
2020-01-09 01:00:00+01:00,36,2,34,3.0873599992209124,43,5,38,8.573704494863009,12,1024,0.1,14
2020-01-09 02:00:00+01:00,40,3,37,5.275608835029151,43,5,38,8.573704494863009,12,1024,0.1,14
2020-01-09 03:00:00+01:00,61,5,56,12.362973378192347,61,8,53,12.362973378192347,12,1024,0.1,14
2020-01-09 04:00:00+01:00,94,7,87,13.172779715339633,103,16,87,12.113442962320551,12,1024,0.1,14
2020-01-09 05:00:00+01:00,184,16,168,20.655558446800804,191,23,168,20.658016380524305,12,1024,0.1,14
2020-01-09 06:00:00+01:00,233,19,214,20.426009043155588,242,31,211,20.990360069331732,12,1024,0.1,14
2020-01-09 07:00:00+01:00,340,28,312,18.92958933704513,376,45,331,15.920759199358614,12,1024,0.1,14
2020-01-09 08:00:00+01:00,367,28,339,20.047055443111752,370,59,311,20.548579550699223,12,1024,0.1,14
2020-01-09 09:00:00+01:00,267,20,247,13.385499595100717,261,34,227,21.270868579361668,12,1024,0.1,14
2020-01-09 10:00:00+01:00,196,17,179,20.04912381427717,223,28,195,21.320656431140716,12,1024,0.1,14
2020-01-09 11:00:00+01:00,231,18,213,16.702836426900134,263,33,230,18.706444640225143,12,1024,0.1,14
2020-01-09 12:00:00+01:00,209,18,191,22.16757043059366,216,27,189,21.273439412003903,12,1024,0.1,14
2020-01-09 13:00:00+01:00,207,18,189,21.877297854955202,209,28,181,22.16757043059366,12,1024,0.1,14
2020-01-09 14:00:00+01:00,202,15,187,22.500350864850866,205,28,177,13.47116079711613,12,1024,0.1,14
2020-01-09 15:00:00+01:00,223,17,206,21.320656431140716,228,31,197,15.818609956751573,12,1024,0.1,14
2020-01-09 16:00:00+01:00,230,17,213,17.120376816836934,263,33,230,18.706444640225143,12,1024,0.1,14
2020-01-09 17:00:00+01:00,356,31,325,20.092398613710877,362,48,314,18.208767664177746,12,1024,0.1,14
2020-01-09 18:00:00+01:00,402,35,367,17.230856788696144,386,59,327,18.304254687443294,12,1024,0.1,14
2020-01-09 19:00:00+01:00,274,22,252,20.56786912693606,284,46,238,21.60666647068217,12,1024,0.1,14
2020-01-09 20:00:00+01:00,261,19,242,21.270868579361668,275,42,233,24.67224255888931,12,1024,0.1,14
2020-01-09 21:00:00+01:00,203,18,185,24.82410288636225,209,30,179,22.16757043059366,12,1024,0.1,14
2020-01-09 22:00:00+01:00,140,10,130,15.331768592489755,144,21,123,22.91915418498221,12,1024,0.1,14
2020-01-09 23:00:00+01:00,96,8,88,11.83328593996439,103,16,87,12.113442962320551,12,1024,0.1,14
2020-01-10 00:00:00+01:00,37,3,34,2.066086063070793,38,4,34,11.101073107969722,9,1010,0.3,32
2020-01-10 01:00:00+01:00,25,2,23,1.1875344360364632,25,2,23,1.1875344360364632,9,1010,0.3,32
2020-01-10 02:00:00+01:00,25,2,23,1.1875344360364632,25,2,23,1.1875344360364632,9,1010,0.3,32
2020-01-10 03:00:00+01:00,37,3,34,2.066086063070793,38,4,34,11.101073107969722,9,1010,0.3,32
2020-01-10 04:00:00+01:00,63,6,57,14.929801273937542,58,5,53,10.505136369992313,9,1010,0.3,32
2020-01-10 05:00:00+01:00,113,12,101,20.093188266697116,113,11,102,20.093188266697116,9,1010,0.3,32
2020-01-10 06:00:00+01:00,140,13,127,15.331768592489755,129,13,116,17.995114557081255,9,1010,0.3,32
2020-01-10 07:00:00+01:00,210,19,191,16.3212742992447,212,18,194,18.597605283865732,9,1010,0.3,32
2020-01-10 08:00:00+01:00,228,23,205,15.818609956751573,211,19,192,18.759232281731908,9,1010,0.3,32
2020-01-10 09:00:00+01:00,147,14,133,20.208056467665056,153,13,140,14.915022999208679,9,1010,0.3,32
2020-01-10 10:00:00+01:00,124,11,113,17.53992981591413,117,12,105,21.891304075969387,9,1010,0.3,32
2020-01-10 11:00:00+01:00,153,15,138,14.915022999208679,148,13,135,18.058884943386857,9,1010,0.3,32
2020-01-10 12:00:00+01:00,129,13,116,17.995114557081255,123,10,113,19.074654696202938,9,1010,0.3,32
2020-01-10 13:00:00+01:00,124,12,112,17.53992981591413,117,12,105,21.891304075969387,9,1010,0.3,32
2020-01-10 14:00:00+01:00,128,12,116,19.601953989978306,123,10,113,19.074654696202938,9,1010,0.3,32
2020-01-10 15:00:00+01:00,136,14,122,16.594078125250377,138,14,124,20.21600799483387,9,1010,0.3,32
2020-01-10 16:00:00+01:00,145,14,131,18.85528596371164,154,15,139,23.457384968254527,9,1010,0.3,32
2020-01-10 17:00:00+01:00,207,22,185,21.877297854955202,202,19,183,22.500350864850866,9,1010,0.3,32
2020-01-10 18:00:00+01:00,218,21,197,22.57742359713229,227,25,202,19.269071808142694,9,1010,0.3,32
2020-01-10 19:00:00+01:00,158,15,143,21.67102174389251,159,15,144,17.78748005044877,9,1010,0.3,32
2020-01-10 20:00:00+01:00,160,14,146,19.89239402952506,159,13,146,17.78748005044877,9,1010,0.3,32
2020-01-10 21:00:00+01:00,123,11,112,19.074654696202938,123,12,111,19.074654696202938,9,1010,0.3,32
2020-01-10 22:00:00+01:00,86,8,78,21.204994436842384,85,7,78,19.289671453475872,9,1010,0.3,32
2020-01-10 23:00:00+01:00,61,6,55,12.362973378192347,58,5,53,10.505136369992313,9,1010,0.3,32
2020-01-11 00:00:00+01:00,82,5,77,8.6962433625344,87,4,83,9.504121716770046,6,1032,0.0,4
2020-01-11 01:00:00+01:00,55,3,52,10.027044718132117,55,3,52,10.027044718132117,6,1032,0.0,4
2020-01-11 02:00:00+01:00,53,3,50,12.671576687621188,58,2,56,11.561797090249616,6,1032,0.0,4
2020-01-11 03:00:00+01:00,80,4,76,12.9514806028411,87,5,82,9.504121716770046,6,1032,0.0,4
2020-01-11 04:00:00+01:00,113,6,107,20.97275705288615,116,6,110,11.000262455867666,6,1032,0.0,4
2020-01-11 05:00:00+01:00,138,8,130,15.03091255444847,147,8,139,16.306492316544293,6,1032,0.0,4
2020-01-11 06:00:00+01:00,227,15,212,13.349035543905368,232,14,218,19.09590246733257,6,1032,0.0,4
2020-01-11 07:00:00+01:00,330,20,310,18.864376108789497,352,20,332,18.547693732895546,6,1032,0.0,4
2020-01-11 08:00:00+01:00,440,28,412,20.915500855429855,464,27,437,21.34229223380193,6,1032,0.0,4
2020-01-11 09:00:00+01:00,477,29,448,19.556522486250476,504,32,472,18.186363959256344,6,1032,0.0,4
2020-01-11 10:00:00+01:00,431,24,407,19.594917580038825,431,28,403,19.594917580038825,6,1032,0.0,4
2020-01-11 11:00:00+01:00,323,22,301,19.446887597808452,350,20,330,19.39294883514927,6,1032,0.0,4
2020-01-11 12:00:00+01:00,330,19,311,18.864376108789497,352,20,332,18.547693732895546,6,1032,0.0,4
2020-01-11 13:00:00+01:00,357,23,334,16.579219218063535,384,21,363,20.93762948810624,6,1032,0.0,4
2020-01-11 14:00:00+01:00,343,22,321,16.93402466287014,352,23,329,18.547693732895546,6,1032,0.0,4
2020-01-11 15:00:00+01:00,384,25,359,20.93762948810624,415,25,390,20.29207139621444,6,1032,0.0,4
2020-01-11 16:00:00+01:00,388,26,362,20.16254491947918,415,25,390,20.29207139621444,6,1032,0.0,4
2020-01-11 17:00:00+01:00,444,30,414,21.75090257606931,464,27,437,21.34229223380193,6,1032,0.0,4
2020-01-11 18:00:00+01:00,422,25,397,15.562162592523094,435,22,413,17.70683292278672,6,1032,0.0,4
2020-01-11 19:00:00+01:00,328,20,308,18.977288676463566,355,19,336,19.867707600873487,6,1032,0.0,4
2020-01-11 20:00:00+01:00,310,19,291,15.258998808795859,317,18,299,17.791113543708203,6,1032,0.0,4
2020-01-11 21:00:00+01:00,281,18,263,18.053311879599764,288,18,270,15.693687299637316,6,1032,0.0,4
2020-01-11 22:00:00+01:00,216,12,204,17.62117954457743,230,13,217,16.58682627515864,6,1032,0.0,4
2020-01-11 23:00:00+01:00,109,6,103,18.214376818550008,116,6,110,11.000262455867666,6,1032,0.0,4
2020-01-12 00:00:00+01:00,27,1,26,0.2711247026271743,37,1,36,3.5125252112896685,6,1029,0.0,13
2020-01-12 01:00:00+01:00,18,0,18,0.014449312499738909,21,0,21,0.0727095127790566,6,1029,0.0,13
2020-01-12 02:00:00+01:00,17,0,17,0.01741797176914947,21,0,21,0.0727095127790566,6,1029,0.0,13
2020-01-12 03:00:00+01:00,26,0,26,0.13434729751860394,38,1,37,5.960450042509954,6,1029,0.0,13
2020-01-12 04:00:00+01:00,38,1,37,5.960450042509954,50,1,49,13.833131991765365,6,1029,0.0,13
2020-01-12 05:00:00+01:00,47,1,46,8.734704942588355,62,2,60,14.019247608895405,6,1029,0.0,13
2020-01-12 06:00:00+01:00,75,3,72,11.283880560685672,95,3,92,10.506818941407664,6,1029,0.0,13
2020-01-12 07:00:00+01:00,106,4,102,19.560878716092326,158,5,153,19.40470350916573,6,1029,0.0,13
2020-01-12 08:00:00+01:00,159,5,154,19.89258263570152,162,5,157,18.435104799511247,6,1029,0.0,13
2020-01-12 09:00:00+01:00,158,6,152,19.40470350916573,172,6,166,18.863206387348974,6,1029,0.0,13
2020-01-12 10:00:00+01:00,147,5,142,16.306492316544293,198,8,190,20.173795644408123,6,1029,0.0,13
2020-01-12 11:00:00+01:00,115,4,111,14.522258078721798,155,5,150,18.708796369633056,6,1029,0.0,13
2020-01-12 12:00:00+01:00,106,3,103,19.560878716092326,158,5,153,19.40470350916573,6,1029,0.0,13
2020-01-12 13:00:00+01:00,129,4,125,12.81298343964759,153,5,148,18.67945251137068,6,1029,0.0,13
2020-01-12 14:00:00+01:00,106,3,103,19.560878716092326,158,5,153,19.40470350916573,6,1029,0.0,13
2020-01-12 15:00:00+01:00,139,5,134,19.408576933840735,180,6,174,18.453361889556408,6,1029,0.0,13
2020-01-12 16:00:00+01:00,127,4,123,18.022773693841014,155,6,149,18.708796369633056,6,1029,0.0,13
2020-01-12 17:00:00+01:00,141,5,136,17.007652233540448,206,7,199,20.90053052788098,6,1029,0.0,13
2020-01-12 18:00:00+01:00,137,5,132,15.965917364236809,188,7,181,19.664617237016223,6,1029,0.0,13
2020-01-12 19:00:00+01:00,110,4,106,20.964248322238312,127,4,123,18.022773693841014,6,1029,0.0,13
2020-01-12 20:00:00+01:00,101,4,97,14.022694861996197,141,5,136,17.007652233540448,6,1029,0.0,13
2020-01-12 21:00:00+01:00,98,4,94,9.366341704429512,122,5,117,15.53082002471091,6,1029,0.0,13
2020-01-12 22:00:00+01:00,73,2,71,10.015349835153332,90,3,87,10.477669283936715,6,1029,0.0,13
2020-01-12 23:00:00+01:00,35,1,34,5.369702870779087,37,1,36,3.5125252112896685,6,1029,0.0,13
2020-01-13 00:00:00+01:00,67,6,61,12.5039951599288,67,7,60,12.5039951599288,8,1025,0.1,10
2020-01-13 01:00:00+01:00,45,4,41,8.16653528554085,43,4,39,8.573704494863009,8,1025,0.1,10
2020-01-13 02:00:00+01:00,43,4,39,8.573704494863009,43,4,39,8.573704494863009,8,1025,0.1,10
2020-01-13 03:00:00+01:00,66,6,60,13.86002207659952,69,8,61,19.29595730158091,8,1025,0.1,10
2020-01-13 04:00:00+01:00,105,10,95,15.778065052313549,112,14,98,14.898852003445265,8,1025,0.1,10
2020-01-13 05:00:00+01:00,192,18,174,21.295822766447603,201,21,180,22.51450761920508,8,1025,0.1,10
2020-01-13 06:00:00+01:00,236,23,213,19.106111918840778,244,29,215,17.108671526861457,8,1025,0.1,10
2020-01-13 07:00:00+01:00,375,37,338,22.64494297948435,378,39,339,19.765573549462566,8,1025,0.1,10
2020-01-13 08:00:00+01:00,401,37,364,26.708807440790352,397,45,352,20.240119954252663,8,1025,0.1,10
2020-01-13 09:00:00+01:00,262,26,236,18.255168653975332,271,33,238,24.814459053724722,8,1025,0.1,10
2020-01-13 10:00:00+01:00,225,20,205,17.07968654570721,224,22,202,16.30248157536985,8,1025,0.1,10
2020-01-13 11:00:00+01:00,264,23,241,20.665980174270672,265,26,239,24.143057918667047,8,1025,0.1,10
2020-01-13 12:00:00+01:00,218,21,197,22.57742359713229,224,27,197,16.30248157536985,8,1025,0.1,10
2020-01-13 13:00:00+01:00,220,19,201,16.758079648934128,220,21,199,16.758079648934128,8,1025,0.1,10
2020-01-13 14:00:00+01:00,218,20,198,22.57742359713229,224,27,197,16.30248157536985,8,1025,0.1,10
2020-01-13 15:00:00+01:00,241,21,220,21.076687701702674,243,27,216,18.936896488437778,8,1025,0.1,10
2020-01-13 16:00:00+01:00,262,27,235,18.255168653975332,271,33,238,24.814459053724722,8,1025,0.1,10
2020-01-13 17:00:00+01:00,383,35,348,23.132924781238575,387,48,339,22.869757461740583,8,1025,0.1,10
2020-01-13 18:00:00+01:00,390,42,348,23.204029211730827,397,49,348,20.240119954252663,8,1025,0.1,10
2020-01-13 19:00:00+01:00,284,29,255,21.60666647068217,288,27,261,22.858888837585067,8,1025,0.1,10
2020-01-13 20:00:00+01:00,276,26,250,21.646913060128323,286,30,256,20.398524223626136,8,1025,0.1,10
2020-01-13 21:00:00+01:00,231,24,207,16.702836426900134,224,22,202,16.30248157536985,8,1025,0.1,10
2020-01-13 22:00:00+01:00,152,13,139,20.188330220444417,156,15,141,23.175119746499636,8,1025,0.1,10
2020-01-13 23:00:00+01:00,105,11,94,15.778065052313549,112,14,98,14.898852003445265,8,1025,0.1,10
2020-01-14 00:00:00+01:00,34,3,31,5.3950651883530085,40,4,36,5.275608835029151,9,1009,0.0,28
2020-01-14 01:00:00+01:00,25,2,23,1.1875344360364632,27,2,25,1.9016023008994223,9,1009,0.0,28
2020-01-14 02:00:00+01:00,25,2,23,1.1875344360364632,27,2,25,1.9016023008994223,9,1009,0.0,28
2020-01-14 03:00:00+01:00,38,3,35,11.101073107969722,40,4,36,5.275608835029151,9,1009,0.0,28
2020-01-14 04:00:00+01:00,62,5,57,14.48690450543278,62,5,57,14.48690450543278,9,1009,0.0,28
2020-01-14 05:00:00+01:00,101,8,93,11.280950715811313,121,12,109,20.317620945183666,9,1009,0.0,28
2020-01-14 06:00:00+01:00,138,11,127,20.21600799483387,138,14,124,20.21600799483387,9,1009,0.0,28
2020-01-14 07:00:00+01:00,192,17,175,21.295822766447603,225,21,204,17.07968654570721,9,1009,0.0,28
2020-01-14 08:00:00+01:00,218,18,200,22.57742359713229,242,27,215,20.990360069331732,9,1009,0.0,28
2020-01-14 09:00:00+01:00,142,13,129,21.623487252479663,164,16,148,22.827361263214527,9,1009,0.0,28
2020-01-14 10:00:00+01:00,129,10,119,17.995114557081255,131,11,120,14.183230975852695,9,1009,0.0,28
2020-01-14 11:00:00+01:00,142,11,131,21.623487252479663,164,16,148,22.827361263214527,9,1009,0.0,28
2020-01-14 12:00:00+01:00,129,10,119,17.995114557081255,131,11,120,14.183230975852695,9,1009,0.0,28
2020-01-14 13:00:00+01:00,119,9,110,22.46945513312648,129,12,117,17.995114557081255,9,1009,0.0,28
2020-01-14 14:00:00+01:00,119,9,110,22.46945513312648,129,12,117,17.995114557081255,9,1009,0.0,28
2020-01-14 15:00:00+01:00,130,10,120,15.65660051079879,144,12,132,22.91915418498221,9,1009,0.0,28
2020-01-14 16:00:00+01:00,139,13,126,18.732486269107348,150,15,135,17.939622434692456,9,1009,0.0,28
2020-01-14 17:00:00+01:00,209,17,192,22.16757043059366,224,19,205,16.30248157536985,9,1009,0.0,28
2020-01-14 18:00:00+01:00,213,17,196,20.488166305452438,246,24,222,17.57126233227549,9,1009,0.0,28
2020-01-14 19:00:00+01:00,153,14,139,14.915022999208679,172,15,157,19.644113972447897,9,1009,0.0,28
2020-01-14 20:00:00+01:00,155,15,140,19.469409355748308,165,18,147,20.56038540292619,9,1009,0.0,28
2020-01-14 21:00:00+01:00,119,11,108,22.46945513312648,129,12,117,17.995114557081255,9,1009,0.0,28
2020-01-14 22:00:00+01:00,83,6,77,18.699193296190067,90,9,81,13.960700117154147,9,1009,0.0,28
2020-01-14 23:00:00+01:00,58,4,54,10.505136369992313,67,7,60,12.5039951599288,9,1009,0.0,28
2020-01-15 00:00:00+01:00,38,4,34,7.590795833711637,34,3,31,11.019687492562438,10,1011,0.0,25
2020-01-15 01:00:00+01:00,25,3,22,4.851536786659508,25,2,23,4.851536786659508,10,1011,0.0,25
2020-01-15 02:00:00+01:00,25,2,23,4.851536786659508,25,2,23,4.851536786659508,10,1011,0.0,25
2020-01-15 03:00:00+01:00,38,4,34,7.590795833711637,34,3,31,11.019687492562438,10,1011,0.0,25
2020-01-15 04:00:00+01:00,63,7,56,13.630126271531418,62,6,56,12.779859753427614,10,1011,0.0,25
2020-01-15 05:00:00+01:00,114,13,101,17.516346710171707,112,12,100,16.537505199847164,10,1011,0.0,25
2020-01-15 06:00:00+01:00,140,19,121,17.88117043007633,141,14,127,16.082921323202,10,1011,0.0,25
2020-01-15 07:00:00+01:00,214,24,190,24.48806340301503,203,19,184,21.5050173548228,10,1011,0.0,25
2020-01-15 08:00:00+01:00,226,28,198,20.105295377891462,220,27,193,18.729640796362187,10,1011,0.0,25
2020-01-15 09:00:00+01:00,153,19,134,18.89706115395996,139,16,123,21.474746575274906,10,1011,0.0,25
2020-01-15 10:00:00+01:00,126,17,109,16.250667590352332,123,13,110,15.262138605096247,10,1011,0.0,25
2020-01-15 11:00:00+01:00,153,18,135,18.89706115395996,139,16,123,21.474746575274906,10,1011,0.0,25
2020-01-15 12:00:00+01:00,126,17,109,16.250667590352332,123,13,110,15.262138605096247,10,1011,0.0,25
2020-01-15 13:00:00+01:00,127,15,112,19.95892802947898,120,14,106,10.291257377501918,10,1011,0.0,25
2020-01-15 14:00:00+01:00,127,16,111,19.95892802947898,120,14,106,10.291257377501918,10,1011,0.0,25
2020-01-15 15:00:00+01:00,140,18,122,17.88117043007633,141,14,127,16.082921323202,10,1011,0.0,25
2020-01-15 16:00:00+01:00,151,17,134,19.198981193831877,149,16,133,18.476483571588744,10,1011,0.0,25
2020-01-15 17:00:00+01:00,217,26,191,20.47500927792046,213,24,189,16.70464389525102,10,1011,0.0,25
2020-01-15 18:00:00+01:00,232,26,206,24.606618615768106,205,22,183,18.29833304368066,10,1011,0.0,25
2020-01-15 19:00:00+01:00,167,22,145,16.493575022686013,154,14,140,25.102227050596255,10,1011,0.0,25
2020-01-15 20:00:00+01:00,167,21,146,16.493575022686013,154,14,140,25.102227050596255,10,1011,0.0,25
2020-01-15 21:00:00+01:00,129,16,113,12.321757402623772,125,13,112,14.698947587184879,10,1011,0.0,25
2020-01-15 22:00:00+01:00,89,11,78,16.127888447212325,79,9,70,16.621554061874914,10,1011,0.0,25
2020-01-15 23:00:00+01:00,63,8,55,13.630126271531418,62,6,56,12.779859753427614,10,1011,0.0,25
2020-01-16 00:00:00+01:00,78,6,72,16.41986115786707,82,11,71,16.39179981762634,9,1024,0.0,7
2020-01-16 01:00:00+01:00,51,4,47,7.252205043556333,53,7,46,8.976459755768028,9,1024,0.0,7
2020-01-16 02:00:00+01:00,53,4,49,8.976459755768028,56,7,49,10.152150256689218,9,1024,0.0,7
2020-01-16 03:00:00+01:00,80,6,74,18.237765354324676,82,9,73,16.39179981762634,9,1024,0.0,7
2020-01-16 04:00:00+01:00,132,11,121,19.37004764296085,136,21,115,16.594078125250377,9,1024,0.0,7
2020-01-16 05:00:00+01:00,235,19,216,20.674840106170866,251,39,212,19.570183352800104,9,1024,0.0,7
2020-01-16 06:00:00+01:00,282,24,258,14.328617212432716,307,49,258,19.62844127124222,9,1024,0.0,7
2020-01-16 07:00:00+01:00,423,37,386,23.290663678046883,475,76,399,26.73035993542065,9,1024,0.0,7
2020-01-16 08:00:00+01:00,470,37,433,21.98902238846196,495,69,426,22.447345833209692,9,1024,0.0,7
2020-01-16 09:00:00+01:00,307,26,281,19.62844127124222,320,50,270,21.04137400974582,9,1024,0.0,7
2020-01-16 10:00:00+01:00,280,24,256,25.91177046818179,275,42,233,24.67224255888931,9,1024,0.0,7
2020-01-16 11:00:00+01:00,311,28,283,16.325599187415413,331,44,287,18.08059708638437,9,1024,0.0,7
2020-01-16 12:00:00+01:00,251,20,231,19.570183352800104,273,41,232,23.61851837889036,9,1024,0.0,7
2020-01-16 13:00:00+01:00,262,20,242,18.255168653975332,286,45,241,20.398524223626136,9,1024,0.0,7
2020-01-16 14:00:00+01:00,268,23,245,16.114987230113258,273,35,238,23.61851837889036,9,1024,0.0,7
2020-01-16 15:00:00+01:00,289,22,267,20.14984129628082,291,38,253,17.50237418524224,9,1024,0.0,7
2020-01-16 16:00:00+01:00,304,23,281,22.339067945756394,320,52,268,21.04137400974582,9,1024,0.0,7
2020-01-16 17:00:00+01:00,477,41,436,19.637502490728593,490,69,421,20.189989846505636,9,1024,0.0,7
2020-01-16 18:00:00+01:00,508,42,466,22.57591031476529,475,67,408,26.73035993542065,9,1024,0.0,7
2020-01-16 19:00:00+01:00,338,27,311,21.115663704400472,372,49,323,17.388398109436665,9,1024,0.0,7
2020-01-16 20:00:00+01:00,333,26,307,26.7685298712925,354,54,300,21.22371738501729,9,1024,0.0,7
2020-01-16 21:00:00+01:00,275,21,254,24.67224255888931,277,45,232,24.920160895876304,9,1024,0.0,7
2020-01-16 22:00:00+01:00,190,16,174,20.51689583562818,190,26,164,20.51689583562818,9,1024,0.0,7
2020-01-16 23:00:00+01:00,141,11,130,21.00935462418931,143,20,123,22.510370466296816,9,1024,0.0,7
2020-01-17 00:00:00+01:00,44,4,40,6.744796902616623,47,4,43,10.718407092962304,10,1017,0.0,18
2020-01-17 01:00:00+01:00,29,2,27,3.1672610972900266,28,2,26,4.026144260024548,10,1017,0.0,18
2020-01-17 02:00:00+01:00,29,2,27,3.1672610972900266,28,2,26,4.026144260024548,10,1017,0.0,18
2020-01-17 03:00:00+01:00,44,4,40,6.744796902616623,47,4,43,10.718407092962304,10,1017,0.0,18
2020-01-17 04:00:00+01:00,75,7,68,14.734681497037354,79,8,71,16.382916607013883,10,1017,0.0,18
2020-01-17 05:00:00+01:00,138,13,125,20.21600799483387,130,13,117,15.65660051079879,10,1017,0.0,18
2020-01-17 06:00:00+01:00,168,15,153,20.304807772345505,168,16,152,20.304807772345505,10,1017,0.0,18
2020-01-17 07:00:00+01:00,261,25,236,21.270868579361668,255,27,228,21.41944964647189,10,1017,0.0,18
2020-01-17 08:00:00+01:00,280,25,255,25.91177046818179,275,29,246,24.67224255888931,10,1017,0.0,18
2020-01-17 09:00:00+01:00,184,20,164,20.655558446800804,181,15,166,20.051163259817507,10,1017,0.0,18
2020-01-17 10:00:00+01:00,152,13,139,20.188330220444417,153,13,140,14.915022999208679,10,1017,0.0,18
2020-01-17 11:00:00+01:00,184,16,168,20.655558446800804,181,15,166,20.051163259817507,10,1017,0.0,18
2020-01-17 12:00:00+01:00,152,13,139,20.188330220444417,153,13,140,14.915022999208679,10,1017,0.0,18
2020-01-17 13:00:00+01:00,153,14,139,14.915022999208679,153,13,140,14.915022999208679,10,1017,0.0,18
2020-01-17 14:00:00+01:00,153,14,139,14.915022999208679,153,13,140,14.915022999208679,10,1017,0.0,18
2020-01-17 15:00:00+01:00,168,15,153,20.304807772345505,168,16,152,20.304807772345505,10,1017,0.0,18
2020-01-17 16:00:00+01:00,184,18,166,20.655558446800804,181,15,166,20.051163259817507,10,1017,0.0,18
2020-01-17 17:00:00+01:00,259,23,236,22.988395045636892,250,23,227,14.642007731534619,10,1017,0.0,18
2020-01-17 18:00:00+01:00,276,28,248,21.646913060128323,270,26,244,23.920073269237992,10,1017,0.0,18
2020-01-17 19:00:00+01:00,202,18,184,22.500350864850866,188,18,170,22.908938245974742,10,1017,0.0,18
2020-01-17 20:00:00+01:00,204,20,184,12.517560993101368,192,21,171,21.295822766447603,10,1017,0.0,18
2020-01-17 21:00:00+01:00,153,14,139,14.915022999208679,153,13,140,14.915022999208679,10,1017,0.0,18
2020-01-17 22:00:00+01:00,107,9,98,12.156196464705383,104,11,93,11.935148455597123,10,1017,0.0,18
2020-01-17 23:00:00+01:00,78,8,70,16.41986115786707,76,7,69,16.686685835236233,10,1017,0.0,18
2020-01-18 00:00:00+01:00,36,2,34,2.727177547566476,39,2,37,6.913338666308079,6,1025,0.0,18
2020-01-18 01:00:00+01:00,24,1,23,0.16633697306049489,26,1,25,0.13434729751860394,6,1025,0.0,18
2020-01-18 02:00:00+01:00,25,1,24,0.10677168789919293,26,1,25,0.13434729751860394,6,1025,0.0,18
2020-01-18 03:00:00+01:00,38,2,36,5.960450042509954,39,2,37,6.913338666308079,6,1025,0.0,18
2020-01-18 04:00:00+01:00,48,3,45,9.964553643509852,52,2,50,14.472017643602554,6,1025,0.0,18
2020-01-18 05:00:00+01:00,62,4,58,14.019247608895405,65,4,61,10.13470849860639,6,1025,0.0,18
2020-01-18 06:00:00+01:00,101,6,95,14.022694861996197,105,6,99,16.343560716114418,6,1025,0.0,18
2020-01-18 07:00:00+01:00,147,9,138,16.306492316544293,159,10,149,19.89258263570152,6,1025,0.0,18
2020-01-18 08:00:00+01:00,206,11,195,20.90053052788098,208,12,196,18.807092053665322,6,1025,0.0,18
2020-01-18 09:00:00+01:00,213,14,199,20.238518600536185,223,14,209,18.802339292525456,6,1025,0.0,18
2020-01-18 10:00:00+01:00,187,12,175,15.611538170802525,198,12,186,20.173795644408123,6,1025,0.0,18
2020-01-18 11:00:00+01:00,152,10,142,18.686880121910534,155,8,147,18.708796369633056,6,1025,0.0,18
2020-01-18 12:00:00+01:00,145,8,137,19.922746131926434,158,8,150,19.40470350916573,6,1025,0.0,18
2020-01-18 13:00:00+01:00,167,9,158,19.047083059371815,172,10,162,18.863206387348974,6,1025,0.0,18
2020-01-18 14:00:00+01:00,154,8,146,19.868163821621103,155,8,147,18.708796369633056,6,1025,0.0,18
2020-01-18 15:00:00+01:00,169,9,160,20.526675282456768,185,10,175,20.88033942284811,6,1025,0.0,18
2020-01-18 16:00:00+01:00,172,10,162,18.863206387348974,186,9,177,20.400698976924794,6,1025,0.0,18
2020-01-18 17:00:00+01:00,199,12,187,19.11274068140836,209,10,199,16.60419034744366,6,1025,0.0,18
2020-01-18 18:00:00+01:00,190,11,179,20.182913119811044,197,10,187,19.118279085736297,6,1025,0.0,18
2020-01-18 19:00:00+01:00,146,9,137,19.4340926707284,157,8,149,19.700921436065542,6,1025,0.0,18
2020-01-18 20:00:00+01:00,142,8,134,19.57947604189084,146,8,138,19.4340926707284,6,1025,0.0,18
2020-01-18 21:00:00+01:00,124,7,117,14.467255533674502,129,7,122,12.81298343964759,6,1025,0.0,18
2020-01-18 22:00:00+01:00,100,6,94,12.129363492765288,105,7,98,16.343560716114418,6,1025,0.0,18
2020-01-18 23:00:00+01:00,49,3,46,12.126419816698254,52,2,50,14.472017643602554,6,1025,0.0,18
2020-01-19 00:00:00+01:00,32,1,31,4.0395468395825125,41,1,40,7.51149883575918,5,1033,0.0,10
2020-01-19 01:00:00+01:00,21,0,21,0.0727095127790566,24,0,24,0.16633697306049489,5,1033,0.0,10
2020-01-19 02:00:00+01:00,21,0,21,0.0727095127790566,24,0,24,0.16633697306049489,5,1033,0.0,10
2020-01-19 03:00:00+01:00,32,1,31,4.0395468395825125,41,1,40,7.51149883575918,5,1033,0.0,10
2020-01-19 04:00:00+01:00,42,1,41,10.321824814537676,56,1,55,11.681432660358455,5,1033,0.0,10
2020-01-19 05:00:00+01:00,50,1,49,13.833131991765365,71,2,69,11.584371388309396,5,1033,0.0,10
2020-01-19 06:00:00+01:00,84,3,81,7.6306798135980785,120,4,116,15.329119598546,5,1033,0.0,10
2020-01-19 07:00:00+01:00,122,4,118,15.53082002471091,152,5,147,18.686880121910534,5,1033,0.0,10
2020-01-19 08:00:00+01:00,162,6,156,18.435104799511247,207,7,200,18.76558942906742,5,1033,0.0,10
2020-01-19 09:00:00+01:00,188,7,181,19.664617237016223,215,7,208,14.020699077914754,5,1033,0.0,10
2020-01-19 10:00:00+01:00,159,5,154,19.89258263570152,174,6,168,17.20816352324012,5,1033,0.0,10
2020-01-19 11:00:00+01:00,126,4,122,13.391954395859463,152,6,146,18.686880121910534,5,1033,0.0,10
2020-01-19 12:00:00+01:00,122,4,118,15.53082002471091,152,5,147,18.686880121910534,5,1033,0.0,10
2020-01-19 13:00:00+01:00,131,4,127,17.703689985975256,140,5,135,15.157104538016958,5,1033,0.0,10
2020-01-19 14:00:00+01:00,136,5,131,17.36617287321582,142,5,137,19.57947604189084,5,1033,0.0,10
2020-01-19 15:00:00+01:00,157,6,151,19.700921436065542,163,5,158,16.305265165047643,5,1033,0.0,10
2020-01-19 16:00:00+01:00,160,5,155,18.858823274894117,181,6,175,16.606730094694083,5,1033,0.0,10
2020-01-19 17:00:00+01:00,168,6,162,15.312398611458734,227,8,219,13.349035543905368,5,1033,0.0,10
2020-01-19 18:00:00+01:00,162,6,156,18.435104799511247,194,7,187,19.241214114048436,5,1033,0.0,10
2020-01-19 19:00:00+01:00,131,4,127,17.703689985975256,129,5,124,12.81298343964759,5,1033,0.0,10
2020-01-19 20:00:00+01:00,119,4,115,9.275729661817119,133,5,128,15.567856067550506,5,1033,0.0,10
2020-01-19 21:00:00+01:00,110,4,106,20.964248322238312,122,4,118,15.53082002471091,5,1033,0.0,10
2020-01-19 22:00:00+01:00,84,3,81,7.6306798135980785,120,4,116,15.329119598546,5,1033,0.0,10
2020-01-19 23:00:00+01:00,39,1,38,6.913338666308079,42,1,41,10.321824814537676,5,1033,0.0,10
2020-01-20 00:00:00+01:00,39,3,36,6.782457974710225,37,4,33,2.066086063070793,5,1045,0.0,17
2020-01-20 01:00:00+01:00,26,2,24,1.5382661455122164,26,2,24,1.5382661455122164,5,1045,0.0,17
2020-01-20 02:00:00+01:00,24,2,22,1.5004308879154395,26,2,24,1.5382661455122164,5,1045,0.0,17
2020-01-20 03:00:00+01:00,37,3,34,2.066086063070793,39,4,35,6.782457974710225,5,1045,0.0,17
2020-01-20 04:00:00+01:00,60,5,55,10.583722413773145,62,6,56,14.48690450543278,5,1045,0.0,17
2020-01-20 05:00:00+01:00,108,10,98,14.813734676069407,112,11,101,14.898852003445265,5,1045,0.0,17
2020-01-20 06:00:00+01:00,136,13,123,16.594078125250377,142,16,126,21.623487252479663,5,1045,0.0,17
2020-01-20 07:00:00+01:00,226,22,204,20.308697708911414,214,23,191,18.560318290748608,5,1045,0.0,17
2020-01-20 08:00:00+01:00,239,24,215,13.74553452780325,235,29,206,20.674840106170866,5,1045,0.0,17
2020-01-20 09:00:00+01:00,154,16,138,23.457384968254527,151,18,133,19.408157188048275,5,1045,0.0,17
2020-01-20 10:00:00+01:00,128,11,117,19.601953989978306,128,12,116,19.601953989978306,5,1045,0.0,17
2020-01-20 11:00:00+01:00,152,13,139,20.188330220444417,154,15,139,23.457384968254527,5,1045,0.0,17
2020-01-20 12:00:00+01:00,123,13,110,19.074654696202938,128,14,114,19.601953989978306,5,1045,0.0,17
2020-01-20 13:00:00+01:00,127,11,116,19.116953333289125,125,13,112,23.026828253397017,5,1045,0.0,17
2020-01-20 14:00:00+01:00,127,11,116,19.116953333289125,125,13,112,23.026828253397017,5,1045,0.0,17
2020-01-20 15:00:00+01:00,139,12,127,18.732486269107348,137,15,122,18.928795118329443,5,1045,0.0,17
2020-01-20 16:00:00+01:00,145,14,131,18.85528596371164,157,17,140,23.857880119976507,5,1045,0.0,17
2020-01-20 17:00:00+01:00,216,21,195,21.273439412003903,220,27,193,16.758079648934128,5,1045,0.0,17
2020-01-20 18:00:00+01:00,228,21,207,15.818609956751573,225,22,203,17.07968654570721,5,1045,0.0,17
2020-01-20 19:00:00+01:00,168,15,153,20.304807772345505,167,18,149,21.39117903937357,5,1045,0.0,17
2020-01-20 20:00:00+01:00,166,16,150,18.57114730689396,170,20,150,19.775542485132945,5,1045,0.0,17
2020-01-20 21:00:00+01:00,122,13,109,20.245567873519157,131,15,116,14.183230975852695,5,1045,0.0,17
2020-01-20 22:00:00+01:00,89,8,81,17.562315027840828,89,8,81,17.562315027840828,5,1045,0.0,17
2020-01-20 23:00:00+01:00,63,5,58,14.929801273937542,62,6,56,14.48690450543278,5,1045,0.0,17
2020-01-21 00:00:00+01:00,44,3,41,6.744796902616623,54,5,49,10.37826089518735,5,1044,0.0,12
2020-01-21 01:00:00+01:00,32,3,29,5.041092888653022,36,4,32,3.0873599992209124,5,1044,0.0,12
2020-01-21 02:00:00+01:00,32,2,30,5.041092888653022,36,4,32,3.0873599992209124,5,1044,0.0,12
2020-01-21 03:00:00+01:00,49,4,45,13.911731041947528,50,5,45,13.688855833793909,5,1044,0.0,12
2020-01-21 04:00:00+01:00,83,7,76,18.699193296190067,85,8,77,19.289671453475872,5,1044,0.0,12
2020-01-21 05:00:00+01:00,139,12,127,18.732486269107348,151,15,136,19.408157188048275,5,1044,0.0,12
2020-01-21 06:00:00+01:00,175,14,161,17.666202741429842,200,19,181,19.256012935412965,5,1044,0.0,12
2020-01-21 07:00:00+01:00,262,24,238,18.255168653975332,310,34,276,16.921651532922695,5,1044,0.0,12
2020-01-21 08:00:00+01:00,286,24,262,20.398524223626136,330,36,294,16.43301680059058,5,1044,0.0,12
2020-01-21 09:00:00+01:00,186,16,170,22.772295906033783,202,17,185,22.500350864850866,5,1044,0.0,12
2020-01-21 10:00:00+01:00,151,13,138,19.408157188048275,176,15,161,20.324791671108635,5,1044,0.0,12
2020-01-21 11:00:00+01:00,191,18,173,20.658016380524305,217,23,194,21.833662628048735,5,1044,0.0,12
2020-01-21 12:00:00+01:00,152,13,139,20.188330220444417,178,16,162,19.804789777436813,5,1044,0.0,12
2020-01-21 13:00:00+01:00,156,12,144,23.175119746499636,170,19,151,19.775542485132945,5,1044,0.0,12
2020-01-21 14:00:00+01:00,168,14,154,20.304807772345505,176,17,159,20.324791671108635,5,1044,0.0,12
2020-01-21 15:00:00+01:00,175,17,158,17.666202741429842,200,19,181,19.256012935412965,5,1044,0.0,12
2020-01-21 16:00:00+01:00,184,16,168,20.655558446800804,209,18,191,22.16757043059366,5,1044,0.0,12
2020-01-21 17:00:00+01:00,272,22,250,23.2664106640069,300,33,267,19.621479548992166,5,1044,0.0,12
2020-01-21 18:00:00+01:00,274,24,250,20.56786912693606,320,36,284,21.04137400974582,5,1044,0.0,12
2020-01-21 19:00:00+01:00,219,21,198,21.009686825041197,227,19,208,19.269071808142694,5,1044,0.0,12
2020-01-21 20:00:00+01:00,198,17,181,18.14522738171017,235,20,215,20.674840106170866,5,1044,0.0,12
2020-01-21 21:00:00+01:00,160,15,145,19.89239402952506,175,14,161,17.666202741429842,5,1044,0.0,12
2020-01-21 22:00:00+01:00,117,10,107,21.891304075969387,127,12,115,19.116953333289125,5,1044,0.0,12
2020-01-21 23:00:00+01:00,75,6,69,14.734681497037354,91,9,82,13.154481673544206,5,1044,0.0,12
2020-01-22 00:00:00+01:00,64,7,57,14.026099803141571,60,6,54,13.20628140081713,4,1039,0.0,7
2020-01-22 01:00:00+01:00,43,5,38,7.555366152542149,41,5,36,4.9345676418029445,4,1039,0.0,7
2020-01-22 02:00:00+01:00,43,4,39,7.555366152542149,41,5,36,4.9345676418029445,4,1039,0.0,7
2020-01-22 03:00:00+01:00,65,7,58,10.373259911317103,65,6,59,10.373259911317103,4,1039,0.0,7
2020-01-22 04:00:00+01:00,110,12,98,14.109887773033899,98,10,88,18.03644044567539,4,1039,0.0,7
2020-01-22 05:00:00+01:00,198,22,176,16.831897106241644,186,19,167,14.511740402245575,4,1039,0.0,7
2020-01-22 06:00:00+01:00,242,31,211,18.29710618225889,243,29,214,25.380099969640305,4,1039,0.0,7
2020-01-22 07:00:00+01:00,371,49,322,19.26013813327,347,44,303,19.054171185340035,4,1039,0.0,7
2020-01-22 08:00:00+01:00,397,49,348,17.68183590028467,352,39,313,22.013609081992854,4,1039,0.0,7
2020-01-22 09:00:00+01:00,262,30,232,22.836816144401386,252,24,228,19.64962099491398,4,1039,0.0,7
2020-01-22 10:00:00+01:00,216,24,192,19.85285941667913,205,20,185,18.29833304368066,4,1039,0.0,7
2020-01-22 11:00:00+01:00,266,35,231,19.44559969107549,236,24,212,11.423053117408324,4,1039,0.0,7
2020-01-22 12:00:00+01:00,219,25,194,24.028704787177322,214,24,190,24.48806340301503,4,1039,0.0,7
2020-01-22 13:00:00+01:00,217,25,192,20.47500927792046,216,24,192,19.85285941667913,4,1039,0.0,7
2020-01-22 14:00:00+01:00,217,25,192,20.47500927792046,216,24,192,19.85285941667913,4,1039,0.0,7
2020-01-22 15:00:00+01:00,240,27,213,19.23767446741953,228,27,201,11.999655172013497,4,1039,0.0,7
2020-01-22 16:00:00+01:00,261,30,231,22.290397298498814,252,24,228,19.64962099491398,4,1039,0.0,7
2020-01-22 17:00:00+01:00,366,41,325,18.901447571833554,364,41,323,21.051236699694496,4,1039,0.0,7
2020-01-22 18:00:00+01:00,396,51,345,22.018658697036606,361,35,326,18.620400096098233,4,1039,0.0,7
2020-01-22 19:00:00+01:00,287,38,249,21.022527027479835,268,26,242,19.54671273578713,4,1039,0.0,7
2020-01-22 20:00:00+01:00,287,38,249,21.022527027479835,268,26,242,19.54671273578713,4,1039,0.0,7
2020-01-22 21:00:00+01:00,219,29,190,24.028704787177322,214,24,190,24.48806340301503,4,1039,0.0,7
2020-01-22 22:00:00+01:00,152,17,135,20.701024990887795,140,17,123,17.88117043007633,4,1039,0.0,7
2020-01-22 23:00:00+01:00,110,12,98,14.109887773033899,98,10,88,18.03644044567539,4,1039,0.0,7
2020-01-23 00:00:00+01:00,47,3,44,10.718407092962304,47,6,41,10.718407092962304,5,1033,0.0,12
2020-01-23 01:00:00+01:00,29,2,27,3.1672610972900266,30,4,26,3.420694029650136,5,1033,0.0,12
2020-01-23 02:00:00+01:00,30,2,28,3.420694029650136,33,4,29,5.985660510090718,5,1033,0.0,12
2020-01-23 03:00:00+01:00,45,3,42,8.16653528554085,49,7,42,13.911731041947528,5,1033,0.0,12
2020-01-23 04:00:00+01:00,82,6,76,16.39179981762634,83,12,71,18.699193296190067,5,1033,0.0,12
2020-01-23 05:00:00+01:00,132,11,121,19.37004764296085,146,23,123,20.98788244482569,5,1033,0.0,12
2020-01-23 06:00:00+01:00,179,15,164,19.18236787964663,184,28,156,20.655558446800804,5,1033,0.0,12
2020-01-23 07:00:00+01:00,255,19,236,21.41944964647189,284,35,249,21.60666647068217,5,1033,0.0,12
2020-01-23 08:00:00+01:00,273,20,253,23.61851837889036,301,37,264,16.897732473063776,5,1033,0.0,12
2020-01-23 09:00:00+01:00,178,13,165,19.804789777436813,194,24,170,21.593451125557873,5,1033,0.0,12
2020-01-23 10:00:00+01:00,167,15,152,21.39117903937357,163,22,141,20.41127666656249,5,1033,0.0,12
2020-01-23 11:00:00+01:00,172,13,159,19.644113972447897,196,31,165,20.04912381427717,5,1033,0.0,12
2020-01-23 12:00:00+01:00,160,14,146,19.89239402952506,162,19,143,19.08849102929865,5,1033,0.0,12
2020-01-23 13:00:00+01:00,168,13,155,20.304807772345505,163,22,141,20.41127666656249,5,1033,0.0,12
2020-01-23 14:00:00+01:00,143,11,132,22.510370466296816,159,24,135,17.78748005044877,5,1033,0.0,12
2020-01-23 15:00:00+01:00,186,14,172,22.772295906033783,171,21,150,22.137070929890193,5,1033,0.0,12
2020-01-23 16:00:00+01:00,179,14,165,19.18236787964663,202,31,171,22.500350864850866,5,1033,0.0,12
2020-01-23 17:00:00+01:00,245,20,225,18.942213831390788,277,42,235,24.920160895876304,5,1033,0.0,12
2020-01-23 18:00:00+01:00,291,24,267,17.50237418524224,291,38,253,17.50237418524224,5,1033,0.0,12
2020-01-23 19:00:00+01:00,195,15,180,23.83440770251287,219,27,192,21.009686825041197,5,1033,0.0,12
2020-01-23 20:00:00+01:00,216,17,199,21.273439412003903,217,34,183,21.833662628048735,5,1033,0.0,12
2020-01-23 21:00:00+01:00,170,13,157,19.775542485132945,156,24,132,23.175119746499636,5,1033,0.0,12
2020-01-23 22:00:00+01:00,102,9,93,13.093305626972347,116,14,102,23.67872830820291,5,1033,0.0,12
2020-01-23 23:00:00+01:00,85,7,78,19.289671453475872,79,11,68,16.382916607013883,5,1033,0.0,12
2020-01-24 00:00:00+01:00,74,7,67,19.513800836509724,76,7,69,16.686685835236233,5,1025,0.0,5
2020-01-24 01:00:00+01:00,48,5,43,12.297077384196717,50,4,46,13.688855833793909,5,1025,0.0,5
2020-01-24 02:00:00+01:00,50,4,46,13.688855833793909,50,4,46,13.688855833793909,5,1025,0.0,5
2020-01-24 03:00:00+01:00,76,7,69,16.686685835236233,72,8,64,19.53768091870668,5,1025,0.0,5
2020-01-24 04:00:00+01:00,127,11,116,19.116953333289125,117,11,106,21.891304075969387,5,1025,0.0,5
2020-01-24 05:00:00+01:00,232,23,209,14.357520231191923,228,20,208,15.818609956751573,5,1025,0.0,5
2020-01-24 06:00:00+01:00,268,25,243,16.114987230113258,270,24,246,23.920073269237992,5,1025,0.0,5
2020-01-24 07:00:00+01:00,430,39,391,19.32256414396262,414,36,378,21.211929621647883,5,1025,0.0,5
2020-01-24 08:00:00+01:00,464,48,416,21.884111394069308,434,37,397,17.25970681294468,5,1025,0.0,5
2020-01-24 09:00:00+01:00,311,31,280,16.325599187415413,299,28,271,15.06368464327721,5,1025,0.0,5
2020-01-24 10:00:00+01:00,244,24,220,17.108671526861457,246,24,222,17.57126233227549,5,1025,0.0,5
2020-01-24 11:00:00+01:00,299,31,268,15.06368464327721,285,28,257,23.62629721954127,5,1025,0.0,5
2020-01-24 12:00:00+01:00,256,27,229,20.451990100158973,254,22,232,21.33413531955627,5,1025,0.0,5
2020-01-24 13:00:00+01:00,250,27,223,14.642007731534619,246,26,220,17.57126233227549,5,1025,0.0,5
2020-01-24 14:00:00+01:00,248,25,223,17.312704307039937,246,26,220,17.57126233227549,5,1025,0.0,5
2020-01-24 15:00:00+01:00,272,28,244,23.2664106640069,274,31,243,20.56786912693606,5,1025,0.0,5
2020-01-24 16:00:00+01:00,301,32,269,16.897732473063776,291,26,265,17.50237418524224,5,1025,0.0,5
2020-01-24 17:00:00+01:00,422,39,383,20.257299015157166,412,46,366,21.450154879298072,5,1025,0.0,5
2020-01-24 18:00:00+01:00,464,48,416,21.884111394069308,434,37,397,17.25970681294468,5,1025,0.0,5
2020-01-24 19:00:00+01:00,337,34,303,21.494538760895587,335,30,305,21.419812345615075,5,1025,0.0,5
2020-01-24 20:00:00+01:00,317,32,285,23.692514426518255,313,31,282,23.332837891570005,5,1025,0.0,5
2020-01-24 21:00:00+01:00,248,22,226,17.312704307039937,246,26,220,17.57126233227549,5,1025,0.0,5
2020-01-24 22:00:00+01:00,173,18,155,20.37647841384157,175,19,156,17.666202741429842,5,1025,0.0,5
2020-01-24 23:00:00+01:00,129,12,117,17.995114557081255,123,10,113,19.074654696202938,5,1025,0.0,5
2020-01-25 00:00:00+01:00,82,5,77,8.6962433625344,86,4,82,9.565861223121674,6,1023,0.0,4
2020-01-25 01:00:00+01:00,55,3,52,10.027044718132117,55,3,52,10.027044718132117,6,1023,0.0,4
2020-01-25 02:00:00+01:00,53,3,50,12.671576687621188,57,2,55,11.247345675463038,6,1023,0.0,4
2020-01-25 03:00:00+01:00,84,5,79,7.6306798135980785,86,4,82,9.565861223121674,6,1023,0.0,4
2020-01-25 04:00:00+01:00,113,6,107,20.97275705288615,115,6,109,14.522258078721798,6,1023,0.0,4
2020-01-25 05:00:00+01:00,140,8,132,15.157104538016958,146,9,137,19.4340926707284,6,1023,0.0,4
2020-01-25 06:00:00+01:00,220,12,208,20.77869221062603,229,12,217,20.858973540615885,6,1023,0.0,4
2020-01-25 07:00:00+01:00,331,21,310,19.942495480727644,351,19,332,17.103376818692087,6,1023,0.0,4
2020-01-25 08:00:00+01:00,449,28,421,17.9741178967318,464,24,440,21.34229223380193,6,1023,0.0,4
2020-01-25 09:00:00+01:00,476,28,448,20.090041264055532,493,27,466,15.790488496822915,6,1023,0.0,4
2020-01-25 10:00:00+01:00,407,25,382,18.86836233630375,442,27,415,22.71527178577055,6,1023,0.0,4
2020-01-25 11:00:00+01:00,327,20,307,19.796623391570257,353,19,334,19.24169978578992,6,1023,0.0,4
2020-01-25 12:00:00+01:00,335,22,313,21.63506552863301,351,20,331,17.103376818692087,6,1023,0.0,4
2020-01-25 13:00:00+01:00,364,23,341,14.261868127983336,384,24,360,20.93762948810624,6,1023,0.0,4
2020-01-25 14:00:00+01:00,342,21,321,17.3694729072073,349,20,329,19.114918279434413,6,1023,0.0,4
2020-01-25 15:00:00+01:00,400,23,377,18.964845929792475,402,26,376,13.628611178524041,6,1023,0.0,4
2020-01-25 16:00:00+01:00,380,25,355,20.736920018387448,409,24,385,21.901781937406163,6,1023,0.0,4
2020-01-25 17:00:00+01:00,442,30,412,22.71527178577055,462,27,435,22.520787209725228,6,1023,0.0,4
2020-01-25 18:00:00+01:00,418,25,393,19.95137004302942,436,25,411,17.144177199139556,6,1023,0.0,4
2020-01-25 19:00:00+01:00,327,19,308,19.796623391570257,353,19,334,19.24169978578992,6,1023,0.0,4
2020-01-25 20:00:00+01:00,307,20,287,16.74476305242919,315,20,295,17.275310260978717,6,1023,0.0,4
2020-01-25 21:00:00+01:00,282,18,264,20.995138580232226,289,15,274,18.938144972747136,6,1023,0.0,4
2020-01-25 22:00:00+01:00,215,12,203,14.020699077914754,231,11,220,18.808415660395674,6,1023,0.0,4
2020-01-25 23:00:00+01:00,111,7,104,16.60196152330297,115,6,109,14.522258078721798,6,1023,0.0,4
2020-01-26 00:00:00+01:00,44,1,43,9.212556088945261,56,2,54,11.681432660358455,7,1018,0.0,7
2020-01-26 01:00:00+01:00,26,1,25,0.13434729751860394,38,1,37,5.960450042509954,7,1018,0.0,7
2020-01-26 02:00:00+01:00,28,1,27,0.9732919408254891,38,1,37,5.960450042509954,7,1018,0.0,7
2020-01-26 03:00:00+01:00,42,1,41,10.321824814537676,56,1,55,11.681432660358455,7,1018,0.0,7
2020-01-26 04:00:00+01:00,52,2,50,14.472017643602554,72,3,69,10.765287360581397,7,1018,0.0,7
2020-01-26 05:00:00+01:00,70,2,68,11.628132043946147,78,3,75,10.154730086809042,7,1018,0.0,7
2020-01-26 06:00:00+01:00,117,4,113,13.539944397802945,135,5,130,20.27811899595658,7,1018,0.0,7
2020-01-26 07:00:00+01:00,176,6,170,16.20057962349047,180,6,174,18.453361889556408,7,1018,0.0,7
2020-01-26 08:00:00+01:00,222,8,214,17.594973015311762,261,10,251,17.831444140197515,7,1018,0.0,7
2020-01-26 09:00:00+01:00,253,9,244,17.73107046839405,334,13,321,17.139636433234756,7,1018,0.0,7
2020-01-26 10:00:00+01:00,216,7,209,17.62117954457743,216,8,208,17.62117954457743,7,1018,0.0,7
2020-01-26 11:00:00+01:00,162,6,156,18.435104799511247,206,7,199,20.90053052788098,7,1018,0.0,7
2020-01-26 12:00:00+01:00,166,6,160,16.094287115128708,210,9,201,17.488096079787415,7,1018,0.0,7
2020-01-26 13:00:00+01:00,182,6,176,16.329362148305133,208,7,201,18.807092053665322,7,1018,0.0,7
2020-01-26 14:00:00+01:00,172,7,165,18.863206387348974,176,5,171,16.20057962349047,7,1018,0.0,7
2020-01-26 15:00:00+01:00,190,7,183,20.182913119811044,259,8,251,22.975221531884507,7,1018,0.0,7
2020-01-26 16:00:00+01:00,208,8,200,18.807092053665322,255,10,245,13.80583098758932,7,1018,0.0,7
2020-01-26 17:00:00+01:00,232,9,223,19.09590246733257,269,10,259,22.758175655823944,7,1018,0.0,7
2020-01-26 18:00:00+01:00,216,7,209,17.62117954457743,216,8,208,17.62117954457743,7,1018,0.0,7
2020-01-26 19:00:00+01:00,162,6,156,18.435104799511247,206,7,199,20.90053052788098,7,1018,0.0,7
2020-01-26 20:00:00+01:00,151,6,145,19.14578123638998,184,6,178,19.759138180971462,7,1018,0.0,7
2020-01-26 21:00:00+01:00,141,5,136,17.007652233540448,196,7,189,22.483124652822625,7,1018,0.0,7
2020-01-26 22:00:00+01:00,109,4,105,18.214376818550008,149,5,144,17.937448228249327,7,1018,0.0,7
2020-01-26 23:00:00+01:00,54,2,52,11.483713237443984,64,2,62,8.557251957401023,7,1018,0.0,7
2020-01-27 00:00:00+01:00,38,4,34,11.101073107969722,39,4,35,6.782457974710225,9,1014,0.2,20
2020-01-27 01:00:00+01:00,24,2,22,1.5004308879154395,26,2,24,1.5382661455122164,9,1014,0.2,20
2020-01-27 02:00:00+01:00,24,2,22,1.5004308879154395,26,2,24,1.5382661455122164,9,1014,0.2,20
2020-01-27 03:00:00+01:00,37,3,34,2.066086063070793,39,4,35,6.782457974710225,9,1014,0.2,20
2020-01-27 04:00:00+01:00,60,5,55,10.583722413773145,62,6,56,14.48690450543278,9,1014,0.2,20
2020-01-27 05:00:00+01:00,108,10,98,14.813734676069407,112,11,101,14.898852003445265,9,1014,0.2,20
2020-01-27 06:00:00+01:00,136,13,123,16.594078125250377,142,16,126,21.623487252479663,9,1014,0.2,20
2020-01-27 07:00:00+01:00,226,22,204,20.308697708911414,214,23,191,18.560318290748608,9,1014,0.2,20
2020-01-27 08:00:00+01:00,239,24,215,13.74553452780325,235,29,206,20.674840106170866,9,1014,0.2,20
2020-01-27 09:00:00+01:00,154,16,138,23.457384968254527,151,18,133,19.408157188048275,9,1014,0.2,20
2020-01-27 10:00:00+01:00,128,11,117,19.601953989978306,128,12,116,19.601953989978306,9,1014,0.2,20
2020-01-27 11:00:00+01:00,152,13,139,20.188330220444417,154,15,139,23.457384968254527,9,1014,0.2,20
2020-01-27 12:00:00+01:00,123,13,110,19.074654696202938,128,14,114,19.601953989978306,9,1014,0.2,20
2020-01-27 13:00:00+01:00,127,11,116,19.116953333289125,125,13,112,23.026828253397017,9,1014,0.2,20
2020-01-27 14:00:00+01:00,127,11,116,19.116953333289125,125,13,112,23.026828253397017,9,1014,0.2,20
2020-01-27 15:00:00+01:00,139,12,127,18.732486269107348,137,15,122,18.928795118329443,9,1014,0.2,20
2020-01-27 16:00:00+01:00,145,14,131,18.85528596371164,157,17,140,23.857880119976507,9,1014,0.2,20
2020-01-27 17:00:00+01:00,216,21,195,21.273439412003903,220,27,193,16.758079648934128,9,1014,0.2,20
2020-01-27 18:00:00+01:00,228,21,207,15.818609956751573,225,22,203,17.07968654570721,9,1014,0.2,20
2020-01-27 19:00:00+01:00,168,15,153,20.304807772345505,167,18,149,21.39117903937357,9,1014,0.2,20
2020-01-27 20:00:00+01:00,166,16,150,18.57114730689396,170,20,150,19.775542485132945,9,1014,0.2,20
2020-01-27 21:00:00+01:00,122,13,109,20.245567873519157,131,15,116,14.183230975852695,9,1014,0.2,20
2020-01-27 22:00:00+01:00,89,8,81,17.562315027840828,89,8,81,17.562315027840828,9,1014,0.2,20
2020-01-27 23:00:00+01:00,63,5,58,14.929801273937542,62,6,56,14.48690450543278,9,1014,0.2,20
2020-01-28 00:00:00+01:00,33,2,31,5.985660510090718,39,3,36,6.782457974710225,6,1000,2.3,22
2020-01-28 01:00:00+01:00,22,1,21,0.1277873501672996,26,2,24,1.5382661455122164,6,1000,2.3,22
2020-01-28 02:00:00+01:00,25,2,23,1.1875344360364632,27,2,25,1.9016023008994223,6,1000,2.3,22
2020-01-28 03:00:00+01:00,38,3,35,11.101073107969722,40,4,36,5.275608835029151,6,1000,2.3,22
2020-01-28 04:00:00+01:00,62,5,57,14.48690450543278,62,5,57,14.48690450543278,6,1000,2.3,22
2020-01-28 05:00:00+01:00,101,8,93,11.280950715811313,121,12,109,20.317620945183666,6,1000,2.3,22
2020-01-28 06:00:00+01:00,138,11,127,20.21600799483387,138,14,124,20.21600799483387,6,1000,2.3,22
2020-01-28 07:00:00+01:00,192,17,175,21.295822766447603,225,21,204,17.07968654570721,6,1000,2.3,22
2020-01-28 08:00:00+01:00,218,18,200,22.57742359713229,242,27,215,20.990360069331732,6,1000,2.3,22
2020-01-28 09:00:00+01:00,142,13,129,21.623487252479663,164,16,148,22.827361263214527,6,1000,2.3,22
2020-01-28 10:00:00+01:00,129,10,119,17.995114557081255,131,11,120,14.183230975852695,6,1000,2.3,22
2020-01-28 11:00:00+01:00,142,11,131,21.623487252479663,164,16,148,22.827361263214527,6,1000,2.3,22
2020-01-28 12:00:00+01:00,129,10,119,17.995114557081255,131,11,120,14.183230975852695,6,1000,2.3,22
2020-01-28 13:00:00+01:00,119,9,110,22.46945513312648,129,12,117,17.995114557081255,6,1000,2.3,22
2020-01-28 14:00:00+01:00,119,9,110,22.46945513312648,129,12,117,17.995114557081255,6,1000,2.3,22
2020-01-28 15:00:00+01:00,130,10,120,15.65660051079879,144,12,132,22.91915418498221,6,1000,2.3,22
2020-01-28 16:00:00+01:00,139,13,126,18.732486269107348,150,15,135,17.939622434692456,6,1000,2.3,22
2020-01-28 17:00:00+01:00,209,17,192,22.16757043059366,224,19,205,16.30248157536985,6,1000,2.3,22
2020-01-28 18:00:00+01:00,213,17,196,20.488166305452438,246,24,222,17.57126233227549,6,1000,2.3,22
2020-01-28 19:00:00+01:00,153,14,139,14.915022999208679,172,15,157,19.644113972447897,6,1000,2.3,22
2020-01-28 20:00:00+01:00,155,15,140,19.469409355748308,165,18,147,20.56038540292619,6,1000,2.3,22
2020-01-28 21:00:00+01:00,119,11,108,22.46945513312648,129,12,117,17.995114557081255,6,1000,2.3,22
2020-01-28 22:00:00+01:00,83,6,77,18.699193296190067,90,9,81,13.960700117154147,6,1000,2.3,22
2020-01-28 23:00:00+01:00,58,4,54,10.505136369992313,67,7,60,12.5039951599288,6,1000,2.3,22
2020-01-29 00:00:00+01:00,38,4,34,7.590795833711637,34,3,31,11.019687492562438,6,1010,0.6,21
2020-01-29 01:00:00+01:00,25,3,22,4.851536786659508,25,2,23,4.851536786659508,6,1010,0.6,21
2020-01-29 02:00:00+01:00,25,2,23,4.851536786659508,25,2,23,4.851536786659508,6,1010,0.6,21
2020-01-29 03:00:00+01:00,38,4,34,7.590795833711637,34,3,31,11.019687492562438,6,1010,0.6,21
2020-01-29 04:00:00+01:00,63,7,56,13.630126271531418,62,6,56,12.779859753427614,6,1010,0.6,21
2020-01-29 05:00:00+01:00,114,13,101,17.516346710171707,112,12,100,16.537505199847164,6,1010,0.6,21
2020-01-29 06:00:00+01:00,140,19,121,17.88117043007633,141,14,127,16.082921323202,6,1010,0.6,21
2020-01-29 07:00:00+01:00,214,24,190,24.48806340301503,203,19,184,21.5050173548228,6,1010,0.6,21
2020-01-29 08:00:00+01:00,226,28,198,20.105295377891462,220,27,193,18.729640796362187,6,1010,0.6,21
2020-01-29 09:00:00+01:00,153,19,134,18.89706115395996,139,16,123,21.474746575274906,6,1010,0.6,21
2020-01-29 10:00:00+01:00,126,17,109,16.250667590352332,123,13,110,15.262138605096247,6,1010,0.6,21
2020-01-29 11:00:00+01:00,153,18,135,18.89706115395996,139,16,123,21.474746575274906,6,1010,0.6,21
2020-01-29 12:00:00+01:00,126,17,109,16.250667590352332,123,13,110,15.262138605096247,6,1010,0.6,21
2020-01-29 13:00:00+01:00,127,15,112,19.95892802947898,120,14,106,10.291257377501918,6,1010,0.6,21
2020-01-29 14:00:00+01:00,127,16,111,19.95892802947898,120,14,106,10.291257377501918,6,1010,0.6,21
2020-01-29 15:00:00+01:00,140,18,122,17.88117043007633,141,14,127,16.082921323202,6,1010,0.6,21
2020-01-29 16:00:00+01:00,151,17,134,19.198981193831877,149,16,133,18.476483571588744,6,1010,0.6,21
2020-01-29 17:00:00+01:00,217,26,191,20.47500927792046,213,24,189,16.70464389525102,6,1010,0.6,21
2020-01-29 18:00:00+01:00,232,26,206,24.606618615768106,205,22,183,18.29833304368066,6,1010,0.6,21
2020-01-29 19:00:00+01:00,167,22,145,16.493575022686013,154,14,140,25.102227050596255,6,1010,0.6,21
2020-01-29 20:00:00+01:00,167,21,146,16.493575022686013,154,14,140,25.102227050596255,6,1010,0.6,21
2020-01-29 21:00:00+01:00,129,16,113,12.321757402623772,125,13,112,14.698947587184879,6,1010,0.6,21
2020-01-29 22:00:00+01:00,89,11,78,16.127888447212325,79,9,70,16.621554061874914,6,1010,0.6,21
2020-01-29 23:00:00+01:00,63,8,55,13.630126271531418,62,6,56,12.779859753427614,6,1010,0.6,21
2020-01-30 00:00:00+01:00,60,4,56,10.583722413773145,60,8,52,10.583722413773145,9,1016,0.0,12
2020-01-30 01:00:00+01:00,36,2,34,3.0873599992209124,43,5,38,8.573704494863009,9,1016,0.0,12
2020-01-30 02:00:00+01:00,39,3,36,6.782457974710225,39,5,34,6.782457974710225,9,1016,0.0,12
2020-01-30 03:00:00+01:00,55,4,51,8.909875597117273,65,8,57,15.361527134905547,9,1016,0.0,12
2020-01-30 04:00:00+01:00,109,9,100,14.645038576883659,100,13,87,11.502705756568044,9,1016,0.0,12
2020-01-30 05:00:00+01:00,183,15,168,16.4856647978058,183,23,160,16.4856647978058,9,1016,0.0,12
2020-01-30 06:00:00+01:00,209,16,193,22.16757043059366,235,29,206,20.674840106170866,9,1016,0.0,12
2020-01-30 07:00:00+01:00,341,30,311,14.480776847696712,371,45,326,20.767700865402965,9,1016,0.0,12
2020-01-30 08:00:00+01:00,395,30,365,19.65690968439359,386,53,333,18.304254687443294,9,1016,0.0,12
2020-01-30 09:00:00+01:00,249,20,229,20.976233072746222,256,36,220,20.451990100158973,9,1016,0.0,12
2020-01-30 10:00:00+01:00,223,18,205,21.320656431140716,204,28,176,12.517560993101368,9,1016,0.0,12
2020-01-30 11:00:00+01:00,260,20,240,21.14564444182058,251,38,213,19.570183352800104,9,1016,0.0,12
2020-01-30 12:00:00+01:00,197,17,180,19.020846849172088,220,27,193,16.758079648934128,9,1016,0.0,12
2020-01-30 13:00:00+01:00,197,15,182,19.020846849172088,220,27,193,16.758079648934128,9,1016,0.0,12
2020-01-30 14:00:00+01:00,197,15,182,19.020846849172088,220,27,193,16.758079648934128,9,1016,0.0,12
2020-01-30 15:00:00+01:00,216,16,200,21.273439412003903,240,38,202,16.023164601360044,9,1016,0.0,12
2020-01-30 16:00:00+01:00,265,23,242,24.143057918667047,253,34,219,24.084070139549794,9,1016,0.0,12
2020-01-30 17:00:00+01:00,336,29,307,23.28683107716768,369,53,316,22.180217499440115,9,1016,0.0,12
2020-01-30 18:00:00+01:00,348,29,319,20.566317862558048,377,53,324,16.83689607567409,9,1016,0.0,12
2020-01-30 19:00:00+01:00,284,23,261,21.60666647068217,277,34,243,24.920160895876304,9,1016,0.0,12
2020-01-30 20:00:00+01:00,273,23,250,23.61851837889036,284,35,249,21.60666647068217,9,1016,0.0,12
2020-01-30 21:00:00+01:00,197,14,183,19.020846849172088,220,27,193,16.758079648934128,9,1016,0.0,12
2020-01-30 22:00:00+01:00,136,10,126,16.594078125250377,150,21,129,17.939622434692456,9,1016,0.0,12
2020-01-30 23:00:00+01:00,102,7,95,13.093305626972347,109,13,96,14.645038576883659,9,1016,0.0,12
2020-01-31 00:00:00+01:00,59,5,54,10.572210467564378,57,5,52,10.480552878481939,12,1011,0.0,16
2020-01-31 01:00:00+01:00,41,3,38,8.457036189746331,41,3,38,8.457036189746331,12,1011,0.0,16
2020-01-31 02:00:00+01:00,41,4,37,8.457036189746331,41,3,38,8.457036189746331,12,1011,0.0,16
2020-01-31 03:00:00+01:00,62,6,56,14.48690450543278,57,5,52,10.480552878481939,12,1011,0.0,16
2020-01-31 04:00:00+01:00,103,9,94,12.113442962320551,101,10,91,11.280950715811313,12,1011,0.0,16
2020-01-31 05:00:00+01:00,185,19,166,20.160625004949942,177,15,162,20.028957588616944,12,1011,0.0,16
2020-01-31 06:00:00+01:00,230,23,207,17.120376816836934,226,20,206,20.308697708911414,12,1011,0.0,16
2020-01-31 07:00:00+01:00,340,33,307,18.92958933704513,351,29,322,16.04918751558848,12,1011,0.0,16
2020-01-31 08:00:00+01:00,363,36,327,20.037936765942277,361,41,320,19.1870055662437,12,1011,0.0,16
2020-01-31 09:00:00+01:00,253,27,226,24.084070139549794,241,25,216,21.076687701702674,12,1011,0.0,16
2020-01-31 10:00:00+01:00,202,20,182,22.500350864850866,192,18,174,21.295822766447603,12,1011,0.0,16
2020-01-31 11:00:00+01:00,245,23,222,18.942213831390788,241,25,216,21.076687701702674,12,1011,0.0,16
2020-01-31 12:00:00+01:00,202,20,182,22.500350864850866,192,18,174,21.295822766447603,12,1011,0.0,16
2020-01-31 13:00:00+01:00,203,19,184,24.82410288636225,195,19,176,23.83440770251287,12,1011,0.0,16
2020-01-31 14:00:00+01:00,210,22,188,16.3212742992447,203,17,186,24.82410288636225,12,1011,0.0,16
2020-01-31 15:00:00+01:00,220,22,198,16.758079648934128,220,19,201,16.758079648934128,12,1011,0.0,16
2020-01-31 16:00:00+01:00,243,22,221,18.936896488437778,240,25,215,16.023164601360044,12,1011,0.0,16
2020-01-31 17:00:00+01:00,345,34,311,18.48984602659702,350,40,310,21.39774246689966,12,1011,0.0,16
2020-01-31 18:00:00+01:00,370,37,333,20.548579550699223,356,33,323,20.092398613710877,12,1011,0.0,16
2020-01-31 19:00:00+01:00,263,25,238,18.706444640225143,273,30,243,23.61851837889036,12,1011,0.0,16
2020-01-31 20:00:00+01:00,268,24,244,16.114987230113258,259,23,236,22.988395045636892,12,1011,0.0,16
2020-01-31 21:00:00+01:00,200,19,181,19.256012935412965,195,19,176,23.83440770251287,12,1011,0.0,16
2020-01-31 22:00:00+01:00,146,15,131,20.98788244482569,146,12,134,20.98788244482569,12,1011,0.0,16
2020-01-31 23:00:00+01:00,105,10,95,15.778065052313549,103,11,92,12.113442962320551,12,1011,0.0,16
2020-02-01 00:00:00+01:00,57,3,54,11.247345675463038,60,3,57,12.98342242386016,13,1012,0.0,18
2020-02-01 01:00:00+01:00,38,2,36,5.960450042509954,40,2,38,6.907029621336792,13,1012,0.0,18
2020-02-01 02:00:00+01:00,38,2,36,5.960450042509954,40,2,38,6.907029621336792,13,1012,0.0,18
2020-02-01 03:00:00+01:00,57,3,54,11.247345675463038,60,3,57,12.98342242386016,13,1012,0.0,18
2020-02-01 04:00:00+01:00,79,4,75,13.473204105951462,79,5,74,13.473204105951462,13,1012,0.0,18
2020-02-01 05:00:00+01:00,93,6,87,7.996959659096201,100,6,94,12.129363492765288,13,1012,0.0,18
2020-02-01 06:00:00+01:00,156,10,146,17.899214712227696,161,10,151,19.39413115763897,13,1012,0.0,18
2020-02-01 07:00:00+01:00,231,14,217,18.808415660395674,245,16,229,17.30944248589229,13,1012,0.0,18
2020-02-01 08:00:00+01:00,314,21,293,19.77016372636934,328,21,307,18.977288676463566,13,1012,0.0,18
2020-02-01 09:00:00+01:00,336,19,317,15.374523455613796,347,17,330,19.911580344317716,13,1012,0.0,18
2020-02-01 10:00:00+01:00,293,19,274,17.329297501722674,302,16,286,20.352052927472357,13,1012,0.0,18
2020-02-01 11:00:00+01:00,231,13,218,18.808415660395674,245,16,229,17.30944248589229,13,1012,0.0,18
2020-02-01 12:00:00+01:00,235,16,219,19.654447093292166,245,13,232,17.30944248589229,13,1012,0.0,18
2020-02-01 13:00:00+01:00,255,17,238,13.80583098758932,265,17,248,17.981103781954623,13,1012,0.0,18
2020-02-01 14:00:00+01:00,232,13,219,19.09590246733257,241,14,227,17.853279648834448,13,1012,0.0,18
2020-02-01 15:00:00+01:00,262,14,248,13.900090096773878,282,15,267,20.995138580232226,13,1012,0.0,18
2020-02-01 16:00:00+01:00,266,15,251,15.200054248100818,286,17,269,20.747694740560487,13,1012,0.0,18
2020-02-01 17:00:00+01:00,311,19,292,18.777054340822975,321,19,302,17.9619971253537,13,1012,0.0,18
2020-02-01 18:00:00+01:00,297,17,280,17.48190242862812,300,19,281,22.416712006057992,13,1012,0.0,18
2020-02-01 19:00:00+01:00,226,14,212,15.467390071610119,240,13,227,19.372323114313716,13,1012,0.0,18
2020-02-01 20:00:00+01:00,206,11,195,20.90053052788098,221,13,208,21.310706623471727,13,1012,0.0,18
2020-02-01 21:00:00+01:00,187,10,177,15.611538170802525,204,13,191,20.27930898180519,13,1012,0.0,18
2020-02-01 22:00:00+01:00,156,9,147,17.899214712227696,161,10,151,19.39413115763897,13,1012,0.0,18
2020-02-01 23:00:00+01:00,75,4,71,11.283880560685672,80,4,76,12.9514806028411,13,1012,0.0,18
2020-02-02 00:00:00+01:00,34,1,33,4.1719622498891535,44,1,43,9.212556088945261,13,1016,0.2,15
2020-02-02 01:00:00+01:00,23,0,23,0.14362729290738016,28,1,27,0.9732919408254891,13,1016,0.2,15
2020-02-02 02:00:00+01:00,23,0,23,0.14362729290738016,28,1,27,0.9732919408254891,13,1016,0.2,15
2020-02-02 03:00:00+01:00,34,1,33,4.1719622498891535,44,1,43,9.212556088945261,13,1016,0.2,15
2020-02-02 04:00:00+01:00,46,1,45,9.91060285131841,52,1,51,14.472017643602554,13,1016,0.2,15
2020-02-02 05:00:00+01:00,57,2,55,11.247345675463038,76,3,73,13.279950485691732,13,1016,0.2,15
2020-02-02 06:00:00+01:00,95,4,91,10.506818941407664,94,3,91,10.166272350500234,13,1016,0.2,15
2020-02-02 07:00:00+01:00,139,5,134,19.408576933840735,191,7,184,21.61132830766016,13,1016,0.2,15
2020-02-02 08:00:00+01:00,195,8,187,16.39636374930337,198,7,191,20.173795644408123,13,1016,0.2,15
2020-02-02 09:00:00+01:00,203,8,195,16.97445579481889,243,8,235,15.58217691478424,13,1016,0.2,15
2020-02-02 10:00:00+01:00,172,7,165,18.863206387348974,178,5,173,18.00585359354758,13,1016,0.2,15
2020-02-02 11:00:00+01:00,134,4,130,14.696678321454899,188,7,181,19.664617237016223,13,1016,0.2,15
2020-02-02 12:00:00+01:00,137,5,132,15.965917364236809,188,7,181,19.664617237016223,13,1016,0.2,15
2020-02-02 13:00:00+01:00,148,5,143,21.655119289441767,178,6,172,18.00585359354758,13,1016,0.2,15
2020-02-02 14:00:00+01:00,134,4,130,14.696678321454899,188,7,181,19.664617237016223,13,1016,0.2,15
2020-02-02 15:00:00+01:00,160,6,154,18.858823274894117,196,7,189,22.483124652822625,13,1016,0.2,15
2020-02-02 16:00:00+01:00,155,5,150,18.708796369633056,165,5,160,20.19240679449499,13,1016,0.2,15
2020-02-02 17:00:00+01:00,191,7,184,21.61132830766016,241,8,233,17.853279648834448,13,1016,0.2,15
2020-02-02 18:00:00+01:00,165,5,160,20.19240679449499,233,8,225,15.034753042734176,13,1016,0.2,15
2020-02-02 19:00:00+01:00,137,5,132,15.965917364236809,188,7,181,19.664617237016223,13,1016,0.2,15
2020-02-02 20:00:00+01:00,125,4,121,11.899638158178501,152,6,146,18.686880121910534,13,1016,0.2,15
2020-02-02 21:00:00+01:00,109,4,105,18.214376818550008,152,5,147,18.686880121910534,13,1016,0.2,15
2020-02-02 22:00:00+01:00,87,3,84,9.504121716770046,130,4,126,16.267882133132378,13,1016,0.2,15
2020-02-02 23:00:00+01:00,44,1,43,9.212556088945261,61,2,59,13.45123014142322,13,1016,0.2,15
2020-02-03 00:00:00+01:00,37,3,34,2.066086063070793,39,4,35,6.782457974710225,11,1016,1.6,21
2020-02-03 01:00:00+01:00,24,2,22,1.5004308879154395,26,2,24,1.5382661455122164,11,1016,1.6,21
2020-02-03 02:00:00+01:00,24,2,22,1.5004308879154395,26,2,24,1.5382661455122164,11,1016,1.6,21
2020-02-03 03:00:00+01:00,37,3,34,2.066086063070793,39,4,35,6.782457974710225,11,1016,1.6,21
2020-02-03 04:00:00+01:00,60,5,55,10.583722413773145,62,6,56,14.48690450543278,11,1016,1.6,21
2020-02-03 05:00:00+01:00,108,10,98,14.813734676069407,112,11,101,14.898852003445265,11,1016,1.6,21
2020-02-03 06:00:00+01:00,136,13,123,16.594078125250377,142,16,126,21.623487252479663,11,1016,1.6,21
2020-02-03 07:00:00+01:00,226,22,204,20.308697708911414,214,23,191,18.560318290748608,11,1016,1.6,21
2020-02-03 08:00:00+01:00,239,24,215,13.74553452780325,235,29,206,20.674840106170866,11,1016,1.6,21
2020-02-03 09:00:00+01:00,154,16,138,23.457384968254527,151,18,133,19.408157188048275,11,1016,1.6,21
2020-02-03 10:00:00+01:00,128,11,117,19.601953989978306,128,12,116,19.601953989978306,11,1016,1.6,21
2020-02-03 11:00:00+01:00,152,13,139,20.188330220444417,154,15,139,23.457384968254527,11,1016,1.6,21
2020-02-03 12:00:00+01:00,123,13,110,19.074654696202938,128,14,114,19.601953989978306,11,1016,1.6,21
2020-02-03 13:00:00+01:00,127,11,116,19.116953333289125,125,13,112,23.026828253397017,11,1016,1.6,21
2020-02-03 14:00:00+01:00,127,11,116,19.116953333289125,125,13,112,23.026828253397017,11,1016,1.6,21
2020-02-03 15:00:00+01:00,139,12,127,18.732486269107348,137,15,122,18.928795118329443,11,1016,1.6,21
2020-02-03 16:00:00+01:00,145,14,131,18.85528596371164,157,17,140,23.857880119976507,11,1016,1.6,21
2020-02-03 17:00:00+01:00,216,21,195,21.273439412003903,220,27,193,16.758079648934128,11,1016,1.6,21
2020-02-03 18:00:00+01:00,228,21,207,15.818609956751573,225,22,203,17.07968654570721,11,1016,1.6,21
2020-02-03 19:00:00+01:00,168,15,153,20.304807772345505,167,18,149,21.39117903937357,11,1016,1.6,21
2020-02-03 20:00:00+01:00,166,16,150,18.57114730689396,170,20,150,19.775542485132945,11,1016,1.6,21
2020-02-03 21:00:00+01:00,122,13,109,20.245567873519157,131,15,116,14.183230975852695,11,1016,1.6,21
2020-02-03 22:00:00+01:00,89,8,81,17.562315027840828,89,8,81,17.562315027840828,11,1016,1.6,21
2020-02-03 23:00:00+01:00,63,5,58,14.929801273937542,62,6,56,14.48690450543278,11,1016,1.6,21
2020-02-04 00:00:00+01:00,33,2,31,5.985660510090718,39,3,36,6.782457974710225,7,1016,5.7,26
2020-02-04 01:00:00+01:00,22,1,21,0.1277873501672996,26,2,24,1.5382661455122164,7,1016,5.7,26
2020-02-04 02:00:00+01:00,25,2,23,1.1875344360364632,27,2,25,1.9016023008994223,7,1016,5.7,26
2020-02-04 03:00:00+01:00,38,3,35,11.101073107969722,40,4,36,5.275608835029151,7,1016,5.7,26
2020-02-04 04:00:00+01:00,62,5,57,14.48690450543278,62,5,57,14.48690450543278,7,1016,5.7,26
2020-02-04 05:00:00+01:00,101,8,93,11.280950715811313,121,12,109,20.317620945183666,7,1016,5.7,26
2020-02-04 06:00:00+01:00,138,11,127,20.21600799483387,138,14,124,20.21600799483387,7,1016,5.7,26
2020-02-04 07:00:00+01:00,192,17,175,21.295822766447603,225,21,204,17.07968654570721,7,1016,5.7,26
2020-02-04 08:00:00+01:00,218,18,200,22.57742359713229,242,27,215,20.990360069331732,7,1016,5.7,26
2020-02-04 09:00:00+01:00,142,13,129,21.623487252479663,164,16,148,22.827361263214527,7,1016,5.7,26
2020-02-04 10:00:00+01:00,129,10,119,17.995114557081255,131,11,120,14.183230975852695,7,1016,5.7,26
2020-02-04 11:00:00+01:00,142,11,131,21.623487252479663,164,16,148,22.827361263214527,7,1016,5.7,26
2020-02-04 12:00:00+01:00,129,10,119,17.995114557081255,131,11,120,14.183230975852695,7,1016,5.7,26
2020-02-04 13:00:00+01:00,119,9,110,22.46945513312648,129,12,117,17.995114557081255,7,1016,5.7,26
2020-02-04 14:00:00+01:00,119,9,110,22.46945513312648,129,12,117,17.995114557081255,7,1016,5.7,26
2020-02-04 15:00:00+01:00,130,10,120,15.65660051079879,144,12,132,22.91915418498221,7,1016,5.7,26
2020-02-04 16:00:00+01:00,139,13,126,18.732486269107348,150,15,135,17.939622434692456,7,1016,5.7,26
2020-02-04 17:00:00+01:00,209,17,192,22.16757043059366,224,19,205,16.30248157536985,7,1016,5.7,26
2020-02-04 18:00:00+01:00,213,17,196,20.488166305452438,246,24,222,17.57126233227549,7,1016,5.7,26
2020-02-04 19:00:00+01:00,153,14,139,14.915022999208679,172,15,157,19.644113972447897,7,1016,5.7,26
2020-02-04 20:00:00+01:00,155,15,140,19.469409355748308,165,18,147,20.56038540292619,7,1016,5.7,26
2020-02-04 21:00:00+01:00,119,11,108,22.46945513312648,129,12,117,17.995114557081255,7,1016,5.7,26
2020-02-04 22:00:00+01:00,83,6,77,18.699193296190067,90,9,81,13.960700117154147,7,1016,5.7,26
2020-02-04 23:00:00+01:00,58,4,54,10.505136369992313,67,7,60,12.5039951599288,7,1016,5.7,26
2020-02-05 00:00:00+01:00,39,4,35,5.511682674530014,39,4,35,5.511682674530014,8,1030,0.1,17
2020-02-05 01:00:00+01:00,26,3,23,8.048674592026803,25,2,23,4.851536786659508,8,1030,0.1,17
2020-02-05 02:00:00+01:00,26,3,23,8.048674592026803,25,2,23,4.851536786659508,8,1030,0.1,17
2020-02-05 03:00:00+01:00,39,4,35,5.511682674530014,39,4,35,5.511682674530014,8,1030,0.1,17
2020-02-05 04:00:00+01:00,66,8,58,8.66087158766172,64,7,57,14.026099803141571,8,1030,0.1,17
2020-02-05 05:00:00+01:00,117,15,102,12.235552510813584,108,11,97,15.542504625013809,8,1030,0.1,17
2020-02-05 06:00:00+01:00,144,17,127,16.028123717603865,128,14,114,21.820504905688143,8,1030,0.1,17
2020-02-05 07:00:00+01:00,225,29,196,24.523176463388204,215,26,189,19.111985716553264,8,1030,0.1,17
2020-02-05 08:00:00+01:00,236,29,207,11.423053117408324,227,22,205,21.978956980369183,8,1030,0.1,17
2020-02-05 09:00:00+01:00,158,21,137,20.016713756826867,150,15,135,18.780420376145724,8,1030,0.1,17
2020-02-05 10:00:00+01:00,133,16,117,18.900492058685707,117,12,105,12.235552510813584,8,1030,0.1,17
2020-02-05 11:00:00+01:00,157,19,138,20.944420246413923,154,14,140,25.102227050596255,8,1030,0.1,17
2020-02-05 12:00:00+01:00,134,17,117,19.23518886649871,117,12,105,12.235552510813584,8,1030,0.1,17
2020-02-05 13:00:00+01:00,130,16,114,18.726979359073987,130,14,116,18.726979359073987,8,1030,0.1,17
2020-02-05 14:00:00+01:00,133,16,117,18.900492058685707,117,12,105,12.235552510813584,8,1030,0.1,17
2020-02-05 15:00:00+01:00,143,17,126,20.96438623620443,138,15,123,21.813750779140573,8,1030,0.1,17
2020-02-05 16:00:00+01:00,157,21,136,20.944420246413923,154,14,140,25.102227050596255,8,1030,0.1,17
2020-02-05 17:00:00+01:00,228,29,199,11.999655172013497,209,20,189,21.301305122159086,8,1030,0.1,17
2020-02-05 18:00:00+01:00,238,27,211,26.357922750399336,240,29,211,19.23767446741953,8,1030,0.1,17
2020-02-05 19:00:00+01:00,171,22,149,19.53129553547978,152,15,137,20.701024990887795,8,1030,0.1,17
2020-02-05 20:00:00+01:00,169,22,147,17.772634846256242,152,15,137,20.701024990887795,8,1030,0.1,17
2020-02-05 21:00:00+01:00,130,17,113,18.726979359073987,130,14,116,18.726979359073987,8,1030,0.1,17
2020-02-05 22:00:00+01:00,92,11,81,14.440667881435587,89,10,79,16.127888447212325,8,1030,0.1,17
2020-02-05 23:00:00+01:00,64,8,56,14.026099803141571,61,7,54,12.120017072784945,8,1030,0.1,17
2020-02-06 00:00:00+01:00,74,6,68,19.513800836509724,85,12,73,19.289671453475872,8,1034,0.0,6
2020-02-06 01:00:00+01:00,49,4,45,13.911731041947528,53,7,46,8.976459755768028,8,1034,0.0,6
2020-02-06 02:00:00+01:00,53,4,49,8.976459755768028,56,7,49,10.152150256689218,8,1034,0.0,6
2020-02-06 03:00:00+01:00,80,6,74,18.237765354324676,83,10,73,18.699193296190067,8,1034,0.0,6
2020-02-06 04:00:00+01:00,125,10,115,23.026828253397017,137,17,120,18.928795118329443,8,1034,0.0,6
2020-02-06 05:00:00+01:00,220,18,202,16.758079648934128,247,31,216,18.30797612224211,8,1034,0.0,6
2020-02-06 06:00:00+01:00,269,20,249,17.49919499982951,300,37,263,19.621479548992166,8,1034,0.0,6
2020-02-06 07:00:00+01:00,417,34,383,23.51661645113794,451,63,388,20.489203978314702,8,1034,0.0,6
2020-02-06 08:00:00+01:00,482,39,443,19.903175971447034,514,66,448,17.018673574730677,8,1034,0.0,6
2020-02-06 09:00:00+01:00,327,29,298,17.492932564197055,325,41,284,19.331050121665143,8,1034,0.0,6
2020-02-06 10:00:00+01:00,285,24,261,23.62629721954127,289,45,244,20.14984129628082,8,1034,0.0,6
2020-02-06 11:00:00+01:00,325,24,301,19.331050121665143,345,54,291,18.48984602659702,8,1034,0.0,6
2020-02-06 12:00:00+01:00,262,23,239,18.255168653975332,287,45,242,21.927304089805975,8,1034,0.0,6
2020-02-06 13:00:00+01:00,256,20,236,20.451990100158973,282,35,247,14.328617212432716,8,1034,0.0,6
2020-02-06 14:00:00+01:00,260,23,237,21.14564444182058,271,42,229,24.814459053724722,8,1034,0.0,6
2020-02-06 15:00:00+01:00,289,22,267,20.14984129628082,291,38,253,17.50237418524224,8,1034,0.0,6
2020-02-06 16:00:00+01:00,305,23,282,19.342371998402466,323,41,282,19.17862862818099,8,1034,0.0,6
2020-02-06 17:00:00+01:00,487,41,446,15.627714583030805,482,70,412,19.903175971447034,8,1034,0.0,6
2020-02-06 18:00:00+01:00,507,44,463,20.732028813124888,476,67,409,21.50817112871545,8,1034,0.0,6
2020-02-06 19:00:00+01:00,357,30,327,21.912097396672888,352,46,306,20.33829699034963,8,1034,0.0,6
2020-02-06 20:00:00+01:00,330,27,303,16.43301680059058,350,46,304,21.39774246689966,8,1034,0.0,6
2020-02-06 21:00:00+01:00,260,21,239,21.14564444182058,271,42,229,24.814459053724722,8,1034,0.0,6
2020-02-06 22:00:00+01:00,184,14,170,20.655558446800804,190,23,167,20.51689583562818,8,1034,0.0,6
2020-02-06 23:00:00+01:00,141,11,130,21.00935462418931,143,20,123,22.510370466296816,8,1034,0.0,6
2020-02-07 00:00:00+01:00,69,7,62,19.29595730158091,67,6,61,12.5039951599288,8,1027,0.0,9
2020-02-07 01:00:00+01:00,48,4,44,12.297077384196717,48,4,44,12.297077384196717,8,1027,0.0,9
2020-02-07 02:00:00+01:00,48,4,44,12.297077384196717,48,4,44,12.297077384196717,8,1027,0.0,9
2020-02-07 03:00:00+01:00,73,6,67,16.592478063282112,73,7,66,16.592478063282112,8,1027,0.0,9
2020-02-07 04:00:00+01:00,122,12,110,20.245567873519157,124,13,111,17.53992981591413,8,1027,0.0,9
2020-02-07 05:00:00+01:00,211,22,189,18.759232281731908,211,21,190,18.759232281731908,8,1027,0.0,9
2020-02-07 06:00:00+01:00,261,26,235,21.270868579361668,257,27,230,24.369710124951805,8,1027,0.0,9
2020-02-07 07:00:00+01:00,413,38,375,24.398754434847095,389,38,351,21.37920911023894,8,1027,0.0,9
2020-02-07 08:00:00+01:00,426,39,387,20.8097346735364,414,42,372,21.211929621647883,8,1027,0.0,9
2020-02-07 09:00:00+01:00,296,30,266,20.454116986907042,294,29,265,18.98421464015195,8,1027,0.0,9
2020-02-07 10:00:00+01:00,240,23,217,16.023164601360044,236,23,213,19.106111918840778,8,1027,0.0,9
2020-02-07 11:00:00+01:00,288,30,258,22.858888837585067,275,25,250,24.67224255888931,8,1027,0.0,9
2020-02-07 12:00:00+01:00,240,26,214,16.023164601360044,236,23,213,19.106111918840778,8,1027,0.0,9
2020-02-07 13:00:00+01:00,240,25,215,16.023164601360044,236,23,213,19.106111918840778,8,1027,0.0,9
2020-02-07 14:00:00+01:00,240,25,215,16.023164601360044,236,23,213,19.106111918840778,8,1027,0.0,9
2020-02-07 15:00:00+01:00,265,28,237,24.143057918667047,259,24,235,22.988395045636892,8,1027,0.0,9
2020-02-07 16:00:00+01:00,283,26,257,21.015453076893927,285,26,259,23.62629721954127,8,1027,0.0,9
2020-02-07 17:00:00+01:00,416,44,372,17.117872401421668,389,38,351,21.37920911023894,8,1027,0.0,9
2020-02-07 18:00:00+01:00,426,39,387,20.8097346735364,414,42,372,21.211929621647883,8,1027,0.0,9
2020-02-07 19:00:00+01:00,321,33,288,23.480156167605287,321,35,286,23.480156167605287,8,1027,0.0,9
2020-02-07 20:00:00+01:00,321,34,287,23.480156167605287,321,35,286,23.480156167605287,8,1027,0.0,9
2020-02-07 21:00:00+01:00,248,26,222,17.312704307039937,236,25,211,19.106111918840778,8,1027,0.0,9
2020-02-07 22:00:00+01:00,168,17,151,20.304807772345505,166,16,150,18.57114730689396,8,1027,0.0,9
2020-02-07 23:00:00+01:00,122,12,110,20.245567873519157,124,13,111,17.53992981591413,8,1027,0.0,9
2020-02-08 00:00:00+01:00,58,3,55,11.561797090249616,61,3,58,13.45123014142322,7,1020,0.0,11
2020-02-08 01:00:00+01:00,39,2,37,6.913338666308079,40,2,38,6.907029621336792,7,1020,0.0,11
2020-02-08 02:00:00+01:00,40,2,38,6.907029621336792,42,2,40,10.321824814537676,7,1020,0.0,11
2020-02-08 03:00:00+01:00,61,3,58,13.45123014142322,61,3,58,13.45123014142322,7,1020,0.0,11
2020-02-08 04:00:00+01:00,78,4,74,10.154730086809042,84,5,79,7.6306798135980785,7,1020,0.0,11
2020-02-08 05:00:00+01:00,104,5,99,18.50502851366146,104,5,99,18.50502851366146,7,1020,0.0,11
2020-02-08 06:00:00+01:00,156,9,147,17.899214712227696,169,10,159,20.526675282456768,7,1020,0.0,11
2020-02-08 07:00:00+01:00,248,15,233,17.022549227170337,255,13,242,13.80583098758932,7,1020,0.0,11
2020-02-08 08:00:00+01:00,328,22,306,18.977288676463566,344,18,326,19.49330876116528,7,1020,0.0,11
2020-02-08 09:00:00+01:00,340,21,319,14.37984208663957,357,22,335,16.579219218063535,7,1020,0.0,11
2020-02-08 10:00:00+01:00,310,18,292,15.258998808795859,315,18,297,17.275310260978717,7,1020,0.0,11
2020-02-08 11:00:00+01:00,247,16,231,19.091366395871336,255,14,241,13.80583098758932,7,1020,0.0,11
2020-02-08 12:00:00+01:00,245,16,229,17.30944248589229,257,17,240,18.99808160477331,7,1020,0.0,11
2020-02-08 13:00:00+01:00,270,16,254,18.31838596155419,274,15,259,20.52791870989968,7,1020,0.0,11
2020-02-08 14:00:00+01:00,240,14,226,19.372323114313716,252,12,240,19.00138202247206,7,1020,0.0,11
2020-02-08 15:00:00+01:00,279,18,261,20.757341864573803,297,16,281,17.48190242862812,7,1020,0.0,11
2020-02-08 16:00:00+01:00,278,18,260,19.287262138921047,297,16,281,17.48190242862812,7,1020,0.0,11
2020-02-08 17:00:00+01:00,317,21,296,17.791113543708203,343,22,321,16.93402466287014,7,1020,0.0,11
2020-02-08 18:00:00+01:00,307,20,287,16.74476305242919,315,20,295,17.275310260978717,7,1020,0.0,11
2020-02-08 19:00:00+01:00,247,16,231,19.091366395871336,255,14,241,13.80583098758932,7,1020,0.0,11
2020-02-08 20:00:00+01:00,226,15,211,15.467390071610119,231,13,218,18.808415660395674,7,1020,0.0,11
2020-02-08 21:00:00+01:00,205,13,192,22.456574383830734,213,10,203,20.238518600536185,7,1020,0.0,11
2020-02-08 22:00:00+01:00,162,10,152,18.435104799511247,169,9,160,20.526675282456768,7,1020,0.0,11
2020-02-08 23:00:00+01:00,82,5,77,8.6962433625344,84,4,80,7.6306798135980785,7,1020,0.0,11
2020-02-09 00:00:00+01:00,33,1,32,6.0078012500217595,41,1,40,7.51149883575918,8,1022,0.2,11
2020-02-09 01:00:00+01:00,21,0,21,0.0727095127790566,24,0,24,0.16633697306049489,8,1022,0.2,11
2020-02-09 02:00:00+01:00,21,0,21,0.0727095127790566,24,0,24,0.16633697306049489,8,1022,0.2,11
2020-02-09 03:00:00+01:00,32,1,31,4.0395468395825125,41,1,40,7.51149883575918,8,1022,0.2,11
2020-02-09 04:00:00+01:00,42,1,41,10.321824814537676,56,1,55,11.681432660358455,8,1022,0.2,11
2020-02-09 05:00:00+01:00,50,1,49,13.833131991765365,72,2,70,10.765287360581397,8,1022,0.2,11
2020-02-09 06:00:00+01:00,87,3,84,9.504121716770046,121,4,117,11.617438248542046,8,1022,0.2,11
2020-02-09 07:00:00+01:00,122,4,118,15.53082002471091,153,5,148,18.67945251137068,8,1022,0.2,11
2020-02-09 08:00:00+01:00,162,6,156,18.435104799511247,208,7,201,18.807092053665322,8,1022,0.2,11
2020-02-09 09:00:00+01:00,185,7,178,20.88033942284811,211,7,204,15.949558582123627,8,1022,0.2,11
2020-02-09 10:00:00+01:00,154,6,148,19.868163821621103,164,5,159,18.874121315806054,8,1022,0.2,11
2020-02-09 11:00:00+01:00,133,5,128,15.567856067550506,174,6,168,17.20816352324012,8,1022,0.2,11
2020-02-09 12:00:00+01:00,127,4,123,18.022773693841014,153,6,147,18.67945251137068,8,1022,0.2,11
2020-02-09 13:00:00+01:00,131,4,127,17.703689985975256,141,5,136,17.007652233540448,8,1022,0.2,11
2020-02-09 14:00:00+01:00,136,5,131,17.36617287321582,142,5,137,19.57947604189084,8,1022,0.2,11
2020-02-09 15:00:00+01:00,158,6,152,19.40470350916573,164,6,158,18.874121315806054,8,1022,0.2,11
2020-02-09 16:00:00+01:00,154,5,149,19.868163821621103,153,5,148,18.67945251137068,8,1022,0.2,11
2020-02-09 17:00:00+01:00,162,6,156,18.435104799511247,208,7,201,18.807092053665322,8,1022,0.2,11
2020-02-09 18:00:00+01:00,164,7,157,18.874121315806054,216,7,209,17.62117954457743,8,1022,0.2,11
2020-02-09 19:00:00+01:00,122,4,118,15.53082002471091,153,5,148,18.67945251137068,8,1022,0.2,11
2020-02-09 20:00:00+01:00,112,4,108,19.016823421759323,156,5,151,17.899214712227696,8,1022,0.2,11
2020-02-09 21:00:00+01:00,107,4,103,12.742346635562697,151,5,146,19.14578123638998,8,1022,0.2,11
2020-02-09 22:00:00+01:00,84,3,81,7.6306798135980785,121,4,117,11.617438248542046,8,1022,0.2,11
2020-02-09 23:00:00+01:00,39,1,38,6.913338666308079,42,1,41,10.321824814537676,8,1022,0.2,11
2020-02-10 00:00:00+01:00,39,3,36,6.782457974710225,37,4,33,2.066086063070793,8,1002,1.5,42
2020-02-10 01:00:00+01:00,26,2,24,1.5382661455122164,26,2,24,1.5382661455122164,8,1002,1.5,42
2020-02-10 02:00:00+01:00,24,2,22,1.5004308879154395,26,2,24,1.5382661455122164,8,1002,1.5,42
2020-02-10 03:00:00+01:00,37,3,34,2.066086063070793,39,4,35,6.782457974710225,8,1002,1.5,42
2020-02-10 04:00:00+01:00,60,5,55,10.583722413773145,62,6,56,14.48690450543278,8,1002,1.5,42
2020-02-10 05:00:00+01:00,108,10,98,14.813734676069407,112,11,101,14.898852003445265,8,1002,1.5,42
2020-02-10 06:00:00+01:00,136,13,123,16.594078125250377,142,16,126,21.623487252479663,8,1002,1.5,42
2020-02-10 07:00:00+01:00,226,22,204,20.308697708911414,214,23,191,18.560318290748608,8,1002,1.5,42
2020-02-10 08:00:00+01:00,239,24,215,13.74553452780325,235,29,206,20.674840106170866,8,1002,1.5,42
2020-02-10 09:00:00+01:00,154,16,138,23.457384968254527,151,18,133,19.408157188048275,8,1002,1.5,42
2020-02-10 10:00:00+01:00,128,11,117,19.601953989978306,128,12,116,19.601953989978306,8,1002,1.5,42
2020-02-10 11:00:00+01:00,152,13,139,20.188330220444417,154,15,139,23.457384968254527,8,1002,1.5,42
2020-02-10 12:00:00+01:00,123,13,110,19.074654696202938,128,14,114,19.601953989978306,8,1002,1.5,42
2020-02-10 13:00:00+01:00,127,11,116,19.116953333289125,125,13,112,23.026828253397017,8,1002,1.5,42
2020-02-10 14:00:00+01:00,127,11,116,19.116953333289125,125,13,112,23.026828253397017,8,1002,1.5,42
2020-02-10 15:00:00+01:00,139,12,127,18.732486269107348,137,15,122,18.928795118329443,8,1002,1.5,42
2020-02-10 16:00:00+01:00,145,14,131,18.85528596371164,157,17,140,23.857880119976507,8,1002,1.5,42
2020-02-10 17:00:00+01:00,216,21,195,21.273439412003903,220,27,193,16.758079648934128,8,1002,1.5,42
2020-02-10 18:00:00+01:00,228,21,207,15.818609956751573,225,22,203,17.07968654570721,8,1002,1.5,42
2020-02-10 19:00:00+01:00,168,15,153,20.304807772345505,167,18,149,21.39117903937357,8,1002,1.5,42
2020-02-10 20:00:00+01:00,166,16,150,18.57114730689396,170,20,150,19.775542485132945,8,1002,1.5,42
2020-02-10 21:00:00+01:00,122,13,109,20.245567873519157,131,15,116,14.183230975852695,8,1002,1.5,42
2020-02-10 22:00:00+01:00,89,8,81,17.562315027840828,89,8,81,17.562315027840828,8,1002,1.5,42
2020-02-10 23:00:00+01:00,63,5,58,14.929801273937542,62,6,56,14.48690450543278,8,1002,1.5,42
2020-02-11 00:00:00+01:00,33,2,31,5.985660510090718,39,3,36,6.782457974710225,6,1012,3.2,30
2020-02-11 01:00:00+01:00,22,1,21,0.1277873501672996,26,2,24,1.5382661455122164,6,1012,3.2,30
2020-02-11 02:00:00+01:00,25,2,23,1.1875344360364632,27,2,25,1.9016023008994223,6,1012,3.2,30
2020-02-11 03:00:00+01:00,38,3,35,11.101073107969722,40,4,36,5.275608835029151,6,1012,3.2,30
2020-02-11 04:00:00+01:00,62,5,57,14.48690450543278,62,5,57,14.48690450543278,6,1012,3.2,30
2020-02-11 05:00:00+01:00,101,8,93,11.280950715811313,121,12,109,20.317620945183666,6,1012,3.2,30
2020-02-11 06:00:00+01:00,138,11,127,20.21600799483387,138,14,124,20.21600799483387,6,1012,3.2,30
2020-02-11 07:00:00+01:00,192,17,175,21.295822766447603,225,21,204,17.07968654570721,6,1012,3.2,30
2020-02-11 08:00:00+01:00,218,18,200,22.57742359713229,242,27,215,20.990360069331732,6,1012,3.2,30
2020-02-11 09:00:00+01:00,142,13,129,21.623487252479663,164,16,148,22.827361263214527,6,1012,3.2,30
2020-02-11 10:00:00+01:00,129,10,119,17.995114557081255,131,11,120,14.183230975852695,6,1012,3.2,30
2020-02-11 11:00:00+01:00,142,11,131,21.623487252479663,164,16,148,22.827361263214527,6,1012,3.2,30
2020-02-11 12:00:00+01:00,129,10,119,17.995114557081255,131,11,120,14.183230975852695,6,1012,3.2,30
2020-02-11 13:00:00+01:00,119,9,110,22.46945513312648,129,12,117,17.995114557081255,6,1012,3.2,30
2020-02-11 14:00:00+01:00,119,9,110,22.46945513312648,129,12,117,17.995114557081255,6,1012,3.2,30
2020-02-11 15:00:00+01:00,130,10,120,15.65660051079879,144,12,132,22.91915418498221,6,1012,3.2,30
2020-02-11 16:00:00+01:00,139,13,126,18.732486269107348,150,15,135,17.939622434692456,6,1012,3.2,30
2020-02-11 17:00:00+01:00,209,17,192,22.16757043059366,224,19,205,16.30248157536985,6,1012,3.2,30
2020-02-11 18:00:00+01:00,213,17,196,20.488166305452438,246,24,222,17.57126233227549,6,1012,3.2,30
2020-02-11 19:00:00+01:00,153,14,139,14.915022999208679,172,15,157,19.644113972447897,6,1012,3.2,30
2020-02-11 20:00:00+01:00,155,15,140,19.469409355748308,165,18,147,20.56038540292619,6,1012,3.2,30
2020-02-11 21:00:00+01:00,119,11,108,22.46945513312648,129,12,117,17.995114557081255,6,1012,3.2,30
2020-02-11 22:00:00+01:00,83,6,77,18.699193296190067,90,9,81,13.960700117154147,6,1012,3.2,30
2020-02-11 23:00:00+01:00,58,4,54,10.505136369992313,67,7,60,12.5039951599288,6,1012,3.2,30
2020-02-12 00:00:00+01:00,89,8,81,16.127888447212325,77,6,71,18.339246781129614,6,1020,0.5,17
2020-02-12 01:00:00+01:00,58,4,54,10.220927905289535,58,4,54,10.220927905289535,6,1020,0.5,17
2020-02-12 02:00:00+01:00,59,5,54,11.41076069350512,56,4,52,12.708841385488384,6,1020,0.5,17
2020-02-12 03:00:00+01:00,87,8,79,17.188718365321975,85,6,79,11.338371679676618,6,1020,0.5,17
2020-02-12 04:00:00+01:00,146,12,134,18.754590489717035,141,10,131,16.082921323202,6,1020,0.5,17
2020-02-12 05:00:00+01:00,261,21,240,22.290397298498814,250,17,233,16.748276094261186,6,1020,0.5,17
2020-02-12 06:00:00+01:00,319,28,291,24.01334617415068,298,20,278,21.055661887973457,6,1020,0.5,17
2020-02-12 07:00:00+01:00,493,45,448,19.413114642597456,476,33,443,21.264665184026093,6,1020,0.5,17
2020-02-12 08:00:00+01:00,519,41,478,17.770207620206634,523,35,488,19.232400876414125,6,1020,0.5,17
2020-02-12 09:00:00+01:00,353,33,320,16.072474715915927,328,26,302,18.98715264551659,6,1020,0.5,17
2020-02-12 10:00:00+01:00,296,26,270,17.230558324905093,269,19,250,18.12289110818214,6,1020,0.5,17
2020-02-12 11:00:00+01:00,351,32,319,21.009303371553763,333,22,311,20.360845500171493,6,1020,0.5,17
2020-02-12 12:00:00+01:00,296,28,268,17.230558324905093,269,19,250,18.12289110818214,6,1020,0.5,17
2020-02-12 13:00:00+01:00,293,27,266,20.77933514509894,281,22,259,16.495274317847883,6,1020,0.5,17
2020-02-12 14:00:00+01:00,294,26,268,24.118136039782872,271,19,252,21.366756148139427,6,1020,0.5,17
2020-02-12 15:00:00+01:00,324,28,296,25.318103431421573,291,22,269,15.818920682290248,6,1020,0.5,17
2020-02-12 16:00:00+01:00,356,33,323,15.115185640587857,323,28,295,20.660649403872643,6,1020,0.5,17
2020-02-12 17:00:00+01:00,493,39,454,19.413114642597456,476,33,443,21.264665184026093,6,1020,0.5,17
2020-02-12 18:00:00+01:00,519,41,478,17.770207620206634,523,35,488,19.232400876414125,6,1020,0.5,17
2020-02-12 19:00:00+01:00,382,36,346,20.636704160930535,356,24,332,15.115185640587857,6,1020,0.5,17
2020-02-12 20:00:00+01:00,377,36,341,22.934146173926393,345,26,319,20.188429732979824,6,1020,0.5,17
2020-02-12 21:00:00+01:00,293,24,269,20.77933514509894,281,22,259,16.495274317847883,6,1020,0.5,17
2020-02-12 22:00:00+01:00,206,18,188,26.316276075539704,185,14,171,13.724989686195345,6,1020,0.5,17
2020-02-12 23:00:00+01:00,144,11,133,16.028123717603865,129,10,119,12.321757402623772,6,1020,0.5,17
2020-02-13 00:00:00+01:00,113,6,107,20.97275705288615,110,11,99,20.964248322238312,8,1017,0.1,14
2020-02-13 01:00:00+01:00,70,4,66,11.628132043946147,73,8,65,10.015349835153332,8,1017,0.1,14
2020-02-13 02:00:00+01:00,73,4,69,10.015349835153332,74,7,67,9.886934519670994,8,1017,0.1,14
2020-02-13 03:00:00+01:00,110,6,104,20.964248322238312,110,11,99,20.964248322238312,8,1017,0.1,14
2020-02-13 04:00:00+01:00,178,10,168,18.00585359354758,179,15,164,21.74229179161351,8,1017,0.1,14
2020-02-13 05:00:00+01:00,319,17,302,23.232042011552885,329,30,299,20.177718732958198,8,1017,0.1,14
2020-02-13 06:00:00+01:00,432,23,409,19.977965204645113,404,36,368,22.221089161183272,8,1017,0.1,14
2020-02-13 07:00:00+01:00,588,37,551,18.625003459627973,664,75,589,21.525177880443678,8,1017,0.1,14
2020-02-13 08:00:00+01:00,631,35,596,18.21881166493505,660,64,596,18.6631029781559,8,1017,0.1,14
2020-02-13 09:00:00+01:00,420,23,397,19.34293358515217,438,49,389,18.033066079167238,8,1017,0.1,14
2020-02-13 10:00:00+01:00,349,20,329,19.114918279434413,368,33,335,19.848434815045938,8,1017,0.1,14
2020-02-13 11:00:00+01:00,446,24,422,16.392503795900122,441,45,396,18.66415998446817,8,1017,0.1,14
2020-02-13 12:00:00+01:00,349,20,329,19.114918279434413,368,33,335,19.848434815045938,8,1017,0.1,14
2020-02-13 13:00:00+01:00,372,20,352,20.398072732636447,389,34,355,18.813833392506616,8,1017,0.1,14
2020-02-13 14:00:00+01:00,369,21,348,14.559507357779353,386,37,349,22.495942580430874,8,1017,0.1,14
2020-02-13 15:00:00+01:00,406,23,383,14.646774291249367,433,45,388,17.57064657679897,8,1017,0.1,14
2020-02-13 16:00:00+01:00,432,23,409,19.977965204645113,441,39,402,18.66415998446817,8,1017,0.1,14
2020-02-13 17:00:00+01:00,594,34,560,20.041319596330183,663,56,607,18.590319207612044,8,1017,0.1,14
2020-02-13 18:00:00+01:00,607,36,571,18.763498809037944,651,59,592,18.496340932670986,8,1017,0.1,14
2020-02-13 19:00:00+01:00,487,27,460,20.801132823441247,485,51,434,23.26524199136097,8,1017,0.1,14
2020-02-13 20:00:00+01:00,474,28,446,22.587368250433876,501,45,456,17.91816636651384,8,1017,0.1,14
2020-02-13 21:00:00+01:00,337,19,318,20.189680789887703,374,33,341,18.684901759797462,8,1017,0.1,14
2020-02-13 22:00:00+01:00,268,15,253,20.190442141402777,273,25,248,23.139691796211615,8,1017,0.1,14
2020-02-13 23:00:00+01:00,187,11,176,15.611538170802525,195,21,174,16.39636374930337,8,1017,0.1,14
2020-02-14 00:00:00+01:00,86,5,81,9.565861223121674,91,5,86,8.844154374326946,9,1013,0.1,18
2020-02-14 01:00:00+01:00,58,3,55,11.561797090249616,54,3,51,11.483713237443984,9,1013,0.1,18
2020-02-14 02:00:00+01:00,57,4,53,11.247345675463038,59,4,55,11.512224289105106,9,1013,0.1,18
2020-02-14 03:00:00+01:00,90,6,84,10.477669283936715,83,6,77,9.333357558089729,9,1013,0.1,18
2020-02-14 04:00:00+01:00,151,11,140,19.14578123638998,144,8,136,20.078554087092446,9,1013,0.1,18
2020-02-14 05:00:00+01:00,266,16,250,15.200054248100818,274,19,255,20.52791870989968,9,1013,0.1,18
2020-02-14 06:00:00+01:00,336,25,311,15.374523455613796,330,19,311,18.864376108789497,9,1013,0.1,18
2020-02-14 07:00:00+01:00,518,36,482,17.06195195164026,482,36,446,21.554128287623442,9,1013,0.1,18
2020-02-14 08:00:00+01:00,532,37,495,21.99526994910307,498,31,467,14.222982449555595,9,1013,0.1,18
2020-02-14 09:00:00+01:00,358,27,331,16.774588466913123,346,27,319,17.93974987663749,9,1013,0.1,18
2020-02-14 10:00:00+01:00,301,21,280,20.607812327110423,289,19,270,18.938144972747136,9,1013,0.1,18
2020-02-14 11:00:00+01:00,347,22,325,19.911580344317716,357,27,330,16.579219218063535,9,1013,0.1,18
2020-02-14 12:00:00+01:00,299,19,280,16.471342376610473,282,21,261,20.995138580232226,9,1013,0.1,18
2020-02-14 13:00:00+01:00,291,19,272,14.14711867692869,297,22,275,17.48190242862812,9,1013,0.1,18
2020-02-14 14:00:00+01:00,288,21,267,15.693687299637316,282,17,265,20.995138580232226,9,1013,0.1,18
2020-02-14 15:00:00+01:00,320,21,299,21.84611391715035,313,19,294,12.040192542056978,9,1013,0.1,18
2020-02-14 16:00:00+01:00,344,25,319,19.49330876116528,343,23,320,16.93402466287014,9,1013,0.1,18
2020-02-14 17:00:00+01:00,505,38,467,13.420156221106103,474,33,441,22.587368250433876,9,1013,0.1,18
2020-02-14 18:00:00+01:00,547,40,507,18.31342997105543,518,31,487,17.06195195164026,9,1013,0.1,18
2020-02-14 19:00:00+01:00,395,25,370,18.398546278061747,373,27,346,16.839124812955344,9,1013,0.1,18
2020-02-14 20:00:00+01:00,392,27,365,22.18304148250548,373,27,346,16.839124812955344,9,1013,0.1,18
2020-02-14 21:00:00+01:00,302,20,282,20.352052927472357,289,19,270,18.938144972747136,9,1013,0.1,18
2020-02-14 22:00:00+01:00,202,13,189,21.075229783177793,205,12,193,22.456574383830734,9,1013,0.1,18
2020-02-14 23:00:00+01:00,146,9,137,19.4340926707284,146,9,137,19.4340926707284,9,1013,0.1,18
2020-02-15 00:00:00+01:00,156,6,150,15.494343228884324,166,6,160,15.805125598041359,10,1023,0.0,12
2020-02-15 01:00:00+01:00,105,4,101,17.275457667249523,112,4,108,15.806853407309559,10,1023,0.0,12
2020-02-15 02:00:00+01:00,101,4,97,15.722824076028786,110,4,106,15.609294066077696,10,1023,0.0,12
2020-02-15 03:00:00+01:00,155,7,148,15.790225708214793,167,6,161,16.326460423959446,10,1023,0.0,12
2020-02-15 04:00:00+01:00,208,8,200,15.634218349387046,225,8,217,16.661436915864048,10,1023,0.0,12
2020-02-15 05:00:00+01:00,265,12,253,21.659352492207965,276,12,264,17.35229192424785,10,1023,0.0,12
2020-02-15 06:00:00+01:00,428,17,411,16.577822504859213,441,19,422,19.94179355487717,10,1023,0.0,12
2020-02-15 07:00:00+01:00,642,30,612,21.008455911133982,673,25,648,20.599740536360162,10,1023,0.0,12
2020-02-15 08:00:00+01:00,836,34,802,18.4492412726081,895,36,859,18.068676456960343,10,1023,0.0,12
2020-02-15 09:00:00+01:00,902,41,861,15.213519013612297,939,43,896,18.905868573761783,10,1023,0.0,12
2020-02-15 10:00:00+01:00,806,38,768,19.36328143059609,838,38,800,17.507309376780274,10,1023,0.0,12
2020-02-15 11:00:00+01:00,642,27,615,21.008455911133982,673,25,648,20.599740536360162,10,1023,0.0,12
2020-02-15 12:00:00+01:00,625,25,600,20.373020646102827,666,24,642,23.854260088489895,10,1023,0.0,12
2020-02-15 13:00:00+01:00,703,29,674,18.837939423876417,732,26,706,19.298380872936654,10,1023,0.0,12
2020-02-15 14:00:00+01:00,618,26,592,20.16331375283063,675,23,652,18.808217183165738,10,1023,0.0,12
2020-02-15 15:00:00+01:00,764,32,732,23.382878709112305,769,27,742,26.302265350984626,10,1023,0.0,12
2020-02-15 16:00:00+01:00,760,31,729,16.55929568251222,782,35,747,21.216904898621415,10,1023,0.0,12
2020-02-15 17:00:00+01:00,852,37,815,17.074570556249217,893,41,852,21.578410255104366,10,1023,0.0,12
2020-02-15 18:00:00+01:00,786,37,749,21.516354272354075,826,36,790,19.451040612230987,10,1023,0.0,12
2020-02-15 19:00:00+01:00,623,24,599,19.813545238499966,666,24,642,23.854260088489895,10,1023,0.0,12
2020-02-15 20:00:00+01:00,594,24,570,17.93124687989194,614,24,590,16.99556836135834,10,1023,0.0,12
2020-02-15 21:00:00+01:00,513,20,493,17.087132975157285,562,20,542,16.760248746749884,10,1023,0.0,12
2020-02-15 22:00:00+01:00,431,17,414,17.430621680262487,441,19,422,19.94179355487717,10,1023,0.0,12
2020-02-15 23:00:00+01:00,214,10,204,15.924572551583156,223,8,215,14.162371988477169,10,1023,0.0,12
2020-02-16 00:00:00+01:00,48,1,47,2.118885624025071,62,1,61,9.933021674487964,14,1016,0.0,26
2020-02-16 01:00:00+01:00,31,0,31,0.09592672504460022,39,1,38,1.033561008980209,14,1016,0.0,26
2020-02-16 02:00:00+01:00,33,0,33,0.14141575834347447,44,1,43,2.806526197564455,14,1016,0.0,26
2020-02-16 03:00:00+01:00,49,1,48,6.860624429398525,67,1,66,8.7820789764259,14,1016,0.0,26
2020-02-16 04:00:00+01:00,66,1,65,9.023232667771104,81,2,79,13.57081910214519,14,1016,0.0,26
2020-02-16 05:00:00+01:00,83,2,81,14.646378896367615,86,2,84,12.26433019639111,14,1016,0.0,26
2020-02-16 06:00:00+01:00,123,3,120,15.194143124406915,158,4,154,15.520682112145103,14,1016,0.0,26
2020-02-16 07:00:00+01:00,203,5,198,14.15515549868705,207,5,202,15.748956490487041,14,1016,0.0,26
2020-02-16 08:00:00+01:00,273,7,266,21.28577278040721,270,7,263,17.22476411837893,14,1016,0.0,26
2020-02-16 09:00:00+01:00,271,7,264,18.609144291774015,320,7,313,16.959865599813572,14,1016,0.0,26
2020-02-16 10:00:00+01:00,231,6,225,23.040251819935676,257,6,251,15.41589678734927,14,1016,0.0,26
2020-02-16 11:00:00+01:00,195,5,190,17.033571067166147,275,8,267,15.101857250184825,14,1016,0.0,26
2020-02-16 12:00:00+01:00,185,5,180,12.907917224661341,268,8,260,18.728976419565118,14,1016,0.0,26
2020-02-16 13:00:00+01:00,207,5,202,15.748956490487041,244,5,239,21.645479919989064,14,1016,0.0,26
2020-02-16 14:00:00+01:00,186,4,182,14.883580611736797,245,5,240,18.743839545838085,14,1016,0.0,26
2020-02-16 15:00:00+01:00,217,5,212,17.475217936101426,278,6,272,18.588750350595824,14,1016,0.0,26
2020-02-16 16:00:00+01:00,223,6,217,14.162371988477169,273,8,265,21.28577278040721,14,1016,0.0,26
2020-02-16 17:00:00+01:00,247,7,240,19.35438042774601,334,9,325,16.121444874138597,14,1016,0.0,26
2020-02-16 18:00:00+01:00,233,6,227,19.131071941994424,257,6,251,15.41589678734927,14,1016,0.0,26
2020-02-16 19:00:00+01:00,195,5,190,17.033571067166147,275,8,267,15.101857250184825,14,1016,0.0,26
2020-02-16 20:00:00+01:00,170,4,166,17.360183949342197,201,4,197,13.923110814237354,14,1016,0.0,26
2020-02-16 21:00:00+01:00,158,4,154,15.520682112145103,229,5,224,17.77127130389445,14,1016,0.0,26
2020-02-16 22:00:00+01:00,124,3,121,16.092127235524575,158,4,154,15.520682112145103,14,1016,0.0,26
2020-02-16 23:00:00+01:00,67,1,66,8.7820789764259,86,2,84,12.26433019639111,14,1016,0.0,26
2020-02-17 00:00:00+01:00,84,5,79,7.6306798135980785,91,8,83,8.844154374326946,9,1016,5.8,22
2020-02-17 01:00:00+01:00,58,3,55,11.561797090249616,57,4,53,11.247345675463038,9,1016,5.8,22
2020-02-17 02:00:00+01:00,59,4,55,11.512224289105106,60,4,56,12.98342242386016,9,1016,5.8,22
2020-02-17 03:00:00+01:00,89,6,83,10.527801976587284,86,7,79,9.565861223121674,9,1016,5.8,22
2020-02-17 04:00:00+01:00,153,9,144,18.67945251137068,143,9,134,15.49985590484046,9,1016,5.8,22
2020-02-17 05:00:00+01:00,273,19,254,23.139691796211615,266,23,243,15.200054248100818,9,1016,5.8,22
2020-02-17 06:00:00+01:00,336,23,313,15.374523455613796,329,21,308,20.177718732958198,9,1016,5.8,22
2020-02-17 07:00:00+01:00,512,34,478,16.667622950500245,503,41,462,20.681117537709245,9,1016,5.8,22
2020-02-17 08:00:00+01:00,537,41,496,17.84682050697329,523,43,480,15.86377141768892,9,1016,5.8,22
2020-02-17 09:00:00+01:00,361,24,337,18.385612781936853,367,27,340,16.178745311566107,9,1016,5.8,22
2020-02-17 10:00:00+01:00,286,19,267,20.747694740560487,297,22,275,17.48190242862812,9,1016,5.8,22
2020-02-17 11:00:00+01:00,340,25,315,14.37984208663957,346,28,318,17.93974987663749,9,1016,5.8,22
2020-02-17 12:00:00+01:00,305,22,283,21.145143787586594,294,21,273,17.632695676481745,9,1016,5.8,22
2020-02-17 13:00:00+01:00,285,18,267,19.95607218889837,297,22,275,17.48190242862812,9,1016,5.8,22
2020-02-17 14:00:00+01:00,283,21,262,18.945435241048195,292,20,272,17.87884891495493,9,1016,5.8,22
2020-02-17 15:00:00+01:00,312,20,292,17.101813661047903,335,27,308,21.63506552863301,9,1016,5.8,22
2020-02-17 16:00:00+01:00,361,24,337,18.385612781936853,367,27,340,16.178745311566107,9,1016,5.8,22
2020-02-17 17:00:00+01:00,487,32,455,20.801132823441247,515,42,473,18.515381952439686,9,1016,5.8,22
2020-02-17 18:00:00+01:00,520,38,482,16.742850474175178,546,37,509,22.692406056572345,9,1016,5.8,22
2020-02-17 19:00:00+01:00,376,24,352,20.486350839145686,394,30,364,20.620478231973475,9,1016,5.8,22
2020-02-17 20:00:00+01:00,375,26,349,21.145699806578275,397,27,370,17.649629378165546,9,1016,5.8,22
2020-02-17 21:00:00+01:00,283,21,262,18.945435241048195,292,20,272,17.87884891495493,9,1016,5.8,22
2020-02-17 22:00:00+01:00,199,12,187,19.11274068140836,206,14,192,20.90053052788098,9,1016,5.8,22
2020-02-17 23:00:00+01:00,143,10,133,15.49985590484046,151,12,139,19.14578123638998,9,1016,5.8,22
2020-02-18 00:00:00+01:00,89,5,84,10.527801976587284,87,6,81,9.504121716770046,8,1025,0.0,21
2020-02-18 01:00:00+01:00,57,3,54,11.247345675463038,61,4,57,13.45123014142322,8,1025,0.0,21
2020-02-18 02:00:00+01:00,58,3,55,11.561797090249616,57,3,54,11.247345675463038,8,1025,0.0,21
2020-02-18 03:00:00+01:00,88,6,82,8.437594054986977,86,5,81,9.565861223121674,8,1025,0.0,21
2020-02-18 04:00:00+01:00,143,8,135,15.49985590484046,157,11,146,19.700921436065542,8,1025,0.0,21
2020-02-18 05:00:00+01:00,262,15,247,13.900090096773878,268,16,252,20.190442141402777,8,1025,0.0,21
2020-02-18 06:00:00+01:00,314,19,295,19.77016372636934,347,27,320,19.911580344317716,8,1025,0.0,21
2020-02-18 07:00:00+01:00,476,32,444,20.090041264055532,516,34,482,18.189169879710622,8,1025,0.0,21
2020-02-18 08:00:00+01:00,525,31,494,20.014875638820815,559,36,523,16.28017139379397,8,1025,0.0,21
2020-02-18 09:00:00+01:00,339,21,318,18.9351903306688,366,29,337,16.269939741661524,8,1025,0.0,21
2020-02-18 10:00:00+01:00,294,18,276,17.632695676481745,294,18,276,17.632695676481745,8,1025,0.0,21
2020-02-18 11:00:00+01:00,319,18,301,23.232042011552885,354,23,331,22.475031570210557,8,1025,0.0,21
2020-02-18 12:00:00+01:00,286,17,269,20.747694740560487,308,21,287,19.852115147138527,8,1025,0.0,21
2020-02-18 13:00:00+01:00,264,16,248,17.866837611646663,306,18,288,16.19476586954662,8,1025,0.0,21
2020-02-18 14:00:00+01:00,264,16,248,17.866837611646663,306,18,288,16.19476586954662,8,1025,0.0,21
2020-02-18 15:00:00+01:00,291,18,273,14.14711867692869,339,25,314,18.9351903306688,8,1025,0.0,21
2020-02-18 16:00:00+01:00,331,23,308,19.942495480727644,373,24,349,16.839124812955344,8,1025,0.0,21
2020-02-18 17:00:00+01:00,493,31,462,15.790488496822915,501,34,467,17.91816636651384,8,1025,0.0,21
2020-02-18 18:00:00+01:00,522,34,488,17.418929457126325,563,33,530,20.57076110354256,8,1025,0.0,21
2020-02-18 19:00:00+01:00,375,22,353,21.145699806578275,380,29,351,20.736920018387448,8,1025,0.0,21
2020-02-18 20:00:00+01:00,364,23,341,14.261868127983336,384,25,359,20.93762948810624,8,1025,0.0,21
2020-02-18 21:00:00+01:00,289,18,271,18.938144972747136,294,18,276,17.632695676481745,8,1025,0.0,21
2020-02-18 22:00:00+01:00,186,11,175,20.400698976924794,212,14,198,14.709005856097448,8,1025,0.0,21
2020-02-18 23:00:00+01:00,139,9,130,19.408576933840735,157,11,146,19.700921436065542,8,1025,0.0,21
2020-02-19 00:00:00+01:00,88,7,81,14.606173107577572,80,6,74,19.781178022419223,8,1022,0.0,26
2020-02-19 01:00:00+01:00,58,4,54,10.220927905289535,58,4,54,10.220927905289535,8,1022,0.0,26
2020-02-19 02:00:00+01:00,59,5,54,11.41076069350512,56,4,52,12.708841385488384,8,1022,0.0,26
2020-02-19 03:00:00+01:00,87,8,79,17.188718365321975,85,6,79,11.338371679676618,8,1022,0.0,26
2020-02-19 04:00:00+01:00,146,12,134,18.754590489717035,141,10,131,16.082921323202,8,1022,0.0,26
2020-02-19 05:00:00+01:00,261,21,240,22.290397298498814,250,17,233,16.748276094261186,8,1022,0.0,26
2020-02-19 06:00:00+01:00,319,28,291,24.01334617415068,298,20,278,21.055661887973457,8,1022,0.0,26
2020-02-19 07:00:00+01:00,493,45,448,19.413114642597456,476,33,443,21.264665184026093,8,1022,0.0,26
2020-02-19 08:00:00+01:00,519,41,478,17.770207620206634,523,35,488,19.232400876414125,8,1022,0.0,26
2020-02-19 09:00:00+01:00,353,33,320,16.072474715915927,328,26,302,18.98715264551659,8,1022,0.0,26
2020-02-19 10:00:00+01:00,296,26,270,17.230558324905093,269,19,250,18.12289110818214,8,1022,0.0,26
2020-02-19 11:00:00+01:00,351,32,319,21.009303371553763,333,22,311,20.360845500171493,8,1022,0.0,26
2020-02-19 12:00:00+01:00,296,28,268,17.230558324905093,269,19,250,18.12289110818214,8,1022,0.0,26
2020-02-19 13:00:00+01:00,293,27,266,20.77933514509894,281,22,259,16.495274317847883,8,1022,0.0,26
2020-02-19 14:00:00+01:00,294,26,268,24.118136039782872,271,19,252,21.366756148139427,8,1022,0.0,26
2020-02-19 15:00:00+01:00,324,28,296,25.318103431421573,291,22,269,15.818920682290248,8,1022,0.0,26
2020-02-19 16:00:00+01:00,356,33,323,15.115185640587857,323,28,295,20.660649403872643,8,1022,0.0,26
2020-02-19 17:00:00+01:00,493,39,454,19.413114642597456,476,33,443,21.264665184026093,8,1022,0.0,26
2020-02-19 18:00:00+01:00,519,41,478,17.770207620206634,523,35,488,19.232400876414125,8,1022,0.0,26
2020-02-19 19:00:00+01:00,382,36,346,20.636704160930535,356,24,332,15.115185640587857,8,1022,0.0,26
2020-02-19 20:00:00+01:00,377,36,341,22.934146173926393,345,26,319,20.188429732979824,8,1022,0.0,26
2020-02-19 21:00:00+01:00,293,24,269,20.77933514509894,281,22,259,16.495274317847883,8,1022,0.0,26
2020-02-19 22:00:00+01:00,206,18,188,26.316276075539704,185,14,171,13.724989686195345,8,1022,0.0,26
2020-02-19 23:00:00+01:00,144,11,133,16.028123717603865,129,10,119,12.321757402623772,8,1022,0.0,26
2020-02-20 00:00:00+01:00,96,5,91,10.792244903732447,98,8,90,9.366341704429512,9,1022,0.4,14
2020-02-20 01:00:00+01:00,66,4,62,9.595877216947136,61,6,55,13.45123014142322,9,1022,0.4,14
2020-02-20 02:00:00+01:00,59,3,56,11.512224289105106,66,7,59,9.595877216947136,9,1022,0.4,14
2020-02-20 03:00:00+01:00,86,4,82,9.565861223121674,101,8,93,14.022694861996197,9,1022,0.4,14
2020-02-20 04:00:00+01:00,161,9,152,19.39413115763897,160,15,145,18.858823274894117,9,1022,0.4,14
2020-02-20 05:00:00+01:00,284,16,268,16.935782048371557,284,26,258,16.935782048371557,9,1022,0.4,14
2020-02-20 06:00:00+01:00,338,18,320,21.621773010719025,357,40,317,16.579219218063535,9,1022,0.4,14
2020-02-20 07:00:00+01:00,527,33,494,19.476857580866454,564,53,511,21.848445480580413,9,1022,0.4,14
2020-02-20 08:00:00+01:00,552,34,518,20.753952450553925,598,55,543,18.730887083184363,9,1022,0.4,14
2020-02-20 09:00:00+01:00,365,22,343,16.041850092706873,378,35,343,21.49376685031853,9,1022,0.4,14
2020-02-20 10:00:00+01:00,332,19,313,20.862138293674573,331,32,299,19.942495480727644,9,1022,0.4,14
2020-02-20 11:00:00+01:00,404,22,382,22.221089161183272,374,42,332,18.684901759797462,9,1022,0.4,14
2020-02-20 12:00:00+01:00,328,19,309,18.977288676463566,337,31,306,20.189680789887703,9,1022,0.4,14
2020-02-20 13:00:00+01:00,316,17,299,17.068110656006358,331,36,295,19.942495480727644,9,1022,0.4,14
2020-02-20 14:00:00+01:00,336,18,318,15.374523455613796,332,28,304,20.862138293674573,9,1022,0.4,14
2020-02-20 15:00:00+01:00,369,21,348,14.559507357779353,365,35,330,16.041850092706873,9,1022,0.4,14
2020-02-20 16:00:00+01:00,363,20,343,15.396964962658,387,34,353,20.68470776467254,9,1022,0.4,14
2020-02-20 17:00:00+01:00,539,30,509,17.186718203528475,526,51,475,18.838197735130766,9,1022,0.4,14
2020-02-20 18:00:00+01:00,556,32,524,19.844491850776702,573,54,519,20.236010926878542,9,1022,0.4,14
2020-02-20 19:00:00+01:00,402,21,381,13.628611178524041,405,46,359,16.41142237268212,9,1022,0.4,14
2020-02-20 20:00:00+01:00,378,21,357,21.49376685031853,429,43,386,19.67571066122959,9,1022,0.4,14
2020-02-20 21:00:00+01:00,306,19,287,16.19476586954662,312,31,281,17.101813661047903,9,1022,0.4,14
2020-02-20 22:00:00+01:00,235,14,221,19.654447093292166,230,21,209,16.58682627515864,9,1022,0.4,14
2020-02-20 23:00:00+01:00,156,9,147,17.899214712227696,160,17,143,18.858823274894117,9,1022,0.4,14
2020-02-21 00:00:00+01:00,113,7,106,20.97275705288615,110,7,103,20.964248322238312,7,1027,0.0,14
2020-02-21 01:00:00+01:00,74,5,69,9.886934519670994,77,5,72,11.693765322784895,7,1027,0.0,14
2020-02-21 02:00:00+01:00,77,5,72,11.693765322784895,77,5,72,11.693765322784895,7,1027,0.0,14
2020-02-21 03:00:00+01:00,117,8,109,13.539944397802945,112,8,104,19.016823421759323,7,1027,0.0,14
2020-02-21 04:00:00+01:00,192,13,179,17.31696395349906,193,14,179,18.376565992281673,7,1027,0.0,14
2020-02-21 05:00:00+01:00,336,23,313,15.374523455613796,350,20,330,19.39294883514927,7,1027,0.0,14
2020-02-21 06:00:00+01:00,414,27,387,20.92110305719904,417,33,384,22.354466756658574,7,1027,0.0,14
2020-02-21 07:00:00+01:00,650,44,606,20.406208347277076,634,46,588,20.850521117555463,7,1027,0.0,14
2020-02-21 08:00:00+01:00,710,52,658,20.355672308683296,686,52,634,20.211331837746997,7,1027,0.0,14
2020-02-21 09:00:00+01:00,473,32,441,14.300214591159298,454,30,424,17.559907338692536,7,1027,0.0,14
2020-02-21 10:00:00+01:00,389,28,361,18.813833392506616,377,25,352,20.61326270709296,7,1027,0.0,14
2020-02-21 11:00:00+01:00,461,32,429,21.59648486572868,462,31,431,22.520787209725228,7,1027,0.0,14
2020-02-21 12:00:00+01:00,382,25,357,19.156893019800307,360,25,335,15.914323746415016,7,1027,0.0,14
2020-02-21 13:00:00+01:00,374,26,348,18.684901759797462,384,27,357,20.93762948810624,7,1027,0.0,14
2020-02-21 14:00:00+01:00,390,28,362,22.823808870670177,366,25,341,16.269939741661524,7,1027,0.0,14
2020-02-21 15:00:00+01:00,433,30,403,17.57064657679897,409,26,383,21.901781937406163,7,1027,0.0,14
2020-02-21 16:00:00+01:00,473,32,441,14.300214591159298,454,30,424,17.559907338692536,7,1027,0.0,14
2020-02-21 17:00:00+01:00,661,48,613,20.06976750473662,630,40,590,13.503006235616843,7,1027,0.0,14
2020-02-21 18:00:00+01:00,696,46,650,17.027923031619004,648,40,608,19.0250543670476,7,1027,0.0,14
2020-02-21 19:00:00+01:00,490,36,454,25.075248566874926,486,36,450,25.256807440063877,7,1027,0.0,14
2020-02-21 20:00:00+01:00,508,37,471,11.879495628294928,512,40,472,16.667622950500245,7,1027,0.0,14
2020-02-21 21:00:00+01:00,381,27,354,20.1963539990622,389,26,363,18.813833392506616,7,1027,0.0,14
2020-02-21 22:00:00+01:00,265,18,247,17.981103781954623,268,16,252,20.190442141402777,7,1027,0.0,14
2020-02-21 23:00:00+01:00,193,13,180,18.376565992281673,182,13,169,16.329362148305133,7,1027,0.0,14
2020-02-22 00:00:00+01:00,113,4,109,15.421761430074353,119,5,114,15.920539807049082,9,1029,0.0,16
2020-02-22 01:00:00+01:00,75,3,72,11.8314049446629,82,3,79,11.950143461787906,9,1029,0.0,16
2020-02-22 02:00:00+01:00,75,3,72,11.8314049446629,82,3,79,11.950143461787906,9,1029,0.0,16
2020-02-22 03:00:00+01:00,113,4,109,15.421761430074353,119,5,114,15.920539807049082,9,1029,0.0,16
2020-02-22 04:00:00+01:00,152,7,145,15.521352115980086,164,6,158,17.04508883203371,9,1029,0.0,16
2020-02-22 05:00:00+01:00,193,8,185,15.803016108301952,201,7,194,13.923110814237354,9,1029,0.0,16
2020-02-22 06:00:00+01:00,304,12,292,17.388899925714064,319,14,305,17.902844208586608,9,1029,0.0,16
2020-02-22 07:00:00+01:00,467,19,448,12.327851409367451,490,22,468,17.126352456192755,9,1029,0.0,16
2020-02-22 08:00:00+01:00,636,28,608,18.93496792452342,659,23,636,20.86989438299481,9,1029,0.0,16
2020-02-22 09:00:00+01:00,655,28,627,21.266263816952357,693,25,668,21.469669783705342,9,1029,0.0,16
2020-02-22 10:00:00+01:00,564,23,541,17.894997027868744,605,28,577,16.68930573284185,9,1029,0.0,16
2020-02-22 11:00:00+01:00,464,20,444,17.998209325652255,492,21,471,18.29419745859776,9,1029,0.0,16
2020-02-22 12:00:00+01:00,461,19,442,20.137663055422987,484,21,463,17.77003244566044,9,1029,0.0,16
2020-02-22 13:00:00+01:00,496,22,474,17.338309517669067,533,23,510,18.186873348292107,9,1029,0.0,16
2020-02-22 14:00:00+01:00,461,20,441,20.137663055422987,484,21,463,17.77003244566044,9,1029,0.0,16
2020-02-22 15:00:00+01:00,535,24,511,16.821008880741488,570,22,548,19.065620013553424,9,1029,0.0,16
2020-02-22 16:00:00+01:00,530,21,509,18.581852334839628,573,20,553,19.486588020453116,9,1029,0.0,16
2020-02-22 17:00:00+01:00,617,27,590,20.73345555288903,640,22,618,18.383349343442266,9,1029,0.0,16
2020-02-22 18:00:00+01:00,561,22,539,19.46521037670725,617,26,591,20.73345555288903,9,1029,0.0,16
2020-02-22 19:00:00+01:00,449,17,432,18.93011755707906,492,21,471,18.29419745859776,9,1029,0.0,16
2020-02-22 20:00:00+01:00,424,17,407,17.598151510365682,452,17,435,20.457835069065744,9,1029,0.0,16
2020-02-22 21:00:00+01:00,395,18,377,22.122661435898713,401,18,383,20.418077893361566,9,1029,0.0,16
2020-02-22 22:00:00+01:00,315,12,303,16.570611602173244,321,12,309,16.145632477670972,9,1029,0.0,16
2020-02-22 23:00:00+01:00,150,5,145,17.56592584239261,158,5,153,15.520682112145103,9,1029,0.0,16
2020-02-23 00:00:00+01:00,78,2,76,15.351161243496865,86,1,85,12.26433019639111,13,1030,0.2,16
2020-02-23 01:00:00+01:00,47,1,46,2.664600317822904,70,1,69,10.058368549125793,13,1030,0.2,16
2020-02-23 02:00:00+01:00,51,1,50,9.370479781353653,70,1,69,10.058368549125793,13,1030,0.2,16
2020-02-23 03:00:00+01:00,76,2,74,13.539433160289862,86,1,85,12.26433019639111,13,1030,0.2,16
2020-02-23 04:00:00+01:00,95,2,93,12.33839690969564,112,3,109,15.806853407309559,13,1030,0.2,16
2020-02-23 05:00:00+01:00,120,3,117,16.653205610761642,147,4,143,15.368688681481572,13,1030,0.2,16
2020-02-23 06:00:00+01:00,205,5,200,17.848192713932285,205,5,200,17.848192713932285,13,1030,0.2,16
2020-02-23 07:00:00+01:00,288,8,280,15.208482117639065,334,8,326,16.121444874138597,13,1030,0.2,16
2020-02-23 08:00:00+01:00,390,10,380,17.116705354131824,542,12,530,19.962845961808647,13,1030,0.2,16
2020-02-23 09:00:00+01:00,450,11,439,18.72192177556589,606,17,589,16.428989532277228,13,1030,0.2,16
2020-02-23 10:00:00+01:00,371,9,362,22.160808065992768,503,15,488,17.292829814524758,13,1030,0.2,16
2020-02-23 11:00:00+01:00,304,8,296,17.388899925714064,310,9,301,21.07594915875671,13,1030,0.2,16
2020-02-23 12:00:00+01:00,319,9,310,17.902844208586608,393,9,384,18.9997609120005,13,1030,0.2,16
2020-02-23 13:00:00+01:00,318,9,309,18.935672225662945,406,11,395,19.046281960290386,13,1030,0.2,16
2020-02-23 14:00:00+01:00,302,9,293,15.388460750733547,310,9,301,21.07594915875671,13,1030,0.2,16
2020-02-23 15:00:00+01:00,373,10,363,21.959269594519817,390,9,381,17.116705354131824,13,1030,0.2,16
2020-02-23 16:00:00+01:00,365,9,356,13.841509085955579,468,11,457,17.065110214488303,13,1030,0.2,16
2020-02-23 17:00:00+01:00,431,12,419,17.430621680262487,461,13,448,20.137663055422987,13,1030,0.2,16
2020-02-23 18:00:00+01:00,377,11,366,22.413124399876164,392,10,382,20.694689399892454,13,1030,0.2,16
2020-02-23 19:00:00+01:00,293,8,285,16.31782341352916,357,9,348,17.217656619200195,13,1030,0.2,16
2020-02-23 20:00:00+01:00,269,7,262,17.405298576573397,365,10,355,13.841509085955579,13,1030,0.2,16
2020-02-23 21:00:00+01:00,258,6,252,16.32756833608363,315,7,308,16.570611602173244,13,1030,0.2,16
2020-02-23 22:00:00+01:00,196,5,191,16.38105770904846,287,8,279,15.556707060677866,13,1030,0.2,16
2020-02-23 23:00:00+01:00,97,2,95,12.899076821727318,101,2,99,15.722824076028786,13,1030,0.2,16
2020-02-24 00:00:00+01:00,90,6,84,10.477669283936715,86,7,79,9.565861223121674,12,1026,1.3,13
2020-02-24 01:00:00+01:00,61,3,58,13.45123014142322,60,4,56,12.98342242386016,12,1026,1.3,13
2020-02-24 02:00:00+01:00,59,4,55,11.512224289105106,60,4,56,12.98342242386016,12,1026,1.3,13
2020-02-24 03:00:00+01:00,89,6,83,10.527801976587284,86,7,79,9.565861223121674,12,1026,1.3,13
2020-02-24 04:00:00+01:00,153,9,144,18.67945251137068,143,9,134,15.49985590484046,12,1026,1.3,13
2020-02-24 05:00:00+01:00,273,19,254,23.139691796211615,266,23,243,15.200054248100818,12,1026,1.3,13
2020-02-24 06:00:00+01:00,336,23,313,15.374523455613796,329,21,308,20.177718732958198,12,1026,1.3,13
2020-02-24 07:00:00+01:00,512,34,478,16.667622950500245,503,41,462,20.681117537709245,12,1026,1.3,13
2020-02-24 08:00:00+01:00,537,41,496,17.84682050697329,523,43,480,15.86377141768892,12,1026,1.3,13
2020-02-24 09:00:00+01:00,361,24,337,18.385612781936853,367,27,340,16.178745311566107,12,1026,1.3,13
2020-02-24 10:00:00+01:00,286,19,267,20.747694740560487,297,22,275,17.48190242862812,12,1026,1.3,13
2020-02-24 11:00:00+01:00,340,25,315,14.37984208663957,346,28,318,17.93974987663749,12,1026,1.3,13
2020-02-24 12:00:00+01:00,305,22,283,21.145143787586594,294,21,273,17.632695676481745,12,1026,1.3,13
2020-02-24 13:00:00+01:00,285,18,267,19.95607218889837,297,22,275,17.48190242862812,12,1026,1.3,13
2020-02-24 14:00:00+01:00,283,21,262,18.945435241048195,292,20,272,17.87884891495493,12,1026,1.3,13
2020-02-24 15:00:00+01:00,312,20,292,17.101813661047903,335,27,308,21.63506552863301,12,1026,1.3,13
2020-02-24 16:00:00+01:00,361,24,337,18.385612781936853,367,27,340,16.178745311566107,12,1026,1.3,13
2020-02-24 17:00:00+01:00,487,32,455,20.801132823441247,515,42,473,18.515381952439686,12,1026,1.3,13
2020-02-24 18:00:00+01:00,520,38,482,16.742850474175178,546,37,509,22.692406056572345,12,1026,1.3,13
2020-02-24 19:00:00+01:00,376,24,352,20.486350839145686,394,30,364,20.620478231973475,12,1026,1.3,13
2020-02-24 20:00:00+01:00,375,26,349,21.145699806578275,397,27,370,17.649629378165546,12,1026,1.3,13
2020-02-24 21:00:00+01:00,283,21,262,18.945435241048195,292,20,272,17.87884891495493,12,1026,1.3,13
2020-02-24 22:00:00+01:00,199,12,187,19.11274068140836,206,14,192,20.90053052788098,12,1026,1.3,13
2020-02-24 23:00:00+01:00,143,10,133,15.49985590484046,151,12,139,19.14578123638998,12,1026,1.3,13
2020-02-25 00:00:00+01:00,89,5,84,10.527801976587284,87,6,81,9.504121716770046,9,1012,0.0,24
2020-02-25 01:00:00+01:00,57,3,54,11.247345675463038,61,4,57,13.45123014142322,9,1012,0.0,24
2020-02-25 02:00:00+01:00,58,3,55,11.561797090249616,57,3,54,11.247345675463038,9,1012,0.0,24
2020-02-25 03:00:00+01:00,88,6,82,8.437594054986977,86,5,81,9.565861223121674,9,1012,0.0,24
2020-02-25 04:00:00+01:00,143,8,135,15.49985590484046,157,11,146,19.700921436065542,9,1012,0.0,24
2020-02-25 05:00:00+01:00,262,15,247,13.900090096773878,268,16,252,20.190442141402777,9,1012,0.0,24
2020-02-25 06:00:00+01:00,314,19,295,19.77016372636934,347,27,320,19.911580344317716,9,1012,0.0,24
2020-02-25 07:00:00+01:00,476,32,444,20.090041264055532,516,34,482,18.189169879710622,9,1012,0.0,24
2020-02-25 08:00:00+01:00,525,31,494,20.014875638820815,559,36,523,16.28017139379397,9,1012,0.0,24
2020-02-25 09:00:00+01:00,339,21,318,18.9351903306688,366,29,337,16.269939741661524,9,1012,0.0,24
2020-02-25 10:00:00+01:00,294,18,276,17.632695676481745,294,18,276,17.632695676481745,9,1012,0.0,24
2020-02-25 11:00:00+01:00,319,18,301,23.232042011552885,354,23,331,22.475031570210557,9,1012,0.0,24
2020-02-25 12:00:00+01:00,286,17,269,20.747694740560487,308,21,287,19.852115147138527,9,1012,0.0,24
2020-02-25 13:00:00+01:00,264,16,248,17.866837611646663,306,18,288,16.19476586954662,9,1012,0.0,24
2020-02-25 14:00:00+01:00,264,16,248,17.866837611646663,306,18,288,16.19476586954662,9,1012,0.0,24
2020-02-25 15:00:00+01:00,291,18,273,14.14711867692869,339,25,314,18.9351903306688,9,1012,0.0,24
2020-02-25 16:00:00+01:00,331,23,308,19.942495480727644,373,24,349,16.839124812955344,9,1012,0.0,24
2020-02-25 17:00:00+01:00,493,31,462,15.790488496822915,501,34,467,17.91816636651384,9,1012,0.0,24
2020-02-25 18:00:00+01:00,522,34,488,17.418929457126325,563,33,530,20.57076110354256,9,1012,0.0,24
2020-02-25 19:00:00+01:00,375,22,353,21.145699806578275,380,29,351,20.736920018387448,9,1012,0.0,24
2020-02-25 20:00:00+01:00,364,23,341,14.261868127983336,384,25,359,20.93762948810624,9,1012,0.0,24
2020-02-25 21:00:00+01:00,289,18,271,18.938144972747136,294,18,276,17.632695676481745,9,1012,0.0,24
2020-02-25 22:00:00+01:00,186,11,175,20.400698976924794,212,14,198,14.709005856097448,9,1012,0.0,24
2020-02-25 23:00:00+01:00,139,9,130,19.408576933840735,157,11,146,19.700921436065542,9,1012,0.0,24
2020-02-26 00:00:00+01:00,88,7,81,14.606173107577572,80,6,74,19.781178022419223,5,1003,1.8,30
2020-02-26 01:00:00+01:00,58,4,54,10.220927905289535,58,4,54,10.220927905289535,5,1003,1.8,30
2020-02-26 02:00:00+01:00,59,5,54,11.41076069350512,56,4,52,12.708841385488384,5,1003,1.8,30
2020-02-26 03:00:00+01:00,87,8,79,17.188718365321975,85,6,79,11.338371679676618,5,1003,1.8,30
2020-02-26 04:00:00+01:00,146,12,134,18.754590489717035,141,10,131,16.082921323202,5,1003,1.8,30
2020-02-26 05:00:00+01:00,261,21,240,22.290397298498814,250,17,233,16.748276094261186,5,1003,1.8,30
2020-02-26 06:00:00+01:00,319,28,291,24.01334617415068,298,20,278,21.055661887973457,5,1003,1.8,30
2020-02-26 07:00:00+01:00,493,45,448,19.413114642597456,476,33,443,21.264665184026093,5,1003,1.8,30
2020-02-26 08:00:00+01:00,519,41,478,17.770207620206634,523,35,488,19.232400876414125,5,1003,1.8,30
2020-02-26 09:00:00+01:00,353,33,320,16.072474715915927,328,26,302,18.98715264551659,5,1003,1.8,30
2020-02-26 10:00:00+01:00,296,26,270,17.230558324905093,269,19,250,18.12289110818214,5,1003,1.8,30
2020-02-26 11:00:00+01:00,351,32,319,21.009303371553763,333,22,311,20.360845500171493,5,1003,1.8,30
2020-02-26 12:00:00+01:00,296,28,268,17.230558324905093,269,19,250,18.12289110818214,5,1003,1.8,30
2020-02-26 13:00:00+01:00,293,27,266,20.77933514509894,281,22,259,16.495274317847883,5,1003,1.8,30
2020-02-26 14:00:00+01:00,294,26,268,24.118136039782872,271,19,252,21.366756148139427,5,1003,1.8,30
2020-02-26 15:00:00+01:00,324,28,296,25.318103431421573,291,22,269,15.818920682290248,5,1003,1.8,30
2020-02-26 16:00:00+01:00,356,33,323,15.115185640587857,323,28,295,20.660649403872643,5,1003,1.8,30
2020-02-26 17:00:00+01:00,493,39,454,19.413114642597456,476,33,443,21.264665184026093,5,1003,1.8,30
2020-02-26 18:00:00+01:00,519,41,478,17.770207620206634,523,35,488,19.232400876414125,5,1003,1.8,30
2020-02-26 19:00:00+01:00,382,36,346,20.636704160930535,356,24,332,15.115185640587857,5,1003,1.8,30
2020-02-26 20:00:00+01:00,377,36,341,22.934146173926393,345,26,319,20.188429732979824,5,1003,1.8,30
2020-02-26 21:00:00+01:00,293,24,269,20.77933514509894,281,22,259,16.495274317847883,5,1003,1.8,30
2020-02-26 22:00:00+01:00,206,18,188,26.316276075539704,185,14,171,13.724989686195345,5,1003,1.8,30
2020-02-26 23:00:00+01:00,144,11,133,16.028123717603865,129,10,119,12.321757402623772,5,1003,1.8,30
2020-02-27 00:00:00+01:00,112,5,107,19.016823421759323,115,11,104,14.522258078721798,7,1016,0.0,14
2020-02-27 01:00:00+01:00,75,3,72,11.283880560685672,75,7,68,11.283880560685672,7,1016,0.0,14
2020-02-27 02:00:00+01:00,75,4,71,11.283880560685672,75,7,68,11.283880560685672,7,1016,0.0,14
2020-02-27 03:00:00+01:00,113,6,107,20.97275705288615,109,10,99,18.214376818550008,7,1016,0.0,14
2020-02-27 04:00:00+01:00,193,11,182,18.376565992281673,181,18,163,16.606730094694083,7,1016,0.0,14
2020-02-27 05:00:00+01:00,317,17,300,17.791113543708203,346,38,308,17.93974987663749,7,1016,0.0,14
2020-02-27 06:00:00+01:00,390,21,369,22.823808870670177,399,40,359,22.11505355738079,7,1016,0.0,14
2020-02-27 07:00:00+01:00,586,37,549,16.81893103683717,653,58,595,19.852184178371132,7,1016,0.0,14
2020-02-27 08:00:00+01:00,641,35,606,20.968994853354097,640,61,579,19.89133908452712,7,1016,0.0,14
2020-02-27 09:00:00+01:00,396,20,376,19.03159851440849,468,41,427,19.201560947119127,7,1016,0.0,14
2020-02-27 10:00:00+01:00,385,20,365,18.20092151022271,357,35,322,16.579219218063535,7,1016,0.0,14
2020-02-27 11:00:00+01:00,432,27,405,19.977965204645113,439,39,400,16.88815045240334,7,1016,0.0,14
2020-02-27 12:00:00+01:00,348,20,328,18.741511759901247,390,41,349,22.823808870670177,7,1016,0.0,14
2020-02-27 13:00:00+01:00,348,20,328,18.741511759901247,390,41,349,22.823808870670177,7,1016,0.0,14
2020-02-27 14:00:00+01:00,348,20,328,18.741511759901247,390,41,349,22.823808870670177,7,1016,0.0,14
2020-02-27 15:00:00+01:00,382,22,360,19.156893019800307,393,39,354,17.925669706725596,7,1016,0.0,14
2020-02-27 16:00:00+01:00,430,25,405,17.047954055769576,427,36,391,17.684962245617744,7,1016,0.0,14
2020-02-27 17:00:00+01:00,607,34,573,18.763498809037944,611,56,555,20.09744642918199,7,1016,0.0,14
2020-02-27 18:00:00+01:00,669,40,629,19.01720676950267,681,76,605,21.795687898236412,7,1016,0.0,14
2020-02-27 19:00:00+01:00,449,23,426,17.9741178967318,489,44,445,20.73788413871882,7,1016,0.0,14
2020-02-27 20:00:00+01:00,472,28,444,15.966412489673269,504,53,451,18.186363959256344,7,1016,0.0,14
2020-02-27 21:00:00+01:00,336,19,317,15.374523455613796,386,33,353,22.495942580430874,7,1016,0.0,14
2020-02-27 22:00:00+01:00,258,14,244,20.847323082118503,268,29,239,20.190442141402777,7,1016,0.0,14
2020-02-27 23:00:00+01:00,183,11,172,15.872019474492381,183,17,166,15.872019474492381,7,1016,0.0,14
2020-02-28 00:00:00+01:00,88,5,83,8.437594054986977,80,5,75,12.9514806028411,8,1006,0.0,21
2020-02-28 01:00:00+01:00,58,4,54,11.561797090249616,53,3,50,12.671576687621188,8,1006,0.0,21
2020-02-28 02:00:00+01:00,58,3,55,11.561797090249616,53,3,50,12.671576687621188,8,1006,0.0,21
2020-02-28 03:00:00+01:00,88,5,83,8.437594054986977,80,5,75,12.9514806028411,8,1006,0.0,21
2020-02-28 04:00:00+01:00,147,10,137,16.306492316544293,148,11,137,21.655119289441767,8,1006,0.0,21
2020-02-28 05:00:00+01:00,255,17,238,13.80583098758932,262,20,242,13.900090096773878,8,1006,0.0,21
2020-02-28 06:00:00+01:00,311,20,291,18.777054340822975,301,21,280,20.607812327110423,8,1006,0.0,21
2020-02-28 07:00:00+01:00,483,32,451,16.739079897917865,489,35,454,20.73788413871882,8,1006,0.0,21
2020-02-28 08:00:00+01:00,528,38,490,15.389090213676,520,32,488,16.742850474175178,8,1006,0.0,21
2020-02-28 09:00:00+01:00,353,22,331,19.24169978578992,346,27,319,17.93974987663749,8,1006,0.0,21
2020-02-28 10:00:00+01:00,292,21,271,17.87884891495493,274,16,258,20.52791870989968,8,1006,0.0,21
2020-02-28 11:00:00+01:00,356,27,329,20.05958990150746,336,26,310,15.374523455613796,8,1006,0.0,21
2020-02-28 12:00:00+01:00,290,18,272,19.079826100657762,274,16,258,20.52791870989968,8,1006,0.0,21
2020-02-28 13:00:00+01:00,296,22,274,18.406113827007673,275,17,258,20.236154766209,8,1006,0.0,21
2020-02-28 14:00:00+01:00,286,21,265,20.747694740560487,289,20,269,18.938144972747136,8,1006,0.0,21
2020-02-28 15:00:00+01:00,309,19,290,20.22531439412751,308,19,289,19.852115147138527,8,1006,0.0,21
2020-02-28 16:00:00+01:00,337,23,314,20.189680789887703,339,21,318,18.9351903306688,8,1006,0.0,21
2020-02-28 17:00:00+01:00,487,37,450,20.801132823441247,478,35,443,18.951044700892695,8,1006,0.0,21
2020-02-28 18:00:00+01:00,531,38,493,16.61168707204345,520,32,488,16.742850474175178,8,1006,0.0,21
2020-02-28 19:00:00+01:00,382,24,358,19.156893019800307,351,24,327,17.103376818692087,8,1006,0.0,21
2020-02-28 20:00:00+01:00,376,26,350,20.486350839145686,374,26,348,18.684901759797462,8,1006,0.0,21
2020-02-28 21:00:00+01:00,293,20,273,17.329297501722674,275,17,258,20.236154766209,8,1006,0.0,21
2020-02-28 22:00:00+01:00,200,15,185,21.668114478408352,197,12,185,19.118279085736297,8,1006,0.0,21
2020-02-28 23:00:00+01:00,140,9,131,15.157104538016958,147,10,137,16.306492316544293,8,1006,0.0,21
2020-02-29 00:00:00+01:00,38,2,36,5.960450042509954,39,2,37,6.913338666308079,9,1005,0.2,22
2020-02-29 01:00:00+01:00,24,1,23,0.16633697306049489,26,1,25,0.13434729751860394,9,1005,0.2,22
2020-02-29 02:00:00+01:00,25,1,24,0.10677168789919293,26,1,25,0.13434729751860394,9,1005,0.2,22
2020-02-29 03:00:00+01:00,38,2,36,5.960450042509954,39,2,37,6.913338666308079,9,1005,0.2,22
2020-02-29 04:00:00+01:00,48,3,45,9.964553643509852,52,2,50,14.472017643602554,9,1005,0.2,22
2020-02-29 05:00:00+01:00,62,4,58,14.019247608895405,65,4,61,10.13470849860639,9,1005,0.2,22
2020-02-29 06:00:00+01:00,101,6,95,14.022694861996197,105,6,99,16.343560716114418,9,1005,0.2,22
2020-02-29 07:00:00+01:00,147,9,138,16.306492316544293,159,10,149,19.89258263570152,9,1005,0.2,22
2020-02-29 08:00:00+01:00,206,11,195,20.90053052788098,208,12,196,18.807092053665322,9,1005,0.2,22
2020-02-29 09:00:00+01:00,213,14,199,20.238518600536185,223,14,209,18.802339292525456,9,1005,0.2,22
2020-02-29 10:00:00+01:00,187,12,175,15.611538170802525,198,12,186,20.173795644408123,9,1005,0.2,22
2020-02-29 11:00:00+01:00,152,10,142,18.686880121910534,155,8,147,18.708796369633056,9,1005,0.2,22
2020-02-29 12:00:00+01:00,145,8,137,19.922746131926434,158,8,150,19.40470350916573,9,1005,0.2,22
2020-02-29 13:00:00+01:00,167,9,158,19.047083059371815,172,10,162,18.863206387348974,9,1005,0.2,22
2020-02-29 14:00:00+01:00,154,8,146,19.868163821621103,155,8,147,18.708796369633056,9,1005,0.2,22
2020-02-29 15:00:00+01:00,169,9,160,20.526675282456768,185,10,175,20.88033942284811,9,1005,0.2,22
2020-02-29 16:00:00+01:00,172,10,162,18.863206387348974,186,9,177,20.400698976924794,9,1005,0.2,22
2020-02-29 17:00:00+01:00,199,12,187,19.11274068140836,209,10,199,16.60419034744366,9,1005,0.2,22
2020-02-29 18:00:00+01:00,190,11,179,20.182913119811044,197,10,187,19.118279085736297,9,1005,0.2,22
2020-02-29 19:00:00+01:00,146,9,137,19.4340926707284,157,8,149,19.700921436065542,9,1005,0.2,22
2020-02-29 20:00:00+01:00,142,8,134,19.57947604189084,146,8,138,19.4340926707284,9,1005,0.2,22
2020-02-29 21:00:00+01:00,124,7,117,14.467255533674502,129,7,122,12.81298343964759,9,1005,0.2,22
2020-02-29 22:00:00+01:00,100,6,94,12.129363492765288,105,7,98,16.343560716114418,9,1005,0.2,22
2020-02-29 23:00:00+01:00,49,3,46,12.126419816698254,52,2,50,14.472017643602554,9,1005,0.2,22
2020-03-01 00:00:00+01:00,48,1,47,2.118885624025071,62,1,61,9.933021674487964,7,1000,0.1,29
2020-03-01 01:00:00+01:00,31,0,31,0.09592672504460022,39,1,38,1.033561008980209,7,1000,0.1,29
2020-03-01 02:00:00+01:00,33,0,33,0.14141575834347447,44,1,43,2.806526197564455,7,1000,0.1,29
2020-03-01 03:00:00+01:00,49,1,48,6.860624429398525,67,1,66,8.7820789764259,7,1000,0.1,29
2020-03-01 04:00:00+01:00,66,1,65,9.023232667771104,81,2,79,13.57081910214519,7,1000,0.1,29
2020-03-01 05:00:00+01:00,83,2,81,14.646378896367615,86,2,84,12.26433019639111,7,1000,0.1,29
2020-03-01 06:00:00+01:00,123,3,120,15.194143124406915,158,4,154,15.520682112145103,7,1000,0.1,29
2020-03-01 07:00:00+01:00,203,5,198,14.15515549868705,207,5,202,15.748956490487041,7,1000,0.1,29
2020-03-01 08:00:00+01:00,273,7,266,21.28577278040721,270,7,263,17.22476411837893,7,1000,0.1,29
2020-03-01 09:00:00+01:00,271,7,264,18.609144291774015,320,7,313,16.959865599813572,7,1000,0.1,29
2020-03-01 10:00:00+01:00,231,6,225,23.040251819935676,257,6,251,15.41589678734927,7,1000,0.1,29
2020-03-01 11:00:00+01:00,195,5,190,17.033571067166147,275,8,267,15.101857250184825,7,1000,0.1,29
2020-03-01 12:00:00+01:00,185,5,180,12.907917224661341,268,8,260,18.728976419565118,7,1000,0.1,29
2020-03-01 13:00:00+01:00,207,5,202,15.748956490487041,244,5,239,21.645479919989064,7,1000,0.1,29
2020-03-01 14:00:00+01:00,186,4,182,14.883580611736797,245,5,240,18.743839545838085,7,1000,0.1,29
2020-03-01 15:00:00+01:00,217,5,212,17.475217936101426,278,6,272,18.588750350595824,7,1000,0.1,29
2020-03-01 16:00:00+01:00,223,6,217,14.162371988477169,273,8,265,21.28577278040721,7,1000,0.1,29
2020-03-01 17:00:00+01:00,247,7,240,19.35438042774601,334,9,325,16.121444874138597,7,1000,0.1,29
2020-03-01 18:00:00+01:00,233,6,227,19.131071941994424,257,6,251,15.41589678734927,7,1000,0.1,29
2020-03-01 19:00:00+01:00,195,5,190,17.033571067166147,275,8,267,15.101857250184825,7,1000,0.1,29
2020-03-01 20:00:00+01:00,170,4,166,17.360183949342197,201,4,197,13.923110814237354,7,1000,0.1,29
2020-03-01 21:00:00+01:00,158,4,154,15.520682112145103,229,5,224,17.77127130389445,7,1000,0.1,29
2020-03-01 22:00:00+01:00,124,3,121,16.092127235524575,158,4,154,15.520682112145103,7,1000,0.1,29
2020-03-01 23:00:00+01:00,67,1,66,8.7820789764259,86,2,84,12.26433019639111,7,1000,0.1,29
2020-03-02 00:00:00+01:00,84,5,79,7.6306798135980785,91,8,83,8.844154374326946,8,995,0.0,18
2020-03-02 01:00:00+01:00,58,3,55,11.561797090249616,57,4,53,11.247345675463038,8,995,0.0,18
2020-03-02 02:00:00+01:00,59,4,55,11.512224289105106,60,4,56,12.98342242386016,8,995,0.0,18
2020-03-02 03:00:00+01:00,89,6,83,10.527801976587284,86,7,79,9.565861223121674,8,995,0.0,18
2020-03-02 04:00:00+01:00,154,9,145,19.868163821621103,144,10,134,20.078554087092446,8,995,0.0,18
2020-03-02 05:00:00+01:00,271,17,254,22.542411999396236,266,19,247,15.200054248100818,8,995,0.0,18
2020-03-02 06:00:00+01:00,338,24,314,21.621773010719025,327,29,298,19.796623391570257,8,995,0.0,18
2020-03-02 07:00:00+01:00,524,34,490,18.41315419537223,522,43,479,17.418929457126325,8,995,0.0,18
2020-03-02 08:00:00+01:00,550,34,516,19.63353059078091,549,36,513,18.842448340385054,8,995,0.0,18
2020-03-02 09:00:00+01:00,362,26,336,18.876684992305748,348,30,318,18.741511759901247,8,995,0.0,18
2020-03-02 10:00:00+01:00,307,22,285,16.74476305242919,290,24,266,19.079826100657762,8,995,0.0,18
2020-03-02 11:00:00+01:00,343,22,321,16.93402466287014,359,31,328,19.276631617836294,8,995,0.0,18
2020-03-02 12:00:00+01:00,291,22,269,14.14711867692869,300,25,275,22.416712006057992,8,995,0.0,18
2020-03-02 13:00:00+01:00,284,20,264,16.935782048371557,294,20,274,17.632695676481745,8,995,0.0,18
2020-03-02 14:00:00+01:00,287,18,269,13.917461050382924,299,23,276,16.471342376610473,8,995,0.0,18
2020-03-02 15:00:00+01:00,314,23,291,19.77016372636934,337,27,310,20.189680789887703,8,995,0.0,18
2020-03-02 16:00:00+01:00,352,23,329,18.547693732895546,352,29,323,18.547693732895546,8,995,0.0,18
2020-03-02 17:00:00+01:00,491,35,456,20.639383164942465,503,41,462,20.681117537709245,8,995,0.0,18
2020-03-02 18:00:00+01:00,541,41,500,18.81222066269775,536,43,493,13.147585514482932,8,995,0.0,18
2020-03-02 19:00:00+01:00,383,24,359,21.26625994117601,392,29,363,22.18304148250548,8,995,0.0,18
2020-03-02 20:00:00+01:00,378,27,351,21.49376685031853,390,30,360,22.823808870670177,8,995,0.0,18
2020-03-02 21:00:00+01:00,286,20,266,20.747694740560487,299,23,276,16.471342376610473,8,995,0.0,18
2020-03-02 22:00:00+01:00,199,14,185,19.11274068140836,207,14,193,18.76558942906742,8,995,0.0,18
2020-03-02 23:00:00+01:00,151,10,141,19.14578123638998,154,11,143,19.868163821621103,8,995,0.0,18
2020-03-03 00:00:00+01:00,77,4,73,11.693765322784895,93,7,86,7.996959659096201,6,1004,0.0,16
2020-03-03 01:00:00+01:00,55,3,52,10.027044718132117,57,3,54,11.247345675463038,6,1004,0.0,16
2020-03-03 02:00:00+01:00,58,4,54,11.561797090249616,57,3,54,11.247345675463038,6,1004,0.0,16
2020-03-03 03:00:00+01:00,88,6,82,8.437594054986977,86,5,81,9.565861223121674,6,1004,0.0,16
2020-03-03 04:00:00+01:00,143,8,135,15.49985590484046,157,11,146,19.700921436065542,6,1004,0.0,16
2020-03-03 05:00:00+01:00,263,15,248,18.06193495748254,269,17,252,22.758175655823944,6,1004,0.0,16
2020-03-03 06:00:00+01:00,306,17,289,16.19476586954662,324,22,302,18.672846971084997,6,1004,0.0,16
2020-03-03 07:00:00+01:00,492,29,463,23.51531207195642,530,33,497,19.266675842235646,6,1004,0.0,16
2020-03-03 08:00:00+01:00,505,30,475,13.420156221106103,525,36,489,20.014875638820815,6,1004,0.0,16
2020-03-03 09:00:00+01:00,357,23,334,16.579219218063535,380,24,356,20.736920018387448,6,1004,0.0,16
2020-03-03 10:00:00+01:00,281,18,263,18.053311879599764,289,22,267,18.938144972747136,6,1004,0.0,16
2020-03-03 11:00:00+01:00,320,18,302,21.84611391715035,357,22,335,16.579219218063535,6,1004,0.0,16
2020-03-03 12:00:00+01:00,287,17,270,13.917461050382924,309,21,288,20.22531439412751,6,1004,0.0,16
2020-03-03 13:00:00+01:00,272,16,256,21.117195423222,301,19,282,20.607812327110423,6,1004,0.0,16
2020-03-03 14:00:00+01:00,273,16,257,23.139691796211615,305,24,281,21.145143787586594,6,1004,0.0,16
2020-03-03 15:00:00+01:00,300,18,282,22.416712006057992,323,24,299,19.446887597808452,6,1004,0.0,16
2020-03-03 16:00:00+01:00,334,21,313,17.139636433234756,370,22,348,20.080410304897075,6,1004,0.0,16
2020-03-03 17:00:00+01:00,464,28,436,21.34229223380193,527,35,492,19.476857580866454,6,1004,0.0,16
2020-03-03 18:00:00+01:00,510,31,479,16.559257473278713,551,41,510,17.61916856629276,6,1004,0.0,16
2020-03-03 19:00:00+01:00,347,21,326,19.911580344317716,403,31,372,21.627704849822535,6,1004,0.0,16
2020-03-03 20:00:00+01:00,346,24,322,17.93974987663749,411,30,381,17.61880175865933,6,1004,0.0,16
2020-03-03 21:00:00+01:00,278,18,260,19.287262138921047,301,19,282,20.607812327110423,6,1004,0.0,16
2020-03-03 22:00:00+01:00,191,11,180,21.61132830766016,216,13,203,17.62117954457743,6,1004,0.0,16
2020-03-03 23:00:00+01:00,129,8,121,12.81298343964759,152,10,142,18.686880121910534,6,1004,0.0,16
2020-03-04 00:00:00+01:00,156,12,144,25.60353225427304,149,10,139,18.476483571588744,7,1013,0.0,9
2020-03-04 01:00:00+01:00,105,9,96,16.064586492970292,98,7,91,18.03644044567539,7,1013,0.0,9
2020-03-04 02:00:00+01:00,105,8,97,16.064586492970292,98,7,91,18.03644044567539,7,1013,0.0,9
2020-03-04 03:00:00+01:00,160,12,148,21.971340940322392,145,11,134,13.359321181044377,7,1013,0.0,9
2020-03-04 04:00:00+01:00,260,23,237,23.629514257400476,251,18,233,16.681136040039966,7,1013,0.0,9
2020-03-04 05:00:00+01:00,475,41,434,19.6579748130494,467,32,435,23.392169574456698,7,1013,0.0,9
2020-03-04 06:00:00+01:00,586,49,537,20.64984702267193,553,48,505,20.118765737907236,7,1013,0.0,9
2020-03-04 07:00:00+01:00,911,73,838,25.833849139564798,904,76,828,16.636225395332858,7,1013,0.0,9
2020-03-04 08:00:00+01:00,970,76,894,18.0275044206988,862,77,785,19.55808625072706,7,1013,0.0,9
2020-03-04 09:00:00+01:00,628,55,573,18.831524381794868,584,44,540,19.403324970579884,7,1013,0.0,9
2020-03-04 10:00:00+01:00,536,44,492,12.072316882001537,496,43,453,16.493355873141443,7,1013,0.0,9
2020-03-04 11:00:00+01:00,646,56,590,22.756934880827867,600,41,559,17.05773046632912,7,1013,0.0,9
2020-03-04 12:00:00+01:00,533,50,483,16.489207387178066,529,35,494,15.236255847579951,7,1013,0.0,9
2020-03-04 13:00:00+01:00,536,44,492,12.072316882001537,496,43,453,16.493355873141443,7,1013,0.0,9
2020-03-04 14:00:00+01:00,538,47,491,18.031855257535994,507,35,472,15.628100284848658,7,1013,0.0,9
2020-03-04 15:00:00+01:00,580,52,528,19.253819838780124,589,48,541,16.22308117067377,7,1013,0.0,9
2020-03-04 16:00:00+01:00,631,59,572,19.989752871263,618,42,576,15.401124934127942,7,1013,0.0,9
2020-03-04 17:00:00+01:00,908,78,830,27.833773000401873,850,61,789,24.27710221785575,7,1013,0.0,9
2020-03-04 18:00:00+01:00,950,81,869,19.47067143596011,962,63,899,14.365208766168493,7,1013,0.0,9
2020-03-04 19:00:00+01:00,682,62,620,23.691923575455103,653,57,596,23.74093072982042,7,1013,0.0,9
2020-03-04 20:00:00+01:00,678,57,621,23.15205097305087,671,47,624,23.971107131659732,7,1013,0.0,9
2020-03-04 21:00:00+01:00,535,48,487,11.54133062653365,516,34,482,19.477342984372644,7,1013,0.0,9
2020-03-04 22:00:00+01:00,374,31,343,16.910170840562934,331,29,302,19.342929405123495,7,1013,0.0,9
2020-03-04 23:00:00+01:00,265,24,241,20.34267348407847,238,17,221,26.357922750399336,7,1013,0.0,9
2020-03-05 00:00:00+01:00,77,4,73,11.693765322784895,87,9,78,9.504121716770046,10,1005,0.4,17
2020-03-05 01:00:00+01:00,51,2,49,13.024781207847502,57,6,51,11.247345675463038,10,1005,0.4,17
2020-03-05 02:00:00+01:00,58,3,55,11.561797090249616,53,5,48,12.671576687621188,10,1005,0.4,17
2020-03-05 03:00:00+01:00,74,4,70,9.886934519670994,88,9,79,8.437594054986977,10,1005,0.4,17
2020-03-05 04:00:00+01:00,125,7,118,11.899638158178501,140,15,125,15.157104538016958,10,1005,0.4,17
2020-03-05 05:00:00+01:00,263,13,250,18.06193495748254,251,22,229,17.440368481170164,10,1005,0.4,17
2020-03-05 06:00:00+01:00,324,20,304,18.672846971084997,304,27,277,24.382586098170826,10,1005,0.4,17
2020-03-05 07:00:00+01:00,438,26,412,18.033066079167238,468,47,421,19.201560947119127,10,1005,0.4,17
2020-03-05 08:00:00+01:00,524,28,496,18.41315419537223,529,45,484,16.649089834553955,10,1005,0.4,17
2020-03-05 09:00:00+01:00,348,18,330,18.741511759901247,354,37,317,22.475031570210557,10,1005,0.4,17
2020-03-05 10:00:00+01:00,272,17,255,21.117195423222,281,25,256,18.053311879599764,10,1005,0.4,17
2020-03-05 11:00:00+01:00,301,18,283,20.607812327110423,338,31,307,21.621773010719025,10,1005,0.4,17
2020-03-05 12:00:00+01:00,284,18,266,16.935782048371557,278,25,253,19.287262138921047,10,1005,0.4,17
2020-03-05 13:00:00+01:00,274,15,259,20.52791870989968,281,25,256,18.053311879599764,10,1005,0.4,17
2020-03-05 14:00:00+01:00,250,15,235,19.251014174910523,273,25,248,23.139691796211615,10,1005,0.4,17
2020-03-05 15:00:00+01:00,310,19,291,15.258998808795859,301,30,271,20.607812327110423,10,1005,0.4,17
2020-03-05 16:00:00+01:00,331,18,313,19.942495480727644,350,32,318,19.39294883514927,10,1005,0.4,17
2020-03-05 17:00:00+01:00,458,25,433,23.935839893982745,465,40,425,21.293065375383044,10,1005,0.4,17
2020-03-05 18:00:00+01:00,448,24,424,19.19628206057244,498,50,448,14.222982449555595,10,1005,0.4,17
2020-03-05 19:00:00+01:00,331,19,312,19.942495480727644,379,35,344,19.424797748224545,10,1005,0.4,17
2020-03-05 20:00:00+01:00,380,22,358,20.736920018387448,377,38,339,20.61326270709296,10,1005,0.4,17
2020-03-05 21:00:00+01:00,292,17,275,17.87884891495493,274,24,250,20.52791870989968,10,1005,0.4,17
2020-03-05 22:00:00+01:00,192,10,182,17.31696395349906,204,22,182,20.27930898180519,10,1005,0.4,17
2020-03-05 23:00:00+01:00,148,8,140,21.655119289441767,140,14,126,15.157104538016958,10,1005,0.4,17
2020-03-06 00:00:00+01:00,88,6,82,8.437594054986977,80,5,75,12.9514806028411,7,991,3.3,27
2020-03-06 01:00:00+01:00,58,4,54,11.561797090249616,53,3,50,12.671576687621188,7,991,3.3,27
2020-03-06 02:00:00+01:00,58,3,55,11.561797090249616,53,3,50,12.671576687621188,7,991,3.3,27
2020-03-06 03:00:00+01:00,88,5,83,8.437594054986977,80,5,75,12.9514806028411,7,991,3.3,27
2020-03-06 04:00:00+01:00,147,10,137,16.306492316544293,148,11,137,21.655119289441767,7,991,3.3,27
2020-03-06 05:00:00+01:00,255,17,238,13.80583098758932,262,20,242,13.900090096773878,7,991,3.3,27
2020-03-06 06:00:00+01:00,311,20,291,18.777054340822975,301,21,280,20.607812327110423,7,991,3.3,27
2020-03-06 07:00:00+01:00,483,32,451,16.739079897917865,489,35,454,20.73788413871882,7,991,3.3,27
2020-03-06 08:00:00+01:00,528,38,490,15.389090213676,520,32,488,16.742850474175178,7,991,3.3,27
2020-03-06 09:00:00+01:00,353,22,331,19.24169978578992,346,27,319,17.93974987663749,7,991,3.3,27
2020-03-06 10:00:00+01:00,292,21,271,17.87884891495493,274,16,258,20.52791870989968,7,991,3.3,27
2020-03-06 11:00:00+01:00,356,27,329,20.05958990150746,336,26,310,15.374523455613796,7,991,3.3,27
2020-03-06 12:00:00+01:00,290,18,272,19.079826100657762,274,16,258,20.52791870989968,7,991,3.3,27
2020-03-06 13:00:00+01:00,296,22,274,18.406113827007673,275,17,258,20.236154766209,7,991,3.3,27
2020-03-06 14:00:00+01:00,286,21,265,20.747694740560487,289,20,269,18.938144972747136,7,991,3.3,27
2020-03-06 15:00:00+01:00,309,19,290,20.22531439412751,308,19,289,19.852115147138527,7,991,3.3,27
2020-03-06 16:00:00+01:00,337,23,314,20.189680789887703,339,21,318,18.9351903306688,7,991,3.3,27
2020-03-06 17:00:00+01:00,487,37,450,20.801132823441247,478,35,443,18.951044700892695,7,991,3.3,27
2020-03-06 18:00:00+01:00,531,38,493,16.61168707204345,520,32,488,16.742850474175178,7,991,3.3,27
2020-03-06 19:00:00+01:00,382,24,358,19.156893019800307,351,24,327,17.103376818692087,7,991,3.3,27
2020-03-06 20:00:00+01:00,376,26,350,20.486350839145686,374,26,348,18.684901759797462,7,991,3.3,27
2020-03-06 21:00:00+01:00,293,20,273,17.329297501722674,275,17,258,20.236154766209,7,991,3.3,27
2020-03-06 22:00:00+01:00,200,15,185,21.668114478408352,197,12,185,19.118279085736297,7,991,3.3,27
2020-03-06 23:00:00+01:00,140,9,131,15.157104538016958,147,10,137,16.306492316544293,7,991,3.3,27
2020-03-07 00:00:00+01:00,69,4,65,11.382640456570568,71,4,67,11.584371388309396,8,1014,0.0,10
2020-03-07 01:00:00+01:00,43,2,41,8.357669380798958,45,2,43,8.150223537761923,8,1014,0.0,10
2020-03-07 02:00:00+01:00,45,2,43,8.150223537761923,47,2,45,8.734704942588355,8,1014,0.0,10
2020-03-07 03:00:00+01:00,69,4,65,11.382640456570568,71,4,67,11.584371388309396,8,1014,0.0,10
2020-03-07 04:00:00+01:00,89,6,83,10.527801976587284,93,5,88,7.996959659096201,8,1014,0.0,10
2020-03-07 05:00:00+01:00,113,7,106,20.97275705288615,118,6,112,16.65435568776215,8,1014,0.0,10
2020-03-07 06:00:00+01:00,186,11,175,20.400698976924794,189,10,179,20.00253163985096,8,1014,0.0,10
2020-03-07 07:00:00+01:00,277,18,259,19.768862676933345,284,15,269,16.935782048371557,8,1014,0.0,10
2020-03-07 08:00:00+01:00,359,21,338,19.276631617836294,381,25,356,20.1963539990622,8,1014,0.0,10
2020-03-07 09:00:00+01:00,392,23,369,22.18304148250548,403,24,379,21.627704849822535,8,1014,0.0,10
2020-03-07 10:00:00+01:00,334,22,312,17.139636433234756,359,18,341,19.276631617836294,8,1014,0.0,10
2020-03-07 11:00:00+01:00,270,18,252,18.31838596155419,284,16,268,16.935782048371557,8,1014,0.0,10
2020-03-07 12:00:00+01:00,270,15,255,18.31838596155419,284,16,268,16.935782048371557,8,1014,0.0,10
2020-03-07 13:00:00+01:00,292,17,275,17.87884891495493,306,15,291,16.19476586954662,8,1014,0.0,10
2020-03-07 14:00:00+01:00,266,16,250,15.200054248100818,290,17,273,19.079826100657762,8,1014,0.0,10
2020-03-07 15:00:00+01:00,312,17,295,17.101813661047903,337,22,315,20.189680789887703,8,1014,0.0,10
2020-03-07 16:00:00+01:00,317,18,299,17.791113543708203,336,21,315,15.374523455613796,8,1014,0.0,10
2020-03-07 17:00:00+01:00,370,20,350,20.080410304897075,381,21,360,20.1963539990622,8,1014,0.0,10
2020-03-07 18:00:00+01:00,347,21,326,19.911580344317716,359,23,336,19.276631617836294,8,1014,0.0,10
2020-03-07 19:00:00+01:00,270,18,252,18.31838596155419,284,16,268,16.935782048371557,8,1014,0.0,10
2020-03-07 20:00:00+01:00,246,14,232,21.917745613565252,259,13,246,22.975221531884507,8,1014,0.0,10
2020-03-07 21:00:00+01:00,231,14,217,18.808415660395674,241,15,226,17.853279648834448,8,1014,0.0,10
2020-03-07 22:00:00+01:00,177,10,167,13.959346220493531,189,10,179,20.00253163985096,8,1014,0.0,10
2020-03-07 23:00:00+01:00,91,6,85,8.844154374326946,94,5,89,10.166272350500234,8,1014,0.0,10
2020-03-08 00:00:00+01:00,25,0,25,0.10677168789919293,35,1,34,5.369702870779087,9,1020,0.0,17
2020-03-08 01:00:00+01:00,16,0,16,0.0,21,0,21,0.0727095127790566,9,1020,0.0,17
2020-03-08 02:00:00+01:00,16,0,16,0.0,21,0,21,0.0727095127790566,9,1020,0.0,17
2020-03-08 03:00:00+01:00,24,0,24,0.16633697306049489,32,1,31,4.0395468395825125,9,1020,0.0,17
2020-03-08 04:00:00+01:00,34,1,33,4.1719622498891535,44,1,43,9.212556088945261,9,1020,0.0,17
2020-03-08 05:00:00+01:00,44,1,43,9.212556088945261,56,2,54,11.681432660358455,9,1020,0.0,17
2020-03-08 06:00:00+01:00,65,2,63,10.13470849860639,94,3,91,10.166272350500234,9,1020,0.0,17
2020-03-08 07:00:00+01:00,103,4,99,17.210287037863655,106,3,103,19.560878716092326,9,1020,0.0,17
2020-03-08 08:00:00+01:00,146,5,141,19.4340926707284,172,6,166,18.863206387348974,9,1020,0.0,17
2020-03-08 09:00:00+01:00,155,5,150,18.708796369633056,149,5,144,17.937448228249327,9,1020,0.0,17
2020-03-08 10:00:00+01:00,127,5,122,18.022773693841014,155,6,149,18.708796369633056,9,1020,0.0,17
2020-03-08 11:00:00+01:00,99,3,96,10.313624634117142,137,6,131,15.965917364236809,9,1020,0.0,17
2020-03-08 12:00:00+01:00,107,4,103,12.742346635562697,147,5,142,16.306492316544293,9,1020,0.0,17
2020-03-08 13:00:00+01:00,117,5,112,13.539944397802945,134,5,129,14.696678321454899,9,1020,0.0,17
2020-03-08 14:00:00+01:00,107,4,103,12.742346635562697,147,5,142,16.306492316544293,9,1020,0.0,17
2020-03-08 15:00:00+01:00,127,5,122,18.022773693841014,144,6,138,20.078554087092446,9,1020,0.0,17
2020-03-08 16:00:00+01:00,123,4,119,13.78591137222831,125,4,121,11.899638158178501,9,1020,0.0,17
2020-03-08 17:00:00+01:00,137,5,132,15.965917364236809,188,7,181,19.664617237016223,9,1020,0.0,17
2020-03-08 18:00:00+01:00,128,4,124,16.268122259148125,154,6,148,19.868163821621103,9,1020,0.0,17
2020-03-08 19:00:00+01:00,99,3,96,10.313624634117142,137,6,131,15.965917364236809,9,1020,0.0,17
2020-03-08 20:00:00+01:00,97,3,94,12.91170780960746,113,4,109,20.97275705288615,9,1020,0.0,17
2020-03-08 21:00:00+01:00,85,3,82,9.516934044829473,122,4,118,15.53082002471091,9,1020,0.0,17
2020-03-08 22:00:00+01:00,68,2,66,8.84385076442631,90,3,87,10.477669283936715,9,1020,0.0,17
2020-03-08 23:00:00+01:00,33,1,32,6.0078012500217595,45,1,44,8.150223537761923,9,1020,0.0,17
2020-03-09 00:00:00+01:00,39,3,36,6.782457974710225,37,4,33,2.066086063070793,8,1014,0.4,18
2020-03-09 01:00:00+01:00,26,2,24,1.5382661455122164,26,2,24,1.5382661455122164,8,1014,0.4,18
2020-03-09 02:00:00+01:00,24,2,22,1.5004308879154395,26,2,24,1.5382661455122164,8,1014,0.4,18
2020-03-09 03:00:00+01:00,37,3,34,2.066086063070793,39,4,35,6.782457974710225,8,1014,0.4,18
2020-03-09 04:00:00+01:00,60,5,55,10.583722413773145,62,6,56,14.48690450543278,8,1014,0.4,18
2020-03-09 05:00:00+01:00,108,10,98,14.813734676069407,112,11,101,14.898852003445265,8,1014,0.4,18
2020-03-09 06:00:00+01:00,136,13,123,16.594078125250377,142,16,126,21.623487252479663,8,1014,0.4,18
2020-03-09 07:00:00+01:00,226,22,204,20.308697708911414,214,23,191,18.560318290748608,8,1014,0.4,18
2020-03-09 08:00:00+01:00,239,24,215,13.74553452780325,235,29,206,20.674840106170866,8,1014,0.4,18
2020-03-09 09:00:00+01:00,154,16,138,23.457384968254527,151,18,133,19.408157188048275,8,1014,0.4,18
2020-03-09 10:00:00+01:00,128,11,117,19.601953989978306,128,12,116,19.601953989978306,8,1014,0.4,18
2020-03-09 11:00:00+01:00,152,13,139,20.188330220444417,154,15,139,23.457384968254527,8,1014,0.4,18
2020-03-09 12:00:00+01:00,123,13,110,19.074654696202938,128,14,114,19.601953989978306,8,1014,0.4,18
2020-03-09 13:00:00+01:00,127,11,116,19.116953333289125,125,13,112,23.026828253397017,8,1014,0.4,18
2020-03-09 14:00:00+01:00,127,11,116,19.116953333289125,125,13,112,23.026828253397017,8,1014,0.4,18
2020-03-09 15:00:00+01:00,139,12,127,18.732486269107348,137,15,122,18.928795118329443,8,1014,0.4,18
2020-03-09 16:00:00+01:00,145,14,131,18.85528596371164,157,17,140,23.857880119976507,8,1014,0.4,18
2020-03-09 17:00:00+01:00,216,21,195,21.273439412003903,220,27,193,16.758079648934128,8,1014,0.4,18
2020-03-09 18:00:00+01:00,228,21,207,15.818609956751573,225,22,203,17.07968654570721,8,1014,0.4,18
2020-03-09 19:00:00+01:00,168,15,153,20.304807772345505,167,18,149,21.39117903937357,8,1014,0.4,18
2020-03-09 20:00:00+01:00,166,16,150,18.57114730689396,170,20,150,19.775542485132945,8,1014,0.4,18
2020-03-09 21:00:00+01:00,122,13,109,20.245567873519157,131,15,116,14.183230975852695,8,1014,0.4,18
2020-03-09 22:00:00+01:00,89,8,81,17.562315027840828,89,8,81,17.562315027840828,8,1014,0.4,18
2020-03-09 23:00:00+01:00,63,5,58,14.929801273937542,62,6,56,14.48690450543278,8,1014,0.4,18
2020-03-10 00:00:00+01:00,33,2,31,5.985660510090718,39,3,36,6.782457974710225,12,1017,1.5,21
2020-03-10 01:00:00+01:00,22,1,21,0.1277873501672996,26,2,24,1.5382661455122164,12,1017,1.5,21
2020-03-10 02:00:00+01:00,25,2,23,1.1875344360364632,27,2,25,1.9016023008994223,12,1017,1.5,21
2020-03-10 03:00:00+01:00,38,3,35,11.101073107969722,40,4,36,5.275608835029151,12,1017,1.5,21
2020-03-10 04:00:00+01:00,62,5,57,14.48690450543278,62,5,57,14.48690450543278,12,1017,1.5,21
2020-03-10 05:00:00+01:00,101,8,93,11.280950715811313,121,12,109,20.317620945183666,12,1017,1.5,21
2020-03-10 06:00:00+01:00,138,11,127,20.21600799483387,138,14,124,20.21600799483387,12,1017,1.5,21
2020-03-10 07:00:00+01:00,192,17,175,21.295822766447603,225,21,204,17.07968654570721,12,1017,1.5,21
2020-03-10 08:00:00+01:00,218,18,200,22.57742359713229,242,27,215,20.990360069331732,12,1017,1.5,21
2020-03-10 09:00:00+01:00,142,13,129,21.623487252479663,164,16,148,22.827361263214527,12,1017,1.5,21
2020-03-10 10:00:00+01:00,129,10,119,17.995114557081255,131,11,120,14.183230975852695,12,1017,1.5,21
2020-03-10 11:00:00+01:00,142,11,131,21.623487252479663,164,16,148,22.827361263214527,12,1017,1.5,21
2020-03-10 12:00:00+01:00,129,10,119,17.995114557081255,131,11,120,14.183230975852695,12,1017,1.5,21
2020-03-10 13:00:00+01:00,119,9,110,22.46945513312648,129,12,117,17.995114557081255,12,1017,1.5,21
2020-03-10 14:00:00+01:00,119,9,110,22.46945513312648,129,12,117,17.995114557081255,12,1017,1.5,21
2020-03-10 15:00:00+01:00,130,10,120,15.65660051079879,144,12,132,22.91915418498221,12,1017,1.5,21
2020-03-10 16:00:00+01:00,139,13,126,18.732486269107348,150,15,135,17.939622434692456,12,1017,1.5,21
2020-03-10 17:00:00+01:00,209,17,192,22.16757043059366,224,19,205,16.30248157536985,12,1017,1.5,21
2020-03-10 18:00:00+01:00,213,17,196,20.488166305452438,246,24,222,17.57126233227549,12,1017,1.5,21
2020-03-10 19:00:00+01:00,153,14,139,14.915022999208679,172,15,157,19.644113972447897,12,1017,1.5,21
2020-03-10 20:00:00+01:00,155,15,140,19.469409355748308,165,18,147,20.56038540292619,12,1017,1.5,21
2020-03-10 21:00:00+01:00,119,11,108,22.46945513312648,129,12,117,17.995114557081255,12,1017,1.5,21
2020-03-10 22:00:00+01:00,83,6,77,18.699193296190067,90,9,81,13.960700117154147,12,1017,1.5,21
2020-03-10 23:00:00+01:00,58,4,54,10.505136369992313,67,7,60,12.5039951599288,12,1017,1.5,21
2020-03-11 00:00:00+01:00,55,6,49,10.403440874465877,54,6,48,10.817024136428179,15,1017,0.0,21
2020-03-11 01:00:00+01:00,36,4,32,6.926188930365992,33,3,30,11.465261513985924,15,1017,0.0,21
2020-03-11 02:00:00+01:00,36,4,32,6.926188930365992,33,3,30,11.465261513985924,15,1017,0.0,21
2020-03-11 03:00:00+01:00,55,7,48,10.403440874465877,54,6,48,10.817024136428179,15,1017,0.0,21
2020-03-11 04:00:00+01:00,93,10,83,19.729575953685952,90,10,80,18.392649197374546,15,1017,0.0,21
2020-03-11 05:00:00+01:00,167,21,146,16.493575022686013,155,14,141,20.64602175207135,15,1017,0.0,21
2020-03-11 06:00:00+01:00,206,26,180,26.316276075539704,184,20,164,11.126916077945086,15,1017,0.0,21
2020-03-11 07:00:00+01:00,316,41,275,12.954823545566947,296,30,266,17.230558324905093,15,1017,0.0,21
2020-03-11 08:00:00+01:00,332,39,293,19.089795695646295,338,43,295,25.380150029874855,15,1017,0.0,21
2020-03-11 09:00:00+01:00,221,25,196,22.998371773489566,218,24,194,22.73300845004657,15,1017,0.0,21
2020-03-11 10:00:00+01:00,183,24,159,17.172205393338412,174,21,153,15.22838843742414,15,1017,0.0,21
2020-03-11 11:00:00+01:00,225,26,199,24.523176463388204,214,26,188,24.48806340301503,15,1017,0.0,21
2020-03-11 12:00:00+01:00,184,21,163,11.126916077945086,178,21,157,13.537284957794041,15,1017,0.0,21
2020-03-11 13:00:00+01:00,186,25,161,14.511740402245575,178,21,157,13.537284957794041,15,1017,0.0,21
2020-03-11 14:00:00+01:00,186,25,161,14.511740402245575,178,21,157,13.537284957794041,15,1017,0.0,21
2020-03-11 15:00:00+01:00,203,27,176,21.5050173548228,184,20,164,11.126916077945086,15,1017,0.0,21
2020-03-11 16:00:00+01:00,224,29,195,23.328062540910114,214,26,188,24.48806340301503,15,1017,0.0,21
2020-03-11 17:00:00+01:00,315,36,279,19.612228121399696,296,30,266,17.230558324905093,15,1017,0.0,21
2020-03-11 18:00:00+01:00,332,39,293,19.089795695646295,338,43,295,25.380150029874855,15,1017,0.0,21
2020-03-11 19:00:00+01:00,239,27,212,23.923723620231325,218,23,195,22.73300845004657,15,1017,0.0,21
2020-03-11 20:00:00+01:00,239,32,207,23.923723620231325,218,23,195,22.73300845004657,15,1017,0.0,21
2020-03-11 21:00:00+01:00,183,24,159,17.172205393338412,174,21,153,15.22838843742414,15,1017,0.0,21
2020-03-11 22:00:00+01:00,131,15,116,20.374527680152948,115,13,102,14.389080564214039,15,1017,0.0,21
2020-03-11 23:00:00+01:00,90,10,80,18.392649197374546,89,10,79,16.127888447212325,15,1017,0.0,21
2020-03-12 00:00:00+01:00,32,2,30,5.041092888653022,38,6,32,11.101073107969722,11,1016,0.0,24
2020-03-12 01:00:00+01:00,23,2,21,0.4122417358964417,25,3,22,1.1875344360364632,11,1016,0.0,24
2020-03-12 02:00:00+01:00,25,2,23,1.1875344360364632,25,3,22,1.1875344360364632,11,1016,0.0,24
2020-03-12 03:00:00+01:00,37,3,34,2.066086063070793,38,5,33,11.101073107969722,11,1016,0.0,24
2020-03-12 04:00:00+01:00,59,5,54,10.572210467564378,58,7,51,10.505136369992313,11,1016,0.0,24
2020-03-12 05:00:00+01:00,106,9,97,12.94750706735717,114,18,96,18.09348958441383,11,1016,0.0,24
2020-03-12 06:00:00+01:00,124,11,113,17.53992981591413,129,19,110,17.995114557081255,11,1016,0.0,24
2020-03-12 07:00:00+01:00,195,14,181,23.83440770251287,216,27,189,21.273439412003903,11,1016,0.0,24
2020-03-12 08:00:00+01:00,212,19,193,18.597605283865732,231,33,198,16.702836426900134,11,1016,0.0,24
2020-03-12 09:00:00+01:00,140,10,130,15.331768592489755,140,20,120,15.331768592489755,11,1016,0.0,24
2020-03-12 10:00:00+01:00,109,9,100,14.645038576883659,117,15,102,21.891304075969387,11,1016,0.0,24
2020-03-12 11:00:00+01:00,150,12,138,17.939622434692456,153,18,135,14.915022999208679,11,1016,0.0,24
2020-03-12 12:00:00+01:00,115,8,107,27.52702584121565,121,19,102,20.317620945183666,11,1016,0.0,24
2020-03-12 13:00:00+01:00,122,9,113,20.245567873519157,128,19,109,19.601953989978306,11,1016,0.0,24
2020-03-12 14:00:00+01:00,114,8,106,18.09348958441383,121,19,102,20.317620945183666,11,1016,0.0,24
2020-03-12 15:00:00+01:00,134,10,124,14.701306049248211,135,21,114,21.280002906629502,11,1016,0.0,24
2020-03-12 16:00:00+01:00,149,11,138,20.003285796587473,153,18,135,14.915022999208679,11,1016,0.0,24
2020-03-12 17:00:00+01:00,196,15,181,20.04912381427717,216,27,189,21.273439412003903,11,1016,0.0,24
2020-03-12 18:00:00+01:00,212,19,193,18.597605283865732,231,33,198,16.702836426900134,11,1016,0.0,24
2020-03-12 19:00:00+01:00,152,11,141,20.188330220444417,162,21,141,19.08849102929865,11,1016,0.0,24
2020-03-12 20:00:00+01:00,165,13,152,20.56038540292619,160,24,136,19.89239402952506,11,1016,0.0,24
2020-03-12 21:00:00+01:00,127,10,117,19.116953333289125,117,15,102,21.891304075969387,11,1016,0.0,24
2020-03-12 22:00:00+01:00,87,7,80,17.896548892855574,85,10,75,19.289671453475872,11,1016,0.0,24
2020-03-12 23:00:00+01:00,56,4,52,10.152150256689218,64,8,56,14.414592943793718,11,1016,0.0,24
2020-03-13 00:00:00+01:00,38,3,35,11.101073107969722,38,4,34,11.101073107969722,9,1020,0.1,21
2020-03-13 01:00:00+01:00,25,2,23,1.1875344360364632,25,2,23,1.1875344360364632,9,1020,0.1,21
2020-03-13 02:00:00+01:00,25,2,23,1.1875344360364632,25,2,23,1.1875344360364632,9,1020,0.1,21
2020-03-13 03:00:00+01:00,37,3,34,2.066086063070793,38,4,34,11.101073107969722,9,1020,0.1,21
2020-03-13 04:00:00+01:00,63,6,57,14.929801273937542,58,5,53,10.505136369992313,9,1020,0.1,21
2020-03-13 05:00:00+01:00,113,12,101,20.093188266697116,113,11,102,20.093188266697116,9,1020,0.1,21
2020-03-13 06:00:00+01:00,140,13,127,15.331768592489755,129,13,116,17.995114557081255,9,1020,0.1,21
2020-03-13 07:00:00+01:00,210,19,191,16.3212742992447,212,18,194,18.597605283865732,9,1020,0.1,21
2020-03-13 08:00:00+01:00,228,23,205,15.818609956751573,211,19,192,18.759232281731908,9,1020,0.1,21
2020-03-13 09:00:00+01:00,147,14,133,20.208056467665056,153,13,140,14.915022999208679,9,1020,0.1,21
2020-03-13 10:00:00+01:00,124,11,113,17.53992981591413,117,12,105,21.891304075969387,9,1020,0.1,21
2020-03-13 11:00:00+01:00,153,15,138,14.915022999208679,148,13,135,18.058884943386857,9,1020,0.1,21
2020-03-13 12:00:00+01:00,129,13,116,17.995114557081255,123,10,113,19.074654696202938,9,1020,0.1,21
2020-03-13 13:00:00+01:00,124,12,112,17.53992981591413,117,12,105,21.891304075969387,9,1020,0.1,21
2020-03-13 14:00:00+01:00,128,12,116,19.601953989978306,123,10,113,19.074654696202938,9,1020,0.1,21
2020-03-13 15:00:00+01:00,136,14,122,16.594078125250377,138,14,124,20.21600799483387,9,1020,0.1,21
2020-03-13 16:00:00+01:00,145,14,131,18.85528596371164,154,15,139,23.457384968254527,9,1020,0.1,21
2020-03-13 17:00:00+01:00,207,22,185,21.877297854955202,202,19,183,22.500350864850866,9,1020,0.1,21
2020-03-13 18:00:00+01:00,218,21,197,22.57742359713229,227,25,202,19.269071808142694,9,1020,0.1,21
2020-03-13 19:00:00+01:00,158,15,143,21.67102174389251,159,15,144,17.78748005044877,9,1020,0.1,21
2020-03-13 20:00:00+01:00,160,14,146,19.89239402952506,159,13,146,17.78748005044877,9,1020,0.1,21
2020-03-13 21:00:00+01:00,123,11,112,19.074654696202938,123,12,111,19.074654696202938,9,1020,0.1,21
2020-03-13 22:00:00+01:00,86,8,78,21.204994436842384,85,7,78,19.289671453475872,9,1020,0.1,21
2020-03-13 23:00:00+01:00,61,6,55,12.362973378192347,58,5,53,10.505136369992313,9,1020,0.1,21
2020-03-14 00:00:00+01:00,90,6,84,10.477669283936715,92,5,87,9.485995969760566,9,1023,0.3,2
2020-03-14 01:00:00+01:00,58,3,55,11.561797090249616,61,3,58,13.45123014142322,9,1023,0.3,2
2020-03-14 02:00:00+01:00,58,3,55,11.561797090249616,61,3,58,13.45123014142322,9,1023,0.3,2
2020-03-14 03:00:00+01:00,87,5,82,9.504121716770046,95,4,91,10.506818941407664,9,1023,0.3,2
2020-03-14 04:00:00+01:00,117,7,110,13.539944397802945,126,7,119,13.391954395859463,9,1023,0.3,2
2020-03-14 05:00:00+01:00,151,10,141,19.14578123638998,158,7,151,19.40470350916573,9,1023,0.3,2
2020-03-14 06:00:00+01:00,251,14,237,17.440368481170164,256,16,240,19.922633354103812,9,1023,0.3,2
2020-03-14 07:00:00+01:00,368,24,344,19.848434815045938,383,20,363,21.26625994117601,9,1023,0.3,2
2020-03-14 08:00:00+01:00,495,30,465,17.429821470150856,514,34,480,17.757565512121285,9,1023,0.3,2
2020-03-14 09:00:00+01:00,534,30,504,10.719794673298331,541,27,514,18.81222066269775,9,1023,0.3,2
2020-03-14 10:00:00+01:00,456,29,427,20.030973704990842,483,26,457,16.739079897917865,9,1023,0.3,2
2020-03-14 11:00:00+01:00,366,23,343,16.269939741661524,385,21,364,18.20092151022271,9,1023,0.3,2
2020-03-14 12:00:00+01:00,375,24,351,21.145699806578275,378,24,354,21.49376685031853,9,1023,0.3,2
2020-03-14 13:00:00+01:00,400,25,375,18.964845929792475,410,27,383,17.249472070304,9,1023,0.3,2
2020-03-14 14:00:00+01:00,373,24,349,16.839124812955344,388,22,366,20.16254491947918,9,1023,0.3,2
2020-03-14 15:00:00+01:00,436,27,409,17.144177199139556,444,23,421,21.75090257606931,9,1023,0.3,2
2020-03-14 16:00:00+01:00,417,26,391,22.354466756658574,449,25,424,17.9741178967318,9,1023,0.3,2
2020-03-14 17:00:00+01:00,485,28,457,23.26524199136097,510,31,479,16.559257473278713,9,1023,0.3,2
2020-03-14 18:00:00+01:00,456,29,427,20.030973704990842,483,26,457,16.739079897917865,9,1023,0.3,2
2020-03-14 19:00:00+01:00,366,23,343,16.269939741661524,385,21,364,18.20092151022271,9,1023,0.3,2
2020-03-14 20:00:00+01:00,344,22,322,19.49330876116528,349,20,329,19.114918279434413,9,1023,0.3,2
2020-03-14 21:00:00+01:00,312,18,294,17.101813661047903,322,21,301,18.644637808692327,9,1023,0.3,2
2020-03-14 22:00:00+01:00,239,14,225,18.056937917326703,251,16,235,17.440368481170164,9,1023,0.3,2
2020-03-14 23:00:00+01:00,122,8,114,15.53082002471091,126,6,120,13.391954395859463,9,1023,0.3,2
2020-03-15 00:00:00+01:00,36,1,35,2.727177547566476,53,2,51,12.671576687621188,11,1018,0.3,10
2020-03-15 01:00:00+01:00,25,0,25,0.10677168789919293,35,1,34,5.369702870779087,11,1018,0.3,10
2020-03-15 02:00:00+01:00,24,0,24,0.16633697306049489,31,1,30,0.3699528216625179,11,1018,0.3,10
2020-03-15 03:00:00+01:00,38,1,37,5.960450042509954,51,2,49,13.024781207847502,11,1018,0.3,10
2020-03-15 04:00:00+01:00,51,2,49,13.024781207847502,66,2,64,9.595877216947136,11,1018,0.3,10
2020-03-15 05:00:00+01:00,60,2,58,12.98342242386016,84,3,81,7.6306798135980785,11,1018,0.3,10
2020-03-15 06:00:00+01:00,108,3,105,15.795702759121413,118,5,113,16.65435568776215,11,1018,0.3,10
2020-03-15 07:00:00+01:00,162,6,156,18.435104799511247,188,7,181,19.664617237016223,11,1018,0.3,10
2020-03-15 08:00:00+01:00,204,7,197,20.27930898180519,280,10,270,18.26048171051442,11,1018,0.3,10
2020-03-15 09:00:00+01:00,219,8,211,18.74397758884313,223,8,215,18.802339292525456,11,1018,0.3,10
2020-03-15 10:00:00+01:00,195,8,187,16.39636374930337,206,7,199,20.90053052788098,11,1018,0.3,10
2020-03-15 11:00:00+01:00,151,6,145,19.14578123638998,182,5,177,16.329362148305133,11,1018,0.3,10
2020-03-15 12:00:00+01:00,151,5,146,19.14578123638998,182,5,177,16.329362148305133,11,1018,0.3,10
2020-03-15 13:00:00+01:00,164,6,158,18.874121315806054,225,8,217,16.518156382279376,11,1018,0.3,10
2020-03-15 14:00:00+01:00,164,7,157,18.874121315806054,208,7,201,18.807092053665322,11,1018,0.3,10
2020-03-15 15:00:00+01:00,184,7,177,19.759138180971462,219,7,212,18.74397758884313,11,1018,0.3,10
2020-03-15 16:00:00+01:00,171,6,165,17.45819407743446,241,9,232,17.853279648834448,11,1018,0.3,10
2020-03-15 17:00:00+01:00,197,7,190,19.118279085736297,225,8,217,16.518156382279376,11,1018,0.3,10
2020-03-15 18:00:00+01:00,204,8,196,20.27930898180519,262,10,252,13.900090096773878,11,1018,0.3,10
2020-03-15 19:00:00+01:00,153,5,148,18.67945251137068,156,5,151,17.899214712227696,11,1018,0.3,10
2020-03-15 20:00:00+01:00,142,6,136,19.57947604189084,197,7,190,19.118279085736297,11,1018,0.3,10
2020-03-15 21:00:00+01:00,125,5,120,11.899638158178501,155,6,149,18.708796369633056,11,1018,0.3,10
2020-03-15 22:00:00+01:00,97,3,94,12.91170780960746,123,4,119,13.78591137222831,11,1018,0.3,10
2020-03-15 23:00:00+01:00,48,1,47,9.964553643509852,68,2,66,8.84385076442631,11,1018,0.3,10
2020-03-16 00:00:00+01:00,115,12,103,27.52702584121565,112,14,98,14.898852003445265,13,1013,0.0,4
2020-03-16 01:00:00+01:00,70,6,64,13.53852946044019,76,7,69,16.686685835236233,13,1013,0.0,4
2020-03-16 02:00:00+01:00,73,7,66,16.592478063282112,76,8,68,16.686685835236233,13,1013,0.0,4
2020-03-16 03:00:00+01:00,109,11,98,14.645038576883659,109,11,98,14.645038576883659,13,1013,0.0,4
2020-03-16 04:00:00+01:00,177,16,161,20.028957588616944,194,21,173,21.593451125557873,13,1013,0.0,4
2020-03-16 05:00:00+01:00,348,32,316,20.566317862558048,336,37,299,23.28683107716768,13,1013,0.0,4
2020-03-16 06:00:00+01:00,422,42,380,20.257299015157166,410,51,359,20.532450928302634,13,1013,0.0,4
2020-03-16 07:00:00+01:00,619,67,552,21.130188595205187,649,73,576,15.80047652296909,13,1013,0.0,4
2020-03-16 08:00:00+01:00,643,62,581,17.945088215014433,670,81,589,16.908196156468264,13,1013,0.0,4
2020-03-16 09:00:00+01:00,439,42,397,18.965638166337634,442,42,400,20.352399635415985,13,1013,0.0,4
2020-03-16 10:00:00+01:00,368,34,334,19.722641588533307,371,41,330,20.767700865402965,13,1013,0.0,4
2020-03-16 11:00:00+01:00,442,42,400,20.352399635415985,448,44,404,23.047509824765182,13,1013,0.0,4
2020-03-16 12:00:00+01:00,366,36,330,21.40807985369936,374,47,327,18.17629135420491,13,1013,0.0,4
2020-03-16 13:00:00+01:00,374,35,339,18.17629135420491,377,39,338,16.83689607567409,13,1013,0.0,4
2020-03-16 14:00:00+01:00,389,37,352,21.37920911023894,371,36,335,20.767700865402965,13,1013,0.0,4
2020-03-16 15:00:00+01:00,404,38,366,21.094548442403457,425,41,384,20.977086023346995,13,1013,0.0,4
2020-03-16 16:00:00+01:00,451,44,407,20.489203978314702,460,48,412,18.198266997149677,13,1013,0.0,4
2020-03-16 17:00:00+01:00,616,62,554,22.224127738373518,634,80,554,19.8752934212295,13,1013,0.0,4
2020-03-16 18:00:00+01:00,646,58,588,22.66748986971251,667,75,592,22.082918216313388,13,1013,0.0,4
2020-03-16 19:00:00+01:00,481,45,436,25.78446993067148,507,56,451,20.732028813124888,13,1013,0.0,4
2020-03-16 20:00:00+01:00,466,46,420,20.265872741633896,510,60,450,19.94640789038923,13,1013,0.0,4
2020-03-16 21:00:00+01:00,360,35,325,23.455775768432638,389,48,341,21.37920911023894,13,1013,0.0,4
2020-03-16 22:00:00+01:00,256,23,233,20.451990100158973,265,26,239,24.143057918667047,13,1013,0.0,4
2020-03-16 23:00:00+01:00,185,17,168,20.160625004949942,185,18,167,20.160625004949942,13,1013,0.0,4
2020-03-17 00:00:00+01:00,83,7,76,18.699193296190067,93,9,84,12.914854269394333,12,1027,0.2,6
2020-03-17 01:00:00+01:00,61,5,56,12.362973378192347,61,5,56,12.362973378192347,12,1027,0.2,6
2020-03-17 02:00:00+01:00,54,4,50,10.37826089518735,63,7,56,14.929801273937542,12,1027,0.2,6
2020-03-17 03:00:00+01:00,81,7,74,16.076626545182606,95,9,86,11.735389228725284,12,1027,0.2,6
2020-03-17 04:00:00+01:00,142,12,130,21.623487252479663,167,16,151,21.39117903937357,12,1027,0.2,6
2020-03-17 05:00:00+01:00,263,23,240,18.706444640225143,300,33,267,19.621479548992166,12,1027,0.2,6
2020-03-17 06:00:00+01:00,307,27,280,19.62844127124222,344,37,307,17.416933285982235,12,1027,0.2,6
2020-03-17 07:00:00+01:00,506,50,456,18.537819376216163,526,52,474,21.343558174072673,12,1027,0.2,6
2020-03-17 08:00:00+01:00,514,49,465,17.018673574730677,580,60,520,24.24750544028644,12,1027,0.2,6
2020-03-17 09:00:00+01:00,378,32,346,19.765573549462566,391,35,356,20.019115852021912,12,1027,0.2,6
2020-03-17 10:00:00+01:00,285,24,261,23.62629721954127,337,36,301,21.494538760895587,12,1027,0.2,6
2020-03-17 11:00:00+01:00,366,31,335,21.40807985369936,386,44,342,18.304254687443294,12,1027,0.2,6
2020-03-17 12:00:00+01:00,305,27,278,19.342371998402466,314,28,286,19.381500590217087,12,1027,0.2,6
2020-03-17 13:00:00+01:00,290,24,266,18.088844908617002,322,34,288,22.976009334024873,12,1027,0.2,6
2020-03-17 14:00:00+01:00,309,30,279,17.68578168988432,322,30,292,22.976009334024873,12,1027,0.2,6
2020-03-17 15:00:00+01:00,341,33,308,14.480776847696712,364,31,333,19.12804198058144,12,1027,0.2,6
2020-03-17 16:00:00+01:00,349,34,315,16.300891984453436,393,35,358,19.01393712330975,12,1027,0.2,6
2020-03-17 17:00:00+01:00,484,44,440,17.863314460235074,565,51,514,17.51797887308028,12,1027,0.2,6
2020-03-17 18:00:00+01:00,553,48,505,21.584774386830425,600,61,539,21.27832637503799,12,1027,0.2,6
2020-03-17 19:00:00+01:00,408,38,370,21.369431512154076,408,46,362,21.369431512154076,12,1027,0.2,6
2020-03-17 20:00:00+01:00,369,36,333,22.180217499440115,408,40,368,21.369431512154076,12,1027,0.2,6
2020-03-17 21:00:00+01:00,282,28,254,14.328617212432716,327,37,290,17.492932564197055,12,1027,0.2,6
2020-03-17 22:00:00+01:00,218,21,197,22.57742359713229,231,25,206,16.702836426900134,12,1027,0.2,6
2020-03-17 23:00:00+01:00,147,12,135,20.208056467665056,164,14,150,22.827361263214527,12,1027,0.2,6
2020-03-18 00:00:00+01:00,120,13,107,10.291257377501918,117,14,103,12.235552510813584,15,1029,0.0,4
2020-03-18 01:00:00+01:00,79,9,70,16.621554061874914,76,9,67,20.954075500954353,15,1029,0.0,4
2020-03-18 02:00:00+01:00,79,9,70,16.621554061874914,76,9,67,20.954075500954353,15,1029,0.0,4
2020-03-18 03:00:00+01:00,117,14,103,12.235552510813584,108,11,97,15.542504625013809,15,1029,0.0,4
2020-03-18 04:00:00+01:00,200,24,176,20.806596333484702,197,23,174,16.840472953316162,15,1029,0.0,4
2020-03-18 05:00:00+01:00,362,43,319,17.53978372490806,362,41,321,17.53978372490806,15,1029,0.0,4
2020-03-18 06:00:00+01:00,448,57,391,20.768496400108308,409,49,360,24.581033645594804,15,1029,0.0,4
2020-03-18 07:00:00+01:00,676,92,584,23.647869444147233,673,67,606,20.667884097429337,15,1029,0.0,4
2020-03-18 08:00:00+01:00,721,85,636,20.67364023861516,680,80,600,20.454350179476304,15,1029,0.0,4
2020-03-18 09:00:00+01:00,483,65,418,21.086662647611625,489,58,431,20.979024543119948,15,1029,0.0,4
2020-03-18 10:00:00+01:00,403,49,354,13.914029524281172,378,40,338,19.72856450330425,15,1029,0.0,4
2020-03-18 11:00:00+01:00,479,57,422,11.814570973379602,451,49,402,15.27543247912955,15,1029,0.0,4
2020-03-18 12:00:00+01:00,409,54,355,24.581033645594804,362,45,317,17.53978372490806,15,1029,0.0,4
2020-03-18 13:00:00+01:00,406,52,354,23.347397986470767,371,42,329,19.26013813327,15,1029,0.0,4
2020-03-18 14:00:00+01:00,400,54,346,24.218092797619367,378,40,338,19.72856450330425,15,1029,0.0,4
2020-03-18 15:00:00+01:00,438,52,386,16.348655609858998,400,43,357,24.218092797619367,15,1029,0.0,4
2020-03-18 16:00:00+01:00,483,58,425,21.086662647611625,489,58,431,20.979024543119948,15,1029,0.0,4
2020-03-18 17:00:00+01:00,683,83,600,22.67814750416712,629,74,555,19.088893736997306,15,1029,0.0,4
2020-03-18 18:00:00+01:00,721,89,632,20.67364023861516,680,80,600,20.454350179476304,15,1029,0.0,4
2020-03-18 19:00:00+01:00,524,71,453,20.560147412005747,518,51,467,19.12914003399451,15,1029,0.0,4
2020-03-18 20:00:00+01:00,530,62,468,19.083977996999057,479,57,422,11.814570973379602,15,1029,0.0,4
2020-03-18 21:00:00+01:00,400,49,351,24.218092797619367,378,40,338,19.72856450330425,15,1029,0.0,4
2020-03-18 22:00:00+01:00,279,33,246,20.78305114330562,270,26,244,21.935045846470036,15,1029,0.0,4
2020-03-18 23:00:00+01:00,203,25,178,21.5050173548228,181,20,161,22.79969312673797,15,1029,0.0,4
2020-03-19 00:00:00+01:00,101,9,92,11.280950715811313,110,16,94,16.975871844207738,16,1026,0.2,5
2020-03-19 01:00:00+01:00,62,5,57,14.48690450543278,68,9,59,14.701855472363336,16,1026,0.2,5
2020-03-19 02:00:00+01:00,74,6,68,19.513800836509724,74,10,64,19.513800836509724,16,1026,0.2,5
2020-03-19 03:00:00+01:00,107,9,98,12.156196464705383,107,17,90,12.156196464705383,16,1026,0.2,5
2020-03-19 04:00:00+01:00,166,15,151,18.57114730689396,190,29,161,20.51689583562818,16,1026,0.2,5
2020-03-19 05:00:00+01:00,336,26,310,23.28683107716768,336,48,288,23.28683107716768,16,1026,0.2,5
2020-03-19 06:00:00+01:00,411,33,378,21.89950881174465,390,63,327,23.204029211730827,16,1026,0.2,5
2020-03-19 07:00:00+01:00,572,51,521,22.464428218647974,616,97,519,22.224127738373518,16,1026,0.2,5
2020-03-19 08:00:00+01:00,599,54,545,22.66737383874895,658,81,577,21.97385875439763,16,1026,0.2,5
2020-03-19 09:00:00+01:00,438,38,400,22.221490993016946,417,51,366,23.51661645113794,16,1026,0.2,5
2020-03-19 10:00:00+01:00,366,27,339,21.40807985369936,363,59,304,20.037936765942277,16,1026,0.2,5
2020-03-19 11:00:00+01:00,408,37,371,21.369431512154076,426,69,357,20.8097346735364,16,1026,0.2,5
2020-03-19 12:00:00+01:00,330,28,302,16.43301680059058,357,47,310,21.912097396672888,16,1026,0.2,5
2020-03-19 13:00:00+01:00,366,28,338,21.40807985369936,363,59,304,20.037936765942277,16,1026,0.2,5
2020-03-19 14:00:00+01:00,339,30,309,21.378284288972047,375,45,330,22.64494297948435,16,1026,0.2,5
2020-03-19 15:00:00+01:00,375,29,346,22.64494297948435,402,53,349,17.230856788696144,16,1026,0.2,5
2020-03-19 16:00:00+01:00,405,35,370,18.172278090342537,423,68,355,23.290663678046883,16,1026,0.2,5
2020-03-19 17:00:00+01:00,587,53,534,20.028899672241884,637,93,544,20.615078570692955,16,1026,0.2,5
2020-03-19 18:00:00+01:00,616,55,561,22.224127738373518,643,104,539,17.945088215014433,16,1026,0.2,5
2020-03-19 19:00:00+01:00,432,38,394,18.473076954520703,458,64,394,24.591159780297854,16,1026,0.2,5
2020-03-19 20:00:00+01:00,464,41,423,21.884111394069308,461,57,404,24.16987876504356,16,1026,0.2,5
2020-03-19 21:00:00+01:00,369,27,342,22.180217499440115,357,51,306,21.912097396672888,16,1026,0.2,5
2020-03-19 22:00:00+01:00,256,20,236,20.451990100158973,262,33,229,18.255168653975332,16,1026,0.2,5
2020-03-19 23:00:00+01:00,190,17,173,20.51689583562818,181,24,157,20.051163259817507,16,1026,0.2,5
2020-03-20 00:00:00+01:00,91,8,83,13.154481673544206,88,7,81,17.756927742208592,13,1022,0.0,9
2020-03-20 01:00:00+01:00,61,6,55,12.362973378192347,56,5,51,10.152150256689218,13,1022,0.0,9
2020-03-20 02:00:00+01:00,61,5,56,12.362973378192347,56,5,51,10.152150256689218,13,1022,0.0,9
2020-03-20 03:00:00+01:00,93,9,84,12.914854269394333,86,7,79,21.204994436842384,13,1022,0.0,9
2020-03-20 04:00:00+01:00,150,13,137,17.939622434692456,155,13,142,19.469409355748308,13,1022,0.0,9
2020-03-20 05:00:00+01:00,268,29,239,16.114987230113258,268,24,244,16.114987230113258,13,1022,0.0,9
2020-03-20 06:00:00+01:00,332,31,301,21.454526645627976,329,30,299,19.339935066365534,13,1022,0.0,9
2020-03-20 07:00:00+01:00,524,52,472,19.821110984782088,511,56,455,22.27774281923901,13,1022,0.0,9
2020-03-20 08:00:00+01:00,568,51,517,20.442364330592024,546,58,488,20.84279480803274,13,1022,0.0,9
2020-03-20 09:00:00+01:00,376,34,342,15.920759199358614,366,32,334,21.40807985369936,13,1022,0.0,9
2020-03-20 10:00:00+01:00,302,33,269,17.71336274061634,290,29,261,18.088844908617002,13,1022,0.0,9
2020-03-20 11:00:00+01:00,364,38,326,19.12804198058144,361,41,320,19.1870055662437,13,1022,0.0,9
2020-03-20 12:00:00+01:00,314,34,280,19.381500590217087,300,26,274,19.621479548992166,13,1022,0.0,9
2020-03-20 13:00:00+01:00,297,29,268,18.348417493587977,292,25,267,18.509650933155072,13,1022,0.0,9
2020-03-20 14:00:00+01:00,297,31,266,18.348417493587977,292,25,267,18.509650933155072,13,1022,0.0,9
2020-03-20 15:00:00+01:00,327,34,293,17.492932564197055,327,29,298,17.492932564197055,13,1022,0.0,9
2020-03-20 16:00:00+01:00,378,41,337,19.765573549462566,366,32,334,21.40807985369936,13,1022,0.0,9
2020-03-20 17:00:00+01:00,516,56,460,23.45871840478751,489,47,442,13.901530333723658,13,1022,0.0,9
2020-03-20 18:00:00+01:00,556,56,500,17.490996909750756,551,54,497,23.574220809021288,13,1022,0.0,9
2020-03-20 19:00:00+01:00,391,37,354,20.019115852021912,383,34,349,23.132924781238575,13,1022,0.0,9
2020-03-20 20:00:00+01:00,406,44,362,17.471736216533994,378,35,343,19.765573549462566,13,1022,0.0,9
2020-03-20 21:00:00+01:00,305,28,277,19.342371998402466,295,26,269,20.557446011766526,13,1022,0.0,9
2020-03-20 22:00:00+01:00,209,19,190,22.16757043059366,211,18,193,18.759232281731908,13,1022,0.0,9
2020-03-20 23:00:00+01:00,150,15,135,17.939622434692456,155,13,142,19.469409355748308,13,1022,0.0,9
2020-03-21 00:00:00+01:00,36,2,34,2.727177547566476,39,2,37,6.913338666308079,8,1022,0.0,20
2020-03-21 01:00:00+01:00,24,1,23,0.16633697306049489,26,1,25,0.13434729751860394,8,1022,0.0,20
2020-03-21 02:00:00+01:00,25,1,24,0.10677168789919293,26,1,25,0.13434729751860394,8,1022,0.0,20
2020-03-21 03:00:00+01:00,38,2,36,5.960450042509954,39,2,37,6.913338666308079,8,1022,0.0,20
2020-03-21 04:00:00+01:00,48,3,45,9.964553643509852,52,2,50,14.472017643602554,8,1022,0.0,20
2020-03-21 05:00:00+01:00,62,4,58,14.019247608895405,65,4,61,10.13470849860639,8,1022,0.0,20
2020-03-21 06:00:00+01:00,101,6,95,14.022694861996197,105,6,99,16.343560716114418,8,1022,0.0,20
2020-03-21 07:00:00+01:00,147,9,138,16.306492316544293,159,10,149,19.89258263570152,8,1022,0.0,20
2020-03-21 08:00:00+01:00,206,11,195,20.90053052788098,208,12,196,18.807092053665322,8,1022,0.0,20
2020-03-21 09:00:00+01:00,213,14,199,20.238518600536185,223,14,209,18.802339292525456,8,1022,0.0,20
2020-03-21 10:00:00+01:00,187,12,175,15.611538170802525,198,12,186,20.173795644408123,8,1022,0.0,20
2020-03-21 11:00:00+01:00,152,10,142,18.686880121910534,155,8,147,18.708796369633056,8,1022,0.0,20
2020-03-21 12:00:00+01:00,145,8,137,19.922746131926434,158,8,150,19.40470350916573,8,1022,0.0,20
2020-03-21 13:00:00+01:00,167,9,158,19.047083059371815,172,10,162,18.863206387348974,8,1022,0.0,20
2020-03-21 14:00:00+01:00,154,8,146,19.868163821621103,155,8,147,18.708796369633056,8,1022,0.0,20
2020-03-21 15:00:00+01:00,169,9,160,20.526675282456768,185,10,175,20.88033942284811,8,1022,0.0,20
2020-03-21 16:00:00+01:00,172,10,162,18.863206387348974,186,9,177,20.400698976924794,8,1022,0.0,20
2020-03-21 17:00:00+01:00,199,12,187,19.11274068140836,209,10,199,16.60419034744366,8,1022,0.0,20
2020-03-21 18:00:00+01:00,190,11,179,20.182913119811044,197,10,187,19.118279085736297,8,1022,0.0,20
2020-03-21 19:00:00+01:00,146,9,137,19.4340926707284,157,8,149,19.700921436065542,8,1022,0.0,20
2020-03-21 20:00:00+01:00,142,8,134,19.57947604189084,146,8,138,19.4340926707284,8,1022,0.0,20
2020-03-21 21:00:00+01:00,124,7,117,14.467255533674502,129,7,122,12.81298343964759,8,1022,0.0,20
2020-03-21 22:00:00+01:00,100,6,94,12.129363492765288,105,7,98,16.343560716114418,8,1022,0.0,20
2020-03-21 23:00:00+01:00,49,3,46,12.126419816698254,52,2,50,14.472017643602554,8,1022,0.0,20
2020-03-22 00:00:00+01:00,21,0,21,0.0727095127790566,25,0,25,0.10677168789919293,7,1020,0.0,22
2020-03-22 01:00:00+01:00,14,0,14,0.0,18,0,18,0.014449312499738909,7,1020,0.0,22
2020-03-22 02:00:00+01:00,13,0,13,0.0,18,0,18,0.014449312499738909,7,1020,0.0,22
2020-03-22 03:00:00+01:00,20,0,20,0.04910283862897408,25,0,25,0.10677168789919293,7,1020,0.0,22
2020-03-22 04:00:00+01:00,29,1,28,0.5419439371488394,36,1,35,2.727177547566476,7,1020,0.0,22
2020-03-22 05:00:00+01:00,36,1,35,2.727177547566476,48,1,47,9.964553643509852,7,1020,0.0,22
2020-03-22 06:00:00+01:00,57,2,55,11.247345675463038,74,3,71,9.886934519670994,7,1020,0.0,22
2020-03-22 07:00:00+01:00,87,3,84,9.504121716770046,119,3,116,9.275729661817119,7,1020,0.0,22
2020-03-22 08:00:00+01:00,110,4,106,20.964248322238312,128,4,124,16.268122259148125,7,1020,0.0,22
2020-03-22 09:00:00+01:00,118,4,114,16.65435568776215,166,6,160,16.094287115128708,7,1020,0.0,22
2020-03-22 10:00:00+01:00,106,4,102,19.560878716092326,149,5,144,17.937448228249327,7,1020,0.0,22
2020-03-22 11:00:00+01:00,82,3,79,8.6962433625344,98,3,95,9.366341704429512,7,1020,0.0,22
2020-03-22 12:00:00+01:00,86,3,83,9.565861223121674,119,3,116,9.275729661817119,7,1020,0.0,22
2020-03-22 13:00:00+01:00,89,3,86,10.527801976587284,98,4,94,9.366341704429512,7,1020,0.0,22
2020-03-22 14:00:00+01:00,86,3,83,9.565861223121674,119,3,116,9.275729661817119,7,1020,0.0,22
2020-03-22 15:00:00+01:00,96,4,92,10.792244903732447,127,4,123,18.022773693841014,7,1020,0.0,22
2020-03-22 16:00:00+01:00,97,4,93,12.91170780960746,118,4,114,16.65435568776215,7,1020,0.0,22
2020-03-22 17:00:00+01:00,117,4,113,13.539944397802945,135,5,130,20.27811899595658,7,1020,0.0,22
2020-03-22 18:00:00+01:00,109,4,105,18.214376818550008,139,5,134,19.408576933840735,7,1020,0.0,22
2020-03-22 19:00:00+01:00,89,3,86,10.527801976587284,90,3,87,10.477669283936715,7,1020,0.0,22
2020-03-22 20:00:00+01:00,74,3,71,9.886934519670994,107,4,103,12.742346635562697,7,1020,0.0,22
2020-03-22 21:00:00+01:00,73,2,71,10.015349835153332,86,3,83,9.565861223121674,7,1020,0.0,22
2020-03-22 22:00:00+01:00,59,2,57,11.512224289105106,74,3,71,9.886934519670994,7,1020,0.0,22
2020-03-22 23:00:00+01:00,29,1,28,0.5419439371488394,36,1,35,2.727177547566476,7,1020,0.0,22
2020-03-23 00:00:00+01:00,39,3,36,6.782457974710225,37,4,33,2.066086063070793,7,1025,0.0,21
2020-03-23 01:00:00+01:00,26,2,24,1.5382661455122164,26,2,24,1.5382661455122164,7,1025,0.0,21
2020-03-23 02:00:00+01:00,24,2,22,1.5004308879154395,26,2,24,1.5382661455122164,7,1025,0.0,21
2020-03-23 03:00:00+01:00,37,3,34,2.066086063070793,39,4,35,6.782457974710225,7,1025,0.0,21
2020-03-23 04:00:00+01:00,60,5,55,10.583722413773145,62,6,56,14.48690450543278,7,1025,0.0,21
2020-03-23 05:00:00+01:00,108,10,98,14.813734676069407,112,11,101,14.898852003445265,7,1025,0.0,21
2020-03-23 06:00:00+01:00,136,13,123,16.594078125250377,142,16,126,21.623487252479663,7,1025,0.0,21
2020-03-23 07:00:00+01:00,226,22,204,20.308697708911414,214,23,191,18.560318290748608,7,1025,0.0,21
2020-03-23 08:00:00+01:00,239,24,215,13.74553452780325,235,29,206,20.674840106170866,7,1025,0.0,21
2020-03-23 09:00:00+01:00,154,16,138,23.457384968254527,151,18,133,19.408157188048275,7,1025,0.0,21
2020-03-23 10:00:00+01:00,128,11,117,19.601953989978306,128,12,116,19.601953989978306,7,1025,0.0,21
2020-03-23 11:00:00+01:00,152,13,139,20.188330220444417,154,15,139,23.457384968254527,7,1025,0.0,21
2020-03-23 12:00:00+01:00,123,13,110,19.074654696202938,128,14,114,19.601953989978306,7,1025,0.0,21
2020-03-23 13:00:00+01:00,127,11,116,19.116953333289125,125,13,112,23.026828253397017,7,1025,0.0,21
2020-03-23 14:00:00+01:00,127,11,116,19.116953333289125,125,13,112,23.026828253397017,7,1025,0.0,21
2020-03-23 15:00:00+01:00,139,12,127,18.732486269107348,137,15,122,18.928795118329443,7,1025,0.0,21
2020-03-23 16:00:00+01:00,145,14,131,18.85528596371164,157,17,140,23.857880119976507,7,1025,0.0,21
2020-03-23 17:00:00+01:00,216,21,195,21.273439412003903,220,27,193,16.758079648934128,7,1025,0.0,21
2020-03-23 18:00:00+01:00,228,21,207,15.818609956751573,225,22,203,17.07968654570721,7,1025,0.0,21
2020-03-23 19:00:00+01:00,168,15,153,20.304807772345505,167,18,149,21.39117903937357,7,1025,0.0,21
2020-03-23 20:00:00+01:00,166,16,150,18.57114730689396,170,20,150,19.775542485132945,7,1025,0.0,21
2020-03-23 21:00:00+01:00,122,13,109,20.245567873519157,131,15,116,14.183230975852695,7,1025,0.0,21
2020-03-23 22:00:00+01:00,89,8,81,17.562315027840828,89,8,81,17.562315027840828,7,1025,0.0,21
2020-03-23 23:00:00+01:00,63,5,58,14.929801273937542,62,6,56,14.48690450543278,7,1025,0.0,21
2020-03-24 00:00:00+01:00,34,3,31,5.3950651883530085,41,4,37,8.457036189746331,8,1027,0.0,18
2020-03-24 01:00:00+01:00,25,2,23,1.1875344360364632,28,2,26,4.026144260024548,8,1027,0.0,18
2020-03-24 02:00:00+01:00,22,1,21,0.1277873501672996,27,2,25,1.9016023008994223,8,1027,0.0,18
2020-03-24 03:00:00+01:00,39,3,36,6.782457974710225,38,3,35,11.101073107969722,8,1027,0.0,18
2020-03-24 04:00:00+01:00,63,5,58,14.929801273937542,64,6,58,14.414592943793718,8,1027,0.0,18
2020-03-24 05:00:00+01:00,119,10,109,22.46945513312648,120,12,108,16.69246741071004,8,1027,0.0,18
2020-03-24 06:00:00+01:00,140,12,128,15.331768592489755,143,14,129,22.510370466296816,8,1027,0.0,18
2020-03-24 07:00:00+01:00,204,19,185,12.517560993101368,225,24,201,17.07968654570721,8,1027,0.0,18
2020-03-24 08:00:00+01:00,226,19,207,20.308697708911414,236,22,214,19.106111918840778,8,1027,0.0,18
2020-03-24 09:00:00+01:00,149,14,135,20.003285796587473,169,14,155,18.567569965901342,8,1027,0.0,18
2020-03-24 10:00:00+01:00,124,12,112,17.53992981591413,130,13,117,15.65660051079879,8,1027,0.0,18
2020-03-24 11:00:00+01:00,147,12,135,20.208056467665056,169,14,155,18.567569965901342,8,1027,0.0,18
2020-03-24 12:00:00+01:00,124,12,112,17.53992981591413,130,13,117,15.65660051079879,8,1027,0.0,18
2020-03-24 13:00:00+01:00,123,10,113,19.074654696202938,136,14,122,16.594078125250377,8,1027,0.0,18
2020-03-24 14:00:00+01:00,125,11,114,23.026828253397017,136,12,124,16.594078125250377,8,1027,0.0,18
2020-03-24 15:00:00+01:00,138,12,126,20.21600799483387,143,14,129,22.510370466296816,8,1027,0.0,18
2020-03-24 16:00:00+01:00,144,13,131,22.91915418498221,160,17,143,19.89239402952506,8,1027,0.0,18
2020-03-24 17:00:00+01:00,208,17,191,17.851758798784658,234,20,214,19.754580108435302,8,1027,0.0,18
2020-03-24 18:00:00+01:00,214,19,195,18.560318290748608,255,25,230,21.41944964647189,8,1027,0.0,18
2020-03-24 19:00:00+01:00,164,13,151,22.827361263214527,172,16,156,19.644113972447897,8,1027,0.0,18
2020-03-24 20:00:00+01:00,161,15,146,19.983041252146048,168,15,153,20.304807772345505,8,1027,0.0,18
2020-03-24 21:00:00+01:00,123,11,112,19.074654696202938,136,14,122,16.594078125250377,8,1027,0.0,18
2020-03-24 22:00:00+01:00,87,8,79,17.896548892855574,94,8,86,13.172779715339633,8,1027,0.0,18
2020-03-24 23:00:00+01:00,59,5,54,10.572210467564378,64,6,58,14.414592943793718,8,1027,0.0,18
2020-03-25 00:00:00+01:00,47,5,42,8.22807275031754,45,5,40,6.873871357402149,8,1025,0.0,16
2020-03-25 01:00:00+01:00,30,3,27,7.677673936986196,29,3,26,5.84117267448801,8,1025,0.0,16
2020-03-25 02:00:00+01:00,30,4,26,7.677673936986196,29,3,26,5.84117267448801,8,1025,0.0,16
2020-03-25 03:00:00+01:00,47,6,41,8.22807275031754,45,5,40,6.873871357402149,8,1025,0.0,16
2020-03-25 04:00:00+01:00,77,9,68,18.339246781129614,76,7,69,20.954075500954353,8,1025,0.0,16
2020-03-25 05:00:00+01:00,139,17,122,21.474746575274906,132,16,116,19.805771941259717,8,1025,0.0,16
2020-03-25 06:00:00+01:00,169,20,149,17.772634846256242,153,15,138,18.89706115395996,8,1025,0.0,16
2020-03-25 07:00:00+01:00,263,35,228,19.43996347144361,241,24,217,22.882071172466965,8,1025,0.0,16
2020-03-25 08:00:00+01:00,279,34,245,20.78305114330562,270,26,244,21.935045846470036,8,1025,0.0,16
2020-03-25 09:00:00+01:00,190,23,167,19.462300258952972,174,16,158,15.22838843742414,8,1025,0.0,16
2020-03-25 10:00:00+01:00,159,18,141,27.11407498537424,152,14,138,20.701024990887795,8,1025,0.0,16
2020-03-25 11:00:00+01:00,186,24,162,14.511740402245575,181,21,160,22.79969312673797,8,1025,0.0,16
2020-03-25 12:00:00+01:00,155,20,135,20.64602175207135,157,18,139,20.944420246413923,8,1025,0.0,16
2020-03-25 13:00:00+01:00,157,17,140,20.944420246413923,152,14,138,20.701024990887795,8,1025,0.0,16
2020-03-25 14:00:00+01:00,154,20,134,25.102227050596255,159,18,141,27.11407498537424,8,1025,0.0,16
2020-03-25 15:00:00+01:00,173,19,154,18.207988535584114,175,17,158,17.379188401043834,8,1025,0.0,16
2020-03-25 16:00:00+01:00,190,22,168,19.462300258952972,174,16,158,15.22838843742414,8,1025,0.0,16
2020-03-25 17:00:00+01:00,270,31,239,21.935045846470036,267,29,238,19.019375644726225,8,1025,0.0,16
2020-03-25 18:00:00+01:00,279,33,246,20.78305114330562,270,26,244,21.935045846470036,8,1025,0.0,16
2020-03-25 19:00:00+01:00,206,25,181,26.316276075539704,184,20,164,11.126916077945086,8,1025,0.0,16
2020-03-25 20:00:00+01:00,204,26,178,18.97564860124531,205,25,180,18.29833304368066,8,1025,0.0,16
2020-03-25 21:00:00+01:00,158,21,137,20.016713756826867,148,14,134,16.32552078684666,8,1025,0.0,16
2020-03-25 22:00:00+01:00,110,13,97,14.109887773033899,98,10,88,18.03644044567539,8,1025,0.0,16
2020-03-25 23:00:00+01:00,79,9,70,16.621554061874914,75,9,66,16.06577410864815,8,1025,0.0,16
2020-03-26 00:00:00+01:00,38,3,35,11.101073107969722,39,5,34,6.782457974710225,7,1020,0.0,17
2020-03-26 01:00:00+01:00,21,1,20,0.10419094703715145,24,3,21,1.5004308879154395,7,1020,0.0,17
2020-03-26 02:00:00+01:00,24,1,23,1.5004308879154395,24,3,21,1.5004308879154395,7,1020,0.0,17
2020-03-26 03:00:00+01:00,36,2,34,3.0873599992209124,39,4,35,6.782457974710225,7,1020,0.0,17
2020-03-26 04:00:00+01:00,55,4,51,8.909875597117273,65,8,57,15.361527134905547,7,1020,0.0,17
2020-03-26 05:00:00+01:00,117,10,107,21.891304075969387,117,16,101,21.891304075969387,7,1020,0.0,17
2020-03-26 06:00:00+01:00,140,12,128,15.331768592489755,132,19,113,19.37004764296085,7,1020,0.0,17
2020-03-26 07:00:00+01:00,200,18,182,19.256012935412965,208,30,178,17.851758798784658,7,1020,0.0,17
2020-03-26 08:00:00+01:00,214,16,198,18.560318290748608,237,34,203,15.922060682410839,7,1020,0.0,17
2020-03-26 09:00:00+01:00,158,13,145,21.67102174389251,150,21,129,17.939622434692456,7,1020,0.0,17
2020-03-26 10:00:00+01:00,122,9,113,20.245567873519157,131,20,111,14.183230975852695,7,1020,0.0,17
2020-03-26 11:00:00+01:00,140,10,130,15.331768592489755,143,20,123,22.510370466296816,7,1020,0.0,17
2020-03-26 12:00:00+01:00,114,10,104,18.09348958441383,124,20,104,17.53992981591413,7,1020,0.0,17
2020-03-26 13:00:00+01:00,111,9,102,12.909820125967427,120,15,105,16.69246741071004,7,1020,0.0,17
2020-03-26 14:00:00+01:00,122,10,112,20.245567873519157,131,20,111,14.183230975852695,7,1020,0.0,17
2020-03-26 15:00:00+01:00,129,9,120,17.995114557081255,138,17,121,20.21600799483387,7,1020,0.0,17
2020-03-26 16:00:00+01:00,133,11,122,22.07413438879217,147,20,127,20.208056467665056,7,1020,0.0,17
2020-03-26 17:00:00+01:00,224,19,205,16.30248157536985,214,26,188,18.560318290748608,7,1020,0.0,17
2020-03-26 18:00:00+01:00,221,18,203,20.34114880306217,226,27,199,20.308697708911414,7,1020,0.0,17
2020-03-26 19:00:00+01:00,146,11,135,20.98788244482569,169,20,149,18.567569965901342,7,1020,0.0,17
2020-03-26 20:00:00+01:00,168,13,155,20.304807772345505,165,23,142,20.56038540292619,7,1020,0.0,17
2020-03-26 21:00:00+01:00,118,10,108,23.272574380346793,130,18,112,15.65660051079879,7,1020,0.0,17
2020-03-26 22:00:00+01:00,82,6,76,16.39179981762634,90,13,77,13.960700117154147,7,1020,0.0,17
2020-03-26 23:00:00+01:00,63,5,58,14.929801273937542,59,8,51,10.572210467564378,7,1020,0.0,17
2020-03-27 00:00:00+01:00,73,6,67,16.592478063282112,73,7,66,16.592478063282112,9,1020,0.0,10
2020-03-27 01:00:00+01:00,48,4,44,12.297077384196717,48,4,44,12.297077384196717,9,1020,0.0,10
2020-03-27 02:00:00+01:00,48,4,44,12.297077384196717,48,4,44,12.297077384196717,9,1020,0.0,10
2020-03-27 03:00:00+01:00,73,6,67,16.592478063282112,73,7,66,16.592478063282112,9,1020,0.0,10
2020-03-27 04:00:00+01:00,122,12,110,20.245567873519157,124,13,111,17.53992981591413,9,1020,0.0,10
2020-03-27 05:00:00+01:00,211,22,189,18.759232281731908,211,21,190,18.759232281731908,9,1020,0.0,10
2020-03-27 06:00:00+01:00,261,26,235,21.270868579361668,257,27,230,24.369710124951805,9,1020,0.0,10
2020-03-27 07:00:00+01:00,412,37,375,21.450154879298072,389,38,351,21.37920911023894,9,1020,0.0,10
2020-03-27 08:00:00+01:00,426,39,387,20.8097346735364,414,42,372,21.211929621647883,9,1020,0.0,10
2020-03-27 09:00:00+01:00,296,30,266,20.454116986907042,294,29,265,18.98421464015195,9,1020,0.0,10
2020-03-27 10:00:00+01:00,240,23,217,16.023164601360044,236,23,213,19.106111918840778,9,1020,0.0,10
2020-03-27 11:00:00+01:00,288,30,258,22.858888837585067,275,25,250,24.67224255888931,9,1020,0.0,10
2020-03-27 12:00:00+01:00,240,26,214,16.023164601360044,236,23,213,19.106111918840778,9,1020,0.0,10
2020-03-27 13:00:00+01:00,240,25,215,16.023164601360044,236,23,213,19.106111918840778,9,1020,0.0,10
2020-03-27 14:00:00+01:00,240,25,215,16.023164601360044,236,23,213,19.106111918840778,9,1020,0.0,10
2020-03-27 15:00:00+01:00,265,28,237,24.143057918667047,259,24,235,22.988395045636892,9,1020,0.0,10
2020-03-27 16:00:00+01:00,282,26,256,14.328617212432716,288,32,256,22.858888837585067,9,1020,0.0,10
2020-03-27 17:00:00+01:00,418,38,380,19.740254716385955,410,46,364,20.532450928302634,9,1020,0.0,10
2020-03-27 18:00:00+01:00,426,46,380,20.8097346735364,414,42,372,21.211929621647883,9,1020,0.0,10
2020-03-27 19:00:00+01:00,321,33,288,23.480156167605287,321,35,286,23.480156167605287,9,1020,0.0,10
2020-03-27 20:00:00+01:00,321,34,287,23.480156167605287,321,35,286,23.480156167605287,9,1020,0.0,10
2020-03-27 21:00:00+01:00,248,26,222,17.312704307039937,236,25,211,19.106111918840778,9,1020,0.0,10
2020-03-27 22:00:00+01:00,168,17,151,20.304807772345505,166,16,150,18.57114730689396,9,1020,0.0,10
2020-03-27 23:00:00+01:00,122,12,110,20.245567873519157,124,13,111,17.53992981591413,9,1020,0.0,10
2020-03-28 00:00:00+01:00,91,5,86,8.844154374326946,99,5,94,10.313624634117142,12,1019,0.0,7
2020-03-28 01:00:00+01:00,63,4,59,11.83290839187245,63,3,60,11.83290839187245,12,1019,0.0,7
2020-03-28 02:00:00+01:00,61,3,58,13.45123014142322,63,3,60,11.83290839187245,12,1019,0.0,7
2020-03-28 03:00:00+01:00,91,5,86,8.844154374326946,99,5,94,10.313624634117142,12,1019,0.0,7
2020-03-28 04:00:00+01:00,127,8,119,18.022773693841014,132,8,124,15.82621260035259,12,1019,0.0,7
2020-03-28 05:00:00+01:00,155,10,145,18.708796369633056,163,8,155,16.305265165047643,12,1019,0.0,7
2020-03-28 06:00:00+01:00,262,15,247,13.900090096773878,265,14,251,17.981103781954623,12,1019,0.0,7
2020-03-28 07:00:00+01:00,382,21,361,19.156893019800307,405,25,380,16.41142237268212,12,1019,0.0,7
2020-03-28 08:00:00+01:00,520,33,487,16.742850474175178,543,27,516,21.26508543455116,12,1019,0.0,7
2020-03-28 09:00:00+01:00,551,33,518,17.61916856629276,564,31,533,21.848445480580413,12,1019,0.0,7
2020-03-28 10:00:00+01:00,490,29,461,25.075248566874926,500,31,469,17.53149172402289,12,1019,0.0,7
2020-03-28 11:00:00+01:00,393,25,368,17.925669706725596,398,24,374,15.189044379634549,12,1019,0.0,7
2020-03-28 12:00:00+01:00,390,22,368,22.823808870670177,398,23,375,15.189044379634549,12,1019,0.0,7
2020-03-28 13:00:00+01:00,421,24,397,23.577567366465193,431,22,409,19.594917580038825,12,1019,0.0,7
2020-03-28 14:00:00+01:00,370,25,345,20.080410304897075,398,21,377,15.189044379634549,12,1019,0.0,7
2020-03-28 15:00:00+01:00,454,26,428,17.559907338692536,472,29,443,15.966412489673269,12,1019,0.0,7
2020-03-28 16:00:00+01:00,454,29,425,17.559907338692536,472,29,443,15.966412489673269,12,1019,0.0,7
2020-03-28 17:00:00+01:00,518,33,485,17.06195195164026,530,33,497,19.266675842235646,12,1019,0.0,7
2020-03-28 18:00:00+01:00,482,28,454,21.554128287623442,502,30,472,16.39928567380866,12,1019,0.0,7
2020-03-28 19:00:00+01:00,393,25,368,17.925669706725596,398,24,374,15.189044379634549,12,1019,0.0,7
2020-03-28 20:00:00+01:00,357,20,337,16.579219218063535,370,20,350,20.080410304897075,12,1019,0.0,7
2020-03-28 21:00:00+01:00,316,18,298,17.068110656006358,336,21,315,15.374523455613796,12,1019,0.0,7
2020-03-28 22:00:00+01:00,257,14,243,18.99808160477331,270,15,255,18.31838596155419,12,1019,0.0,7
2020-03-28 23:00:00+01:00,125,7,118,11.899638158178501,132,8,124,15.82621260035259,12,1019,0.0,7
2020-03-29 00:00:00+01:00,20,0,20,0.04910283862897408,25,0,25,0.10677168789919293,6,1025,0.0,27
2020-03-29 01:00:00+01:00,14,0,14,0.0,18,0,18,0.014449312499738909,6,1025,0.0,27
2020-03-29 03:00:00+02:00,13,0,13,0.0,18,0,18,0.014449312499738909,6,1025,0.0,27
2020-03-29 03:00:00+02:00,20,0,20,0.04910283862897408,25,0,25,0.10677168789919293,6,1025,0.0,27
2020-03-29 04:00:00+02:00,29,1,28,0.5419439371488394,36,1,35,2.727177547566476,6,1025,0.0,27
2020-03-29 05:00:00+02:00,36,1,35,2.727177547566476,48,1,47,9.964553643509852,6,1025,0.0,27
2020-03-29 06:00:00+02:00,57,2,55,11.247345675463038,74,3,71,9.886934519670994,6,1025,0.0,27
2020-03-29 07:00:00+02:00,87,3,84,9.504121716770046,119,3,116,9.275729661817119,6,1025,0.0,27
2020-03-29 08:00:00+02:00,110,4,106,20.964248322238312,128,4,124,16.268122259148125,6,1025,0.0,27
2020-03-29 09:00:00+02:00,118,4,114,16.65435568776215,166,6,160,16.094287115128708,6,1025,0.0,27
2020-03-29 10:00:00+02:00,106,4,102,19.560878716092326,149,5,144,17.937448228249327,6,1025,0.0,27
2020-03-29 11:00:00+02:00,82,3,79,8.6962433625344,98,3,95,9.366341704429512,6,1025,0.0,27
2020-03-29 12:00:00+02:00,86,3,83,9.565861223121674,119,3,116,9.275729661817119,6,1025,0.0,27
2020-03-29 13:00:00+02:00,89,3,86,10.527801976587284,98,4,94,9.366341704429512,6,1025,0.0,27
2020-03-29 14:00:00+02:00,86,3,83,9.565861223121674,119,3,116,9.275729661817119,6,1025,0.0,27
2020-03-29 15:00:00+02:00,96,4,92,10.792244903732447,127,4,123,18.022773693841014,6,1025,0.0,27
2020-03-29 16:00:00+02:00,97,4,93,12.91170780960746,118,4,114,16.65435568776215,6,1025,0.0,27
2020-03-29 17:00:00+02:00,117,4,113,13.539944397802945,135,5,130,20.27811899595658,6,1025,0.0,27
2020-03-29 18:00:00+02:00,109,4,105,18.214376818550008,139,5,134,19.408576933840735,6,1025,0.0,27
2020-03-29 19:00:00+02:00,89,3,86,10.527801976587284,90,3,87,10.477669283936715,6,1025,0.0,27
2020-03-29 20:00:00+02:00,74,3,71,9.886934519670994,107,4,103,12.742346635562697,6,1025,0.0,27
2020-03-29 21:00:00+02:00,73,2,71,10.015349835153332,86,3,83,9.565861223121674,6,1025,0.0,27
2020-03-29 22:00:00+02:00,59,2,57,11.512224289105106,74,3,71,9.886934519670994,6,1025,0.0,27
2020-03-29 23:00:00+02:00,29,1,28,0.5419439371488394,36,1,35,2.727177547566476,6,1025,0.0,27
2020-03-30 00:00:00+02:00,39,3,36,6.782457974710225,37,4,33,2.066086063070793,5,1031,0.0,28
2020-03-30 01:00:00+02:00,26,2,24,1.5382661455122164,26,2,24,1.5382661455122164,5,1031,0.0,28
2020-03-30 02:00:00+02:00,24,2,22,1.5004308879154395,26,2,24,1.5382661455122164,5,1031,0.0,28
2020-03-30 03:00:00+02:00,37,3,34,2.066086063070793,39,4,35,6.782457974710225,5,1031,0.0,28
2020-03-30 04:00:00+02:00,60,5,55,10.583722413773145,62,6,56,14.48690450543278,5,1031,0.0,28
2020-03-30 05:00:00+02:00,108,10,98,14.813734676069407,112,11,101,14.898852003445265,5,1031,0.0,28
2020-03-30 06:00:00+02:00,136,13,123,16.594078125250377,142,16,126,21.623487252479663,5,1031,0.0,28
2020-03-30 07:00:00+02:00,226,22,204,20.308697708911414,214,23,191,18.560318290748608,5,1031,0.0,28
2020-03-30 08:00:00+02:00,239,24,215,13.74553452780325,235,29,206,20.674840106170866,5,1031,0.0,28
2020-03-30 09:00:00+02:00,154,16,138,23.457384968254527,151,18,133,19.408157188048275,5,1031,0.0,28
2020-03-30 10:00:00+02:00,128,11,117,19.601953989978306,128,12,116,19.601953989978306,5,1031,0.0,28
2020-03-30 11:00:00+02:00,152,13,139,20.188330220444417,154,15,139,23.457384968254527,5,1031,0.0,28
2020-03-30 12:00:00+02:00,123,13,110,19.074654696202938,128,14,114,19.601953989978306,5,1031,0.0,28
2020-03-30 13:00:00+02:00,127,11,116,19.116953333289125,125,13,112,23.026828253397017,5,1031,0.0,28
2020-03-30 14:00:00+02:00,127,11,116,19.116953333289125,125,13,112,23.026828253397017,5,1031,0.0,28
2020-03-30 15:00:00+02:00,139,12,127,18.732486269107348,137,15,122,18.928795118329443,5,1031,0.0,28
2020-03-30 16:00:00+02:00,145,14,131,18.85528596371164,157,17,140,23.857880119976507,5,1031,0.0,28
2020-03-30 17:00:00+02:00,216,21,195,21.273439412003903,220,27,193,16.758079648934128,5,1031,0.0,28
2020-03-30 18:00:00+02:00,228,21,207,15.818609956751573,225,22,203,17.07968654570721,5,1031,0.0,28
2020-03-30 19:00:00+02:00,168,15,153,20.304807772345505,167,18,149,21.39117903937357,5,1031,0.0,28
2020-03-30 20:00:00+02:00,166,16,150,18.57114730689396,170,20,150,19.775542485132945,5,1031,0.0,28
2020-03-30 21:00:00+02:00,122,13,109,20.245567873519157,131,15,116,14.183230975852695,5,1031,0.0,28
2020-03-30 22:00:00+02:00,89,8,81,17.562315027840828,89,8,81,17.562315027840828,5,1031,0.0,28
2020-03-30 23:00:00+02:00,63,5,58,14.929801273937542,62,6,56,14.48690450543278,5,1031,0.0,28
2020-03-31 00:00:00+02:00,34,3,31,5.3950651883530085,41,4,37,8.457036189746331,7,1027,0.0,17
2020-03-31 01:00:00+02:00,25,2,23,1.1875344360364632,27,2,25,1.9016023008994223,7,1027,0.0,17
2020-03-31 02:00:00+02:00,25,2,23,1.1875344360364632,27,2,25,1.9016023008994223,7,1027,0.0,17
2020-03-31 03:00:00+02:00,39,3,36,6.782457974710225,38,3,35,11.101073107969722,7,1027,0.0,17
2020-03-31 04:00:00+02:00,63,5,58,14.929801273937542,64,6,58,14.414592943793718,7,1027,0.0,17
2020-03-31 05:00:00+02:00,118,10,108,23.272574380346793,126,12,114,21.990298593101397,7,1027,0.0,17
2020-03-31 06:00:00+02:00,129,12,117,17.995114557081255,148,12,136,18.058884943386857,7,1027,0.0,17
2020-03-31 07:00:00+02:00,226,21,205,20.308697708911414,222,21,201,18.77573498601868,7,1027,0.0,17
2020-03-31 08:00:00+02:00,208,19,189,17.851758798784658,247,21,226,18.30797612224211,7,1027,0.0,17
2020-03-31 09:00:00+02:00,140,11,129,15.331768592489755,155,15,140,19.469409355748308,7,1027,0.0,17
2020-03-31 10:00:00+02:00,117,11,106,21.891304075969387,140,13,127,15.331768592489755,7,1027,0.0,17
2020-03-31 11:00:00+02:00,139,12,127,18.732486269107348,155,15,140,19.469409355748308,7,1027,0.0,17
2020-03-31 12:00:00+02:00,117,11,106,21.891304075969387,140,13,127,15.331768592489755,7,1027,0.0,17
2020-03-31 13:00:00+02:00,116,10,106,23.67872830820291,140,13,127,15.331768592489755,7,1027,0.0,17
2020-03-31 14:00:00+02:00,116,10,106,23.67872830820291,140,13,127,15.331768592489755,7,1027,0.0,17
2020-03-31 15:00:00+02:00,128,11,117,19.601953989978306,148,12,136,18.058884943386857,7,1027,0.0,17
2020-03-31 16:00:00+02:00,159,15,144,17.78748005044877,162,13,149,19.08849102929865,7,1027,0.0,17
2020-03-31 17:00:00+02:00,207,17,190,21.877297854955202,224,21,203,16.30248157536985,7,1027,0.0,17
2020-03-31 18:00:00+02:00,220,18,202,16.758079648934128,242,21,221,20.990360069331732,7,1027,0.0,17
2020-03-31 19:00:00+02:00,159,14,145,17.78748005044877,175,14,161,17.666202741429842,7,1027,0.0,17
2020-03-31 20:00:00+02:00,170,15,155,19.775542485132945,170,18,152,19.775542485132945,7,1027,0.0,17
2020-03-31 21:00:00+02:00,130,10,120,15.65660051079879,135,11,124,21.280002906629502,7,1027,0.0,17
2020-03-31 22:00:00+02:00,92,7,85,10.404364071122256,90,7,83,13.960700117154147,7,1027,0.0,17
2020-03-31 23:00:00+02:00,59,4,55,10.572210467564378,64,6,58,14.414592943793718,7,1027,0.0,17
2020-04-01 00:00:00+02:00,66,8,58,8.66087158766172,64,7,57,14.026099803141571,10,1026,0.0,13
2020-04-01 01:00:00+02:00,43,5,38,7.555366152542149,41,5,36,4.9345676418029445,10,1026,0.0,13
2020-04-01 02:00:00+02:00,43,4,39,7.555366152542149,41,5,36,4.9345676418029445,10,1026,0.0,13
2020-04-01 03:00:00+02:00,66,7,59,8.66087158766172,64,7,57,14.026099803141571,10,1026,0.0,13
2020-04-01 04:00:00+02:00,110,14,96,14.109887773033899,99,10,89,14.833512798015287,10,1026,0.0,13
2020-04-01 05:00:00+02:00,201,22,179,22.061472810845842,195,23,172,21.502321255791472,10,1026,0.0,13
2020-04-01 06:00:00+02:00,241,28,213,22.882071172466965,220,24,196,18.729640796362187,10,1026,0.0,13
2020-04-01 07:00:00+02:00,379,47,332,20.059308979444502,353,36,317,16.072474715915927,10,1026,0.0,13
2020-04-01 08:00:00+02:00,398,50,348,17.528461730035602,403,48,355,13.914029524281172,10,1026,0.0,13
2020-04-01 09:00:00+02:00,265,32,233,20.34267348407847,239,24,215,23.923723620231325,10,1026,0.0,13
2020-04-01 10:00:00+02:00,218,26,192,22.73300845004657,199,25,174,17.787925292792103,10,1026,0.0,13
2020-04-01 11:00:00+02:00,264,31,233,19.326928751905097,239,24,215,23.923723620231325,10,1026,0.0,13
2020-04-01 12:00:00+02:00,218,26,192,22.73300845004657,199,25,174,17.787925292792103,10,1026,0.0,13
2020-04-01 13:00:00+02:00,220,26,194,18.729640796362187,216,24,192,19.85285941667913,10,1026,0.0,13
2020-04-01 14:00:00+02:00,220,25,195,18.729640796362187,216,24,192,19.85285941667913,10,1026,0.0,13
2020-04-01 15:00:00+02:00,243,28,215,25.380099969640305,230,27,203,17.60723498396665,10,1026,0.0,13
2020-04-01 16:00:00+02:00,264,29,235,19.326928751905097,239,24,215,23.923723620231325,10,1026,0.0,13
2020-04-01 17:00:00+02:00,372,46,326,22.421394120106562,351,44,307,21.009303371553763,10,1026,0.0,13
2020-04-01 18:00:00+02:00,400,45,355,24.218092797619367,375,40,335,18.630225331336334,10,1026,0.0,13
2020-04-01 19:00:00+02:00,283,38,245,21.39422350027581,276,26,250,17.34974806433115,10,1026,0.0,13
2020-04-01 20:00:00+02:00,286,33,253,22.799042804335677,274,34,240,27.25802623834161,10,1026,0.0,13
2020-04-01 21:00:00+02:00,220,25,195,18.729640796362187,216,24,192,19.85285941667913,10,1026,0.0,13
2020-04-01 22:00:00+02:00,153,17,136,18.89706115395996,141,17,124,16.082921323202,10,1026,0.0,13
2020-04-01 23:00:00+02:00,110,12,98,14.109887773033899,99,10,89,14.833512798015287,10,1026,0.0,13
2020-04-02 00:00:00+02:00,58,4,54,10.505136369992313,60,9,51,10.583722413773145,7,1020,0.0,11
2020-04-02 01:00:00+02:00,34,2,32,5.3950651883530085,40,5,35,5.275608835029151,7,1020,0.0,11
2020-04-02 02:00:00+02:00,39,3,36,6.782457974710225,37,5,32,2.066086063070793,7,1020,0.0,11
2020-04-02 03:00:00+02:00,56,4,52,10.152150256689218,61,8,53,12.362973378192347,7,1020,0.0,11
2020-04-02 04:00:00+02:00,87,7,80,17.896548892855574,99,12,87,10.779955578794215,7,1020,0.0,11
2020-04-02 05:00:00+02:00,165,14,151,20.56038540292619,180,28,152,20.970253971133605,7,1020,0.0,11
2020-04-02 06:00:00+02:00,211,18,193,18.759232281731908,216,31,185,21.273439412003903,7,1020,0.0,11
2020-04-02 07:00:00+02:00,325,29,296,19.331050121665143,354,55,299,21.22371738501729,7,1020,0.0,11
2020-04-02 08:00:00+02:00,362,28,334,18.208767664177746,357,58,299,21.912097396672888,7,1020,0.0,11
2020-04-02 09:00:00+02:00,240,18,222,16.023164601360044,239,34,205,13.74553452780325,7,1020,0.0,11
2020-04-02 10:00:00+02:00,209,17,192,22.16757043059366,200,25,175,19.256012935412965,7,1020,0.0,11
2020-04-02 11:00:00+02:00,216,18,198,21.273439412003903,245,39,206,18.942213831390788,7,1020,0.0,11
2020-04-02 12:00:00+02:00,185,16,169,20.160625004949942,195,25,170,23.83440770251287,7,1020,0.0,11
2020-04-02 13:00:00+02:00,208,18,190,17.851758798784658,201,25,176,22.51450761920508,7,1020,0.0,11
2020-04-02 14:00:00+02:00,180,15,165,20.970253971133605,206,31,175,22.241507594869486,7,1020,0.0,11
2020-04-02 15:00:00+02:00,195,15,180,23.83440770251287,226,28,198,20.308697708911414,7,1020,0.0,11
2020-04-02 16:00:00+02:00,214,17,197,18.560318290748608,250,36,214,14.642007731534619,7,1020,0.0,11
2020-04-02 17:00:00+02:00,315,27,288,16.084372336057935,330,47,283,16.43301680059058,7,1020,0.0,11
2020-04-02 18:00:00+02:00,327,26,301,17.492932564197055,353,45,308,20.016393666106563,7,1020,0.0,11
2020-04-02 19:00:00+02:00,250,22,228,14.642007731534619,258,39,219,21.93153719781745,7,1020,0.0,11
2020-04-02 20:00:00+02:00,232,18,214,14.357520231191923,265,34,231,24.143057918667047,7,1020,0.0,11
2020-04-02 21:00:00+02:00,183,14,169,16.4856647978058,192,24,168,21.295822766447603,7,1020,0.0,11
2020-04-02 22:00:00+02:00,131,10,121,14.183230975852695,139,17,122,18.732486269107348,7,1020,0.0,11
2020-04-02 23:00:00+02:00,87,7,80,17.896548892855574,99,12,87,10.779955578794215,7,1020,0.0,11
2020-04-03 00:00:00+02:00,86,8,78,21.204994436842384,84,7,77,14.398269762880606,11,1017,0.0,8
2020-04-03 01:00:00+02:00,58,6,52,10.505136369992313,58,6,52,10.505136369992313,11,1017,0.0,8
2020-04-03 02:00:00+02:00,58,6,52,10.505136369992313,58,6,52,10.505136369992313,11,1017,0.0,8
2020-04-03 03:00:00+02:00,86,9,77,21.204994436842384,84,7,77,14.398269762880606,11,1017,0.0,8
2020-04-03 04:00:00+02:00,147,15,132,20.208056467665056,147,12,135,20.208056467665056,11,1017,0.0,8
2020-04-03 05:00:00+02:00,272,28,244,23.2664106640069,260,29,231,21.14564444182058,11,1017,0.0,8
2020-04-03 06:00:00+02:00,316,33,283,20.52457281115525,311,27,284,16.325599187415413,11,1017,0.0,8
2020-04-03 07:00:00+02:00,494,47,447,22.10454361750988,499,56,443,21.95846674548548,11,1017,0.0,8
2020-04-03 08:00:00+02:00,537,55,482,17.709537334724534,534,48,486,22.13831863455401,11,1017,0.0,8
2020-04-03 09:00:00+02:00,342,33,309,17.147818156889407,328,35,293,17.860857228116767,11,1017,0.0,8
2020-04-03 10:00:00+02:00,300,32,268,19.621479548992166,276,27,249,21.646913060128323,11,1017,0.0,8
2020-04-03 11:00:00+02:00,344,33,311,17.416933285982235,351,40,311,16.04918751558848,11,1017,0.0,8
2020-04-03 12:00:00+02:00,288,28,260,22.858888837585067,276,25,251,21.646913060128323,11,1017,0.0,8
2020-04-03 13:00:00+02:00,288,28,260,22.858888837585067,276,25,251,21.646913060128323,11,1017,0.0,8
2020-04-03 14:00:00+02:00,288,28,260,22.858888837585067,276,25,251,21.646913060128323,11,1017,0.0,8
2020-04-03 15:00:00+02:00,316,30,286,20.52457281115525,311,27,284,16.325599187415413,11,1017,0.0,8
2020-04-03 16:00:00+02:00,349,33,316,16.300891984453436,351,31,320,16.04918751558848,11,1017,0.0,8
2020-04-03 17:00:00+02:00,490,48,442,20.189989846505636,508,49,459,22.57591031476529,11,1017,0.0,8
2020-04-03 18:00:00+02:00,541,56,485,22.694770826128472,492,44,448,19.891083729909596,11,1017,0.0,8
2020-04-03 19:00:00+02:00,384,37,347,23.18758332904822,386,39,347,18.304254687443294,11,1017,0.0,8
2020-04-03 20:00:00+02:00,384,37,347,23.18758332904822,386,39,347,18.304254687443294,11,1017,0.0,8
2020-04-03 21:00:00+02:00,295,28,267,20.557446011766526,279,24,255,23.809963875172556,11,1017,0.0,8
2020-04-03 22:00:00+02:00,204,22,182,12.517560993101368,194,21,173,21.593451125557873,11,1017,0.0,8
2020-04-03 23:00:00+02:00,147,15,132,20.208056467665056,147,12,135,20.208056467665056,11,1017,0.0,8
2020-04-04 00:00:00+02:00,97,6,91,12.91170780960746,99,5,94,10.313624634117142,13,1022,0.0,8
2020-04-04 01:00:00+02:00,64,4,60,8.557251957401023,66,4,62,9.595877216947136,13,1022,0.0,8
2020-04-04 02:00:00+02:00,61,3,58,13.45123014142322,64,3,61,8.557251957401023,13,1022,0.0,8
2020-04-04 03:00:00+02:00,94,6,88,10.166272350500234,99,5,94,10.313624634117142,13,1022,0.0,8
2020-04-04 04:00:00+02:00,128,8,120,16.268122259148125,133,8,125,15.567856067550506,13,1022,0.0,8
2020-04-04 05:00:00+02:00,161,9,152,19.39413115763897,166,9,157,16.094287115128708,13,1022,0.0,8
2020-04-04 06:00:00+02:00,253,17,236,17.73107046839405,268,17,251,20.190442141402777,13,1022,0.0,8
2020-04-04 07:00:00+02:00,391,23,368,20.537782610304173,396,23,373,19.03159851440849,13,1022,0.0,8
2020-04-04 08:00:00+02:00,522,30,492,17.418929457126325,540,27,513,17.905003567944703,13,1022,0.0,8
2020-04-04 09:00:00+02:00,553,33,520,19.32438306591248,576,36,540,12.499771352819842,13,1022,0.0,8
2020-04-04 10:00:00+02:00,468,31,437,19.201560947119127,512,32,480,16.667622950500245,13,1022,0.0,8
2020-04-04 11:00:00+02:00,384,25,359,20.93762948810624,407,24,383,18.86836233630375,13,1022,0.0,8
2020-04-04 12:00:00+02:00,391,25,366,20.537782610304173,396,23,373,19.03159851440849,13,1022,0.0,8
2020-04-04 13:00:00+02:00,422,24,398,15.562162592523094,432,22,410,19.977965204645113,13,1022,0.0,8
2020-04-04 14:00:00+02:00,376,21,355,20.486350839145686,407,23,384,18.86836233630375,13,1022,0.0,8
2020-04-04 15:00:00+02:00,455,29,426,20.707907447169188,476,29,447,20.090041264055532,13,1022,0.0,8
2020-04-04 16:00:00+02:00,445,27,418,21.520045849832552,471,26,445,21.514046870792356,13,1022,0.0,8
2020-04-04 17:00:00+02:00,514,29,485,17.757565512121285,545,27,518,20.585179405284507,13,1022,0.0,8
2020-04-04 18:00:00+02:00,473,27,446,14.300214591159298,501,28,473,17.91816636651384,13,1022,0.0,8
2020-04-04 19:00:00+02:00,394,25,369,20.620478231973475,399,24,375,22.11505355738079,13,1022,0.0,8
2020-04-04 20:00:00+02:00,343,23,320,16.93402466287014,371,24,347,18.297011572558848,13,1022,0.0,8
2020-04-04 21:00:00+02:00,322,19,303,18.644637808692327,332,18,314,20.862138293674573,13,1022,0.0,8
2020-04-04 22:00:00+02:00,258,15,243,20.847323082118503,268,17,251,20.190442141402777,13,1022,0.0,8
2020-04-04 23:00:00+02:00,130,7,123,16.267882133132378,133,6,127,15.567856067550506,13,1022,0.0,8
2020-04-05 00:00:00+02:00,47,1,46,8.734704942588355,63,2,61,11.83290839187245,16,1020,0.0,14
2020-04-05 01:00:00+02:00,29,1,28,0.5419439371488394,40,1,39,6.907029621336792,16,1020,0.0,14
2020-04-05 02:00:00+02:00,31,1,30,0.3699528216625179,38,1,37,5.960450042509954,16,1020,0.0,14
2020-04-05 03:00:00+02:00,47,1,46,8.734704942588355,63,2,61,11.83290839187245,16,1020,0.0,14
2020-04-05 04:00:00+02:00,61,2,59,13.45123014142322,68,2,66,8.84385076442631,16,1020,0.0,14
2020-04-05 05:00:00+02:00,79,3,76,13.473204105951462,84,3,81,7.6306798135980785,16,1020,0.0,14
2020-04-05 06:00:00+02:00,134,4,130,14.696678321454899,172,6,166,18.863206387348974,16,1020,0.0,14
2020-04-05 07:00:00+02:00,202,7,195,21.075229783177793,236,7,229,18.261863976847756,16,1020,0.0,14
2020-04-05 08:00:00+02:00,252,10,242,19.00138202247206,291,12,279,14.14711867692869,16,1020,0.0,14
2020-04-05 09:00:00+02:00,277,11,266,19.768862676933345,322,11,311,18.644637808692327,16,1020,0.0,14
2020-04-05 10:00:00+02:00,231,8,223,18.808415660395674,318,13,305,22.522150292755875,16,1020,0.0,14
2020-04-05 11:00:00+02:00,197,8,189,19.118279085736297,206,8,198,20.90053052788098,16,1020,0.0,14
2020-04-05 12:00:00+02:00,186,7,179,20.400698976924794,234,8,226,18.523045519331724,16,1020,0.0,14
2020-04-05 13:00:00+02:00,204,8,196,20.27930898180519,279,10,269,20.757341864573803,16,1020,0.0,14
2020-04-05 14:00:00+02:00,188,7,181,19.664617237016223,225,7,218,16.518156382279376,16,1020,0.0,14
2020-04-05 15:00:00+02:00,236,10,226,18.261863976847756,263,10,253,18.06193495748254,16,1020,0.0,14
2020-04-05 16:00:00+02:00,220,8,212,20.77869221062603,229,7,222,20.858973540615885,16,1020,0.0,14
2020-04-05 17:00:00+02:00,257,10,247,18.99808160477331,329,13,316,20.177718732958198,16,1020,0.0,14
2020-04-05 18:00:00+02:00,245,9,236,17.30944248589229,327,14,313,19.796623391570257,16,1020,0.0,14
2020-04-05 19:00:00+02:00,200,7,193,21.668114478408352,231,7,224,18.808415660395674,16,1020,0.0,14
2020-04-05 20:00:00+02:00,179,7,172,21.74229179161351,197,7,190,19.118279085736297,16,1020,0.0,14
2020-04-05 21:00:00+02:00,154,6,148,19.868163821621103,161,5,156,19.39413115763897,16,1020,0.0,14
2020-04-05 22:00:00+02:00,127,5,122,18.022773693841014,152,6,146,18.686880121910534,16,1020,0.0,14
2020-04-05 23:00:00+02:00,59,2,57,11.512224289105106,84,3,81,7.6306798135980785,16,1020,0.0,14
2020-04-06 00:00:00+02:00,88,8,80,17.756927742208592,95,11,84,11.735389228725284,14,1017,0.0,10
2020-04-06 01:00:00+02:00,61,5,56,12.362973378192347,61,6,55,12.362973378192347,14,1017,0.0,10
2020-04-06 02:00:00+02:00,59,5,54,10.572210467564378,63,5,58,14.929801273937542,14,1017,0.0,10
2020-04-06 03:00:00+02:00,88,8,80,17.756927742208592,95,11,84,11.735389228725284,14,1017,0.0,10
2020-04-06 04:00:00+02:00,155,14,141,19.469409355748308,155,19,136,19.469409355748308,14,1017,0.0,10
2020-04-06 05:00:00+02:00,270,29,241,23.920073269237992,285,27,258,23.62629721954127,14,1017,0.0,10
2020-04-06 06:00:00+02:00,359,38,321,21.41163694321985,344,40,304,17.416933285982235,14,1017,0.0,10
2020-04-06 07:00:00+02:00,541,59,482,22.694770826128472,521,52,469,19.221358989967857,14,1017,0.0,10
2020-04-06 08:00:00+02:00,570,60,510,25.11924504296083,563,58,505,20.337981892053655,14,1017,0.0,10
2020-04-06 09:00:00+02:00,371,36,335,20.767700865402965,374,39,335,18.17629135420491,14,1017,0.0,10
2020-04-06 10:00:00+02:00,312,29,283,18.640393178431868,315,32,283,16.084372336057935,14,1017,0.0,10
2020-04-06 11:00:00+02:00,364,36,328,19.12804198058144,376,47,329,15.920759199358614,14,1017,0.0,10
2020-04-06 12:00:00+02:00,315,29,286,16.084372336057935,310,34,276,16.921651532922695,14,1017,0.0,10
2020-04-06 13:00:00+02:00,312,29,283,18.640393178431868,315,32,283,16.084372336057935,14,1017,0.0,10
2020-04-06 14:00:00+02:00,302,30,272,17.71336274061634,307,34,273,19.62844127124222,14,1017,0.0,10
2020-04-06 15:00:00+02:00,334,35,299,23.256671102053218,349,39,310,16.300891984453436,14,1017,0.0,10
2020-04-06 16:00:00+02:00,381,35,346,21.060383299923174,391,42,349,20.019115852021912,14,1017,0.0,10
2020-04-06 17:00:00+02:00,519,48,471,18.136209473828288,538,63,475,22.05606214078663,14,1017,0.0,10
2020-04-06 18:00:00+02:00,538,51,487,22.05606214078663,553,57,496,21.584774386830425,14,1017,0.0,10
2020-04-06 19:00:00+02:00,420,42,378,20.41205404512006,410,51,359,20.532450928302634,14,1017,0.0,10
2020-04-06 20:00:00+02:00,393,42,351,19.01393712330975,403,45,358,24.744299394136338,14,1017,0.0,10
2020-04-06 21:00:00+02:00,300,28,272,19.621479548992166,307,34,273,19.62844127124222,14,1017,0.0,10
2020-04-06 22:00:00+02:00,211,22,189,18.759232281731908,219,24,195,21.009686825041197,14,1017,0.0,10
2020-04-06 23:00:00+02:00,155,13,142,19.469409355748308,155,19,136,19.469409355748308,14,1017,0.0,10
2020-04-07 00:00:00+02:00,114,11,103,18.09348958441383,128,14,114,19.601953989978306,15,1028,0.0,2
2020-04-07 01:00:00+02:00,77,6,71,16.632320143368542,91,9,82,13.154481673544206,15,1028,0.0,2
2020-04-07 02:00:00+02:00,77,6,71,16.632320143368542,91,9,82,13.154481673544206,15,1028,0.0,2
2020-04-07 03:00:00+02:00,118,9,109,23.272574380346793,135,13,122,21.280002906629502,15,1028,0.0,2
2020-04-07 04:00:00+02:00,216,18,198,21.273439412003903,226,25,201,20.308697708911414,15,1028,0.0,2
2020-04-07 05:00:00+02:00,344,30,314,17.416933285982235,405,46,359,18.172278090342537,15,1028,0.0,2
2020-04-07 06:00:00+02:00,422,41,381,20.257299015157166,476,53,423,21.50817112871545,15,1028,0.0,2
2020-04-07 07:00:00+02:00,726,66,660,18.91664233807501,769,77,692,27.696725693822028,15,1028,0.0,2
2020-04-07 08:00:00+02:00,692,68,624,27.354046214615703,813,89,724,22.527079347661243,15,1028,0.0,2
2020-04-07 09:00:00+02:00,496,46,450,19.543873703625547,530,56,474,19.57875562009149,15,1028,0.0,2
2020-04-07 10:00:00+02:00,401,39,362,26.708807440790352,439,45,394,18.965638166337634,15,1028,0.0,2
2020-04-07 11:00:00+02:00,455,37,418,18.957107089369835,523,53,470,16.192550011919526,15,1028,0.0,2
2020-04-07 12:00:00+02:00,435,37,398,21.80027200191571,435,43,392,21.80027200191571,15,1028,0.0,2
2020-04-07 13:00:00+02:00,391,35,356,20.019115852021912,432,38,394,18.473076954520703,15,1028,0.0,2
2020-04-07 14:00:00+02:00,388,34,354,23.106523601706122,462,44,418,18.95008410951899,15,1028,0.0,2
2020-04-07 15:00:00+02:00,476,45,431,21.50817112871545,506,50,456,18.537819376216163,15,1028,0.0,2
2020-04-07 16:00:00+02:00,520,43,477,21.447261472760864,526,58,468,21.343558174072673,15,1028,0.0,2
2020-04-07 17:00:00+02:00,665,63,602,16.589612733582396,746,68,678,27.806192513599928,15,1028,0.0,2
2020-04-07 18:00:00+02:00,695,62,633,28.42195596268422,763,66,697,23.496566522844443,15,1028,0.0,2
2020-04-07 19:00:00+02:00,560,55,505,19.606018509461766,570,54,516,25.11924504296083,15,1028,0.0,2
2020-04-07 20:00:00+02:00,513,44,469,24.12103157612141,553,55,498,21.584774386830425,15,1028,0.0,2
2020-04-07 21:00:00+02:00,415,38,377,23.376361640310524,452,49,403,20.424814624877964,15,1028,0.0,2
2020-04-07 22:00:00+02:00,290,25,265,18.088844908617002,307,33,274,19.62844127124222,15,1028,0.0,2
2020-04-07 23:00:00+02:00,192,18,174,21.295822766447603,222,21,201,18.77573498601868,15,1028,0.0,2
2020-04-08 00:00:00+02:00,125,15,110,14.698947587184879,125,13,112,14.698947587184879,19,1026,0.0,6
2020-04-08 01:00:00+02:00,84,10,74,16.873060415025794,81,8,73,20.92938881342839,19,1026,0.0,6
2020-04-08 02:00:00+02:00,84,10,74,16.873060415025794,81,8,73,20.92938881342839,19,1026,0.0,6
2020-04-08 03:00:00+02:00,125,15,110,14.698947587184879,125,13,112,14.698947587184879,19,1026,0.0,6
2020-04-08 04:00:00+02:00,213,26,187,16.70464389525102,193,23,170,18.658224506029875,19,1026,0.0,6
2020-04-08 05:00:00+02:00,383,45,338,17.09012122439535,387,40,347,17.47876613578263,19,1026,0.0,6
2020-04-08 06:00:00+02:00,468,63,405,20.750300610230987,461,48,413,22.135518273089986,19,1026,0.0,6
2020-04-08 07:00:00+02:00,723,95,628,21.605911854197412,686,66,620,18.09208187863961,19,1026,0.0,6
2020-04-08 08:00:00+02:00,787,100,687,21.43712347084134,787,80,707,21.43712347084134,19,1026,0.0,6
2020-04-08 09:00:00+02:00,523,62,461,19.232400876414125,512,64,448,23.041505435623115,19,1026,0.0,6
2020-04-08 10:00:00+02:00,434,55,379,20.9227488499813,397,39,358,17.68183590028467,19,1026,0.0,6
2020-04-08 11:00:00+02:00,509,63,446,17.061130068212915,489,54,435,20.979024543119948,19,1026,0.0,6
2020-04-08 12:00:00+02:00,431,52,379,23.74211045616923,410,44,366,11.55444972100336,19,1026,0.0,6
2020-04-08 13:00:00+02:00,434,49,385,20.9227488499813,397,39,358,17.68183590028467,19,1026,0.0,6
2020-04-08 14:00:00+02:00,424,52,372,17.28621876263119,397,50,347,17.68183590028467,19,1026,0.0,6
2020-04-08 15:00:00+02:00,465,58,407,22.071436322838696,427,53,374,20.04761786859743,19,1026,0.0,6
2020-04-08 16:00:00+02:00,516,70,446,19.477342984372644,523,53,470,19.232400876414125,19,1026,0.0,6
2020-04-08 17:00:00+02:00,740,101,639,26.236542664510207,713,68,645,23.720981687157153,19,1026,0.0,6
2020-04-08 18:00:00+02:00,764,100,664,24.717599236324578,696,76,620,25.111204796866655,19,1026,0.0,6
2020-04-08 19:00:00+02:00,560,74,486,22.90545494801123,543,63,480,10.77336456884601,19,1026,0.0,6
2020-04-08 20:00:00+02:00,560,65,495,22.90545494801123,543,63,480,10.77336456884601,19,1026,0.0,6
2020-04-08 21:00:00+02:00,431,50,381,23.74211045616923,410,44,366,11.55444972100336,19,1026,0.0,6
2020-04-08 22:00:00+02:00,302,34,268,16.69876077341281,285,31,254,24.91827111917757,19,1026,0.0,6
2020-04-08 23:00:00+02:00,217,29,188,20.47500927792046,210,23,187,22.373575210561917,19,1026,0.0,6
2020-04-09 00:00:00+02:00,125,10,115,23.026828253397017,136,17,119,16.594078125250377,20,1024,0.0,3
2020-04-09 01:00:00+02:00,87,7,80,17.896548892855574,91,11,80,13.154481673544206,20,1024,0.0,3
2020-04-09 02:00:00+02:00,94,8,86,13.172779715339633,87,13,74,17.896548892855574,20,1024,0.0,3
2020-04-09 03:00:00+02:00,140,12,128,15.331768592489755,132,19,113,19.37004764296085,20,1024,0.0,3
2020-04-09 04:00:00+02:00,216,19,197,21.273439412003903,239,38,201,13.74553452780325,20,1024,0.0,3
2020-04-09 05:00:00+02:00,440,36,404,19.57754243382943,414,65,349,21.211929621647883,20,1024,0.0,3
2020-04-09 06:00:00+02:00,509,43,466,12.20192288247499,490,69,421,20.189989846505636,20,1024,0.0,3
2020-04-09 07:00:00+02:00,813,67,746,22.527079347661243,816,123,693,16.718501990725535,20,1024,0.0,3
2020-04-09 08:00:00+02:00,843,74,769,17.037882589890646,851,122,729,22.04119359069634,20,1024,0.0,3
2020-04-09 09:00:00+02:00,547,44,503,20.747394942344446,539,74,465,14.75171382469777,20,1024,0.0,3
2020-04-09 10:00:00+02:00,448,37,411,23.047509824765182,455,65,390,18.957107089369835,20,1024,0.0,3
2020-04-09 11:00:00+02:00,566,44,522,17.19426395043967,562,85,477,17.57000312304836,20,1024,0.0,3
2020-04-09 12:00:00+02:00,474,39,435,24.663345069259766,467,65,402,22.874976747697783,20,1024,0.0,3
2020-04-09 13:00:00+02:00,421,32,389,22.41212221732918,474,65,409,24.663345069259766,20,1024,0.0,3
2020-04-09 14:00:00+02:00,433,35,398,15.756615810687446,452,63,389,20.424814624877964,20,1024,0.0,3
2020-04-09 15:00:00+02:00,497,40,457,23.514377363791095,512,77,435,24.456321505157344,20,1024,0.0,3
2020-04-09 16:00:00+02:00,566,43,523,17.19426395043967,562,85,477,17.57000312304836,20,1024,0.0,3
2020-04-09 17:00:00+02:00,809,68,741,20.888496543059407,775,111,664,22.057469518952598,20,1024,0.0,3
2020-04-09 18:00:00+02:00,759,57,702,23.764447281483374,866,122,744,21.671956407237744,20,1024,0.0,3
2020-04-09 19:00:00+02:00,619,55,564,21.130188595205187,623,90,533,16.227361496670994,20,1024,0.0,3
2020-04-09 20:00:00+02:00,543,41,502,23.469937738067248,577,74,503,23.103874122084292,20,1024,0.0,3
2020-04-09 21:00:00+02:00,471,37,434,24.71489709392721,452,56,396,20.424814624877964,20,1024,0.0,3
2020-04-09 22:00:00+02:00,315,25,290,16.084372336057935,315,45,270,16.084372336057935,20,1024,0.0,3
2020-04-09 23:00:00+02:00,208,17,191,17.851758798784658,235,29,206,20.674840106170866,20,1024,0.0,3
2020-04-10 00:00:00+02:00,129,13,116,17.995114557081255,125,10,115,23.026828253397017,20,1024,0.0,6
2020-04-10 01:00:00+02:00,83,7,76,18.699193296190067,83,8,75,18.699193296190067,20,1024,0.0,6
2020-04-10 02:00:00+02:00,83,8,75,18.699193296190067,83,8,75,18.699193296190067,20,1024,0.0,6
2020-04-10 03:00:00+02:00,125,12,113,23.026828253397017,125,11,114,23.026828253397017,20,1024,0.0,6
2020-04-10 04:00:00+02:00,216,19,197,21.273439412003903,220,24,196,16.758079648934128,20,1024,0.0,6
2020-04-10 05:00:00+02:00,388,35,353,23.106523601706122,402,38,364,17.230856788696144,20,1024,0.0,6
2020-04-10 06:00:00+02:00,475,49,426,26.73035993542065,479,45,434,24.037051458292083,20,1024,0.0,6
2020-04-10 07:00:00+02:00,731,73,658,19.497186904797278,766,81,685,25.027999628136882,20,1024,0.0,6
2020-04-10 08:00:00+02:00,766,83,683,25.027999628136882,745,83,662,24.741896667257816,20,1024,0.0,6
2020-04-10 09:00:00+02:00,510,50,460,19.94640789038923,493,49,444,23.14736404920122,20,1024,0.0,6
2020-04-10 10:00:00+02:00,437,47,390,22.67431624563715,423,46,377,23.290663678046883,20,1024,0.0,6
2020-04-10 11:00:00+02:00,521,56,465,19.221358989967857,524,56,468,19.821110984782088,20,1024,0.0,6
2020-04-10 12:00:00+02:00,451,43,408,20.489203978314702,447,42,405,16.685974257079213,20,1024,0.0,6
2020-04-10 13:00:00+02:00,426,42,384,20.8097346735364,416,43,373,17.117872401421668,20,1024,0.0,6
2020-04-10 14:00:00+02:00,447,40,407,16.685974257079213,419,42,377,22.446709242047174,20,1024,0.0,6
2020-04-10 15:00:00+02:00,479,52,427,24.037051458292083,465,47,418,19.650501243200726,20,1024,0.0,6
2020-04-10 16:00:00+02:00,538,56,482,22.05606214078663,493,45,448,23.14736404920122,20,1024,0.0,6
2020-04-10 17:00:00+02:00,741,80,661,25.749382578741635,727,78,649,16.475797179385555,20,1024,0.0,6
2020-04-10 18:00:00+02:00,797,79,718,21.083456019846714,804,80,724,21.607637868650773,20,1024,0.0,6
2020-04-10 19:00:00+02:00,559,58,501,22.603831145806197,545,51,494,19.63111833719715,20,1024,0.0,6
2020-04-10 20:00:00+02:00,549,51,498,18.718889066861195,559,52,507,22.603831145806197,20,1024,0.0,6
2020-04-10 21:00:00+02:00,426,40,386,20.8097346735364,416,43,373,17.117872401421668,20,1024,0.0,6
2020-04-10 22:00:00+02:00,311,28,283,16.325599187415413,300,28,272,19.621479548992166,20,1024,0.0,6
2020-04-10 23:00:00+02:00,209,20,189,22.16757043059366,213,18,195,20.488166305452438,20,1024,0.0,6
2020-04-11 00:00:00+02:00,121,7,114,11.617438248542046,121,6,115,11.617438248542046,20,1023,0.0,9
2020-04-11 01:00:00+02:00,76,4,72,13.279950485691732,83,5,78,9.333357558089729,20,1023,0.0,9
2020-04-11 02:00:00+02:00,76,4,72,13.279950485691732,83,5,78,9.333357558089729,20,1023,0.0,9
2020-04-11 03:00:00+02:00,118,6,112,16.65435568776215,124,7,117,14.467255533674502,20,1023,0.0,9
2020-04-11 04:00:00+02:00,153,9,144,18.67945251137068,163,8,155,16.305265165047643,20,1023,0.0,9
2020-04-11 05:00:00+02:00,204,11,193,20.27930898180519,211,12,199,15.949558582123627,20,1023,0.0,9
2020-04-11 06:00:00+02:00,310,19,291,15.258998808795859,329,19,310,20.177718732958198,20,1023,0.0,9
2020-04-11 07:00:00+02:00,486,28,458,25.256807440063877,508,31,477,11.879495628294928,20,1023,0.0,9
2020-04-11 08:00:00+02:00,652,44,608,22.568252909097243,678,43,635,20.43985683175368,20,1023,0.0,9
2020-04-11 09:00:00+02:00,700,40,660,15.894154355642218,703,38,665,18.81247619491939,20,1023,0.0,9
2020-04-11 10:00:00+02:00,594,38,556,20.041319596330183,633,31,602,17.390194907794736,20,1023,0.0,9
2020-04-11 11:00:00+02:00,479,27,452,18.854981551601607,502,30,472,16.39928567380866,20,1023,0.0,9
2020-04-11 12:00:00+02:00,492,31,461,23.51531207195642,505,27,478,13.420156221106103,20,1023,0.0,9
2020-04-11 13:00:00+02:00,534,30,504,10.719794673298331,543,27,516,21.26508543455116,20,1023,0.0,9
2020-04-11 14:00:00+02:00,486,29,457,25.256807440063877,508,31,477,11.879495628294928,20,1023,0.0,9
2020-04-11 15:00:00+02:00,569,38,531,19.424344306636577,578,37,541,19.016387711485798,20,1023,0.0,9
2020-04-11 16:00:00+02:00,559,35,524,16.28017139379397,588,33,555,18.625003459627973,20,1023,0.0,9
2020-04-11 17:00:00+02:00,649,44,605,20.34487337835388,662,44,618,21.573583600756407,20,1023,0.0,9
2020-04-11 18:00:00+02:00,607,35,572,18.763498809037944,620,33,587,15.579919444904501,20,1023,0.0,9
2020-04-11 19:00:00+02:00,466,26,440,21.82685485689329,498,28,470,14.222982449555595,20,1023,0.0,9
2020-04-11 20:00:00+02:00,444,30,414,21.75090257606931,457,27,430,20.01126294383405,20,1023,0.0,9
2020-04-11 21:00:00+02:00,406,23,383,14.646774291249367,422,26,396,15.562162592523094,20,1023,0.0,9
2020-04-11 22:00:00+02:00,313,18,295,12.040192542056978,329,20,309,20.177718732958198,20,1023,0.0,9
2020-04-11 23:00:00+02:00,159,9,150,19.89258263570152,169,8,161,20.526675282456768,20,1023,0.0,9
2020-04-12 00:00:00+02:00,77,3,74,11.693765322784895,98,4,94,9.366341704429512,21,1021,0.1,6
2020-04-12 01:00:00+02:00,49,2,47,12.126419816698254,66,2,64,9.595877216947136,21,1021,0.1,6
2020-04-12 02:00:00+02:00,45,1,44,8.150223537761923,63,2,61,11.83290839187245,21,1021,0.1,6
2020-04-12 03:00:00+02:00,70,2,68,11.628132043946147,80,3,77,12.9514806028411,21,1021,0.1,6
2020-04-12 04:00:00+02:00,101,4,97,14.022694861996197,133,5,128,15.567856067550506,21,1021,0.1,6
2020-04-12 05:00:00+02:00,126,5,121,13.391954395859463,147,6,141,16.306492316544293,21,1021,0.1,6
2020-04-12 06:00:00+02:00,206,8,198,20.90053052788098,224,8,216,19.039166559272836,21,1021,0.1,6
2020-04-12 07:00:00+02:00,283,11,272,18.945435241048195,339,11,328,18.9351903306688,21,1021,0.1,6
2020-04-12 08:00:00+02:00,395,17,378,18.398546278061747,455,18,437,20.707907447169188,21,1021,0.1,6
2020-04-12 09:00:00+02:00,444,18,426,21.75090257606931,462,18,444,22.520787209725228,21,1021,0.1,6
2020-04-12 10:00:00+02:00,374,14,360,18.684901759797462,472,18,454,15.966412489673269,21,1021,0.1,6
2020-04-12 11:00:00+02:00,304,12,292,24.382586098170826,315,12,303,17.275310260978717,21,1021,0.1,6
2020-04-12 12:00:00+02:00,304,12,292,24.382586098170826,315,12,303,17.275310260978717,21,1021,0.1,6
2020-04-12 13:00:00+02:00,332,14,318,20.862138293674573,427,16,411,17.684962245617744,21,1021,0.1,6
2020-04-12 14:00:00+02:00,290,11,279,19.079826100657762,322,10,312,18.644637808692327,21,1021,0.1,6
2020-04-12 15:00:00+02:00,332,12,320,20.862138293674573,458,17,441,23.935839893982745,21,1021,0.1,6
2020-04-12 16:00:00+02:00,332,12,320,20.862138293674573,458,17,441,23.935839893982745,21,1021,0.1,6
2020-04-12 17:00:00+02:00,378,13,365,21.49376685031853,518,20,498,17.06195195164026,21,1021,0.1,6
2020-04-12 18:00:00+02:00,357,15,342,16.579219218063535,518,18,500,17.06195195164026,21,1021,0.1,6
2020-04-12 19:00:00+02:00,287,12,275,13.917461050382924,385,14,371,18.20092151022271,21,1021,0.1,6
2020-04-12 20:00:00+02:00,287,12,275,13.917461050382924,353,13,340,19.24169978578992,21,1021,0.1,6
2020-04-12 21:00:00+02:00,248,10,238,17.022549227170337,315,10,305,17.275310260978717,21,1021,0.1,6
2020-04-12 22:00:00+02:00,203,8,195,16.97445579481889,241,8,233,17.853279648834448,21,1021,0.1,6
2020-04-12 23:00:00+02:00,91,3,88,8.844154374326946,119,4,115,9.275729661817119,21,1021,0.1,6
2020-04-13 00:00:00+02:00,91,9,82,13.154481673544206,93,8,85,12.914854269394333,16,1013,0.7,5
2020-04-13 01:00:00+02:00,59,5,54,10.572210467564378,64,6,58,14.414592943793718,16,1013,0.7,5
2020-04-13 02:00:00+02:00,64,6,58,14.414592943793718,64,7,57,14.414592943793718,16,1013,0.7,5
2020-04-13 03:00:00+02:00,96,10,86,11.83328593996439,91,11,80,13.154481673544206,16,1013,0.7,5
2020-04-13 04:00:00+02:00,155,14,141,19.469409355748308,155,19,136,19.469409355748308,16,1013,0.7,5
2020-04-13 05:00:00+02:00,271,29,242,24.814459053724722,286,27,259,20.398524223626136,16,1013,0.7,5
2020-04-13 06:00:00+02:00,360,38,322,23.455775768432638,360,45,315,23.455775768432638,16,1013,0.7,5
2020-04-13 07:00:00+02:00,530,58,472,19.57875562009149,537,67,470,17.709537334724534,16,1013,0.7,5
2020-04-13 08:00:00+02:00,582,54,528,18.1879449408186,562,54,508,17.57000312304836,16,1013,0.7,5
2020-04-13 09:00:00+02:00,392,37,355,15.515848376438075,380,40,340,15.070197513038655,16,1013,0.7,5
2020-04-13 10:00:00+02:00,303,32,271,15.98015338859148,310,31,279,16.921651532922695,16,1013,0.7,5
2020-04-13 11:00:00+02:00,377,36,341,16.83689607567409,387,41,346,22.869757461740583,16,1013,0.7,5
2020-04-13 12:00:00+02:00,308,33,275,20.24805474367896,323,33,290,19.17862862818099,16,1013,0.7,5
2020-04-13 13:00:00+02:00,325,34,291,19.331050121665143,320,39,281,21.04137400974582,16,1013,0.7,5
2020-04-13 14:00:00+02:00,325,34,291,19.331050121665143,320,39,281,21.04137400974582,16,1013,0.7,5
2020-04-13 15:00:00+02:00,357,38,319,21.912097396672888,360,36,324,23.455775768432638,16,1013,0.7,5
2020-04-13 16:00:00+02:00,375,41,334,22.64494297948435,377,39,338,16.83689607567409,16,1013,0.7,5
2020-04-13 17:00:00+02:00,555,54,501,17.57269749774077,545,63,482,19.63111833719715,16,1013,0.7,5
2020-04-13 18:00:00+02:00,537,50,487,17.709537334724534,577,57,520,23.103874122084292,16,1013,0.7,5
2020-04-13 19:00:00+02:00,402,42,360,17.230856788696144,409,48,361,21.723119645649348,16,1013,0.7,5
2020-04-13 20:00:00+02:00,394,43,351,21.238013248853637,412,44,368,21.450154879298072,16,1013,0.7,5
2020-04-13 21:00:00+02:00,301,29,272,16.897732473063776,310,31,279,16.921651532922695,16,1013,0.7,5
2020-04-13 22:00:00+02:00,219,21,198,21.009686825041197,219,20,199,21.009686825041197,16,1013,0.7,5
2020-04-13 23:00:00+02:00,155,13,142,19.469409355748308,155,19,136,19.469409355748308,16,1013,0.7,5
2020-04-14 00:00:00+02:00,34,3,31,5.3950651883530085,40,4,36,5.275608835029151,9,1025,0.0,23
2020-04-14 01:00:00+02:00,25,2,23,1.1875344360364632,27,2,25,1.9016023008994223,9,1025,0.0,23
2020-04-14 02:00:00+02:00,25,2,23,1.1875344360364632,27,2,25,1.9016023008994223,9,1025,0.0,23
2020-04-14 03:00:00+02:00,38,3,35,11.101073107969722,40,4,36,5.275608835029151,9,1025,0.0,23
2020-04-14 04:00:00+02:00,62,5,57,14.48690450543278,62,5,57,14.48690450543278,9,1025,0.0,23
2020-04-14 05:00:00+02:00,101,8,93,11.280950715811313,121,12,109,20.317620945183666,9,1025,0.0,23
2020-04-14 06:00:00+02:00,138,11,127,20.21600799483387,138,14,124,20.21600799483387,9,1025,0.0,23
2020-04-14 07:00:00+02:00,192,17,175,21.295822766447603,225,21,204,17.07968654570721,9,1025,0.0,23
2020-04-14 08:00:00+02:00,218,18,200,22.57742359713229,242,27,215,20.990360069331732,9,1025,0.0,23
2020-04-14 09:00:00+02:00,142,13,129,21.623487252479663,164,16,148,22.827361263214527,9,1025,0.0,23
2020-04-14 10:00:00+02:00,129,10,119,17.995114557081255,131,11,120,14.183230975852695,9,1025,0.0,23
2020-04-14 11:00:00+02:00,142,11,131,21.623487252479663,164,16,148,22.827361263214527,9,1025,0.0,23
2020-04-14 12:00:00+02:00,129,10,119,17.995114557081255,131,11,120,14.183230975852695,9,1025,0.0,23
2020-04-14 13:00:00+02:00,119,9,110,22.46945513312648,129,12,117,17.995114557081255,9,1025,0.0,23
2020-04-14 14:00:00+02:00,119,9,110,22.46945513312648,129,12,117,17.995114557081255,9,1025,0.0,23
2020-04-14 15:00:00+02:00,130,10,120,15.65660051079879,144,12,132,22.91915418498221,9,1025,0.0,23
2020-04-14 16:00:00+02:00,139,13,126,18.732486269107348,150,15,135,17.939622434692456,9,1025,0.0,23
2020-04-14 17:00:00+02:00,209,17,192,22.16757043059366,224,19,205,16.30248157536985,9,1025,0.0,23
2020-04-14 18:00:00+02:00,213,17,196,20.488166305452438,246,24,222,17.57126233227549,9,1025,0.0,23
2020-04-14 19:00:00+02:00,153,14,139,14.915022999208679,172,15,157,19.644113972447897,9,1025,0.0,23
2020-04-14 20:00:00+02:00,155,15,140,19.469409355748308,165,18,147,20.56038540292619,9,1025,0.0,23
2020-04-14 21:00:00+02:00,119,11,108,22.46945513312648,129,12,117,17.995114557081255,9,1025,0.0,23
2020-04-14 22:00:00+02:00,83,6,77,18.699193296190067,90,9,81,13.960700117154147,9,1025,0.0,23
2020-04-14 23:00:00+02:00,58,4,54,10.505136369992313,67,7,60,12.5039951599288,9,1025,0.0,23
2020-04-15 00:00:00+02:00,66,8,58,8.66087158766172,65,7,58,10.373259911317103,13,1024,0.0,16
2020-04-15 01:00:00+02:00,44,4,40,8.948844291148367,42,4,38,9.591613610307915,13,1024,0.0,16
2020-04-15 02:00:00+02:00,44,5,39,8.948844291148367,42,4,38,9.591613610307915,13,1024,0.0,16
2020-04-15 03:00:00+02:00,66,7,59,8.66087158766172,65,7,58,10.373259911317103,13,1024,0.0,16
2020-04-15 04:00:00+02:00,112,12,100,16.537505199847164,107,13,94,14.004294924356088,13,1024,0.0,16
2020-04-15 05:00:00+02:00,200,26,174,20.806596333484702,197,23,174,16.840472953316162,13,1024,0.0,16
2020-04-15 06:00:00+02:00,245,29,216,21.661045851911695,229,25,204,20.440115346834332,13,1024,0.0,16
2020-04-15 07:00:00+02:00,375,49,326,18.630225331336334,338,42,296,25.380150029874855,13,1024,0.0,16
2020-04-15 08:00:00+02:00,398,45,353,17.528461730035602,407,49,358,18.525230961716417,13,1024,0.0,16
2020-04-15 09:00:00+02:00,264,33,231,19.326928751905097,241,24,217,22.882071172466965,13,1024,0.0,16
2020-04-15 10:00:00+02:00,220,27,193,18.729640796362187,218,24,194,22.73300845004657,13,1024,0.0,16
2020-04-15 11:00:00+02:00,264,35,229,19.326928751905097,241,24,217,22.882071172466965,13,1024,0.0,16
2020-04-15 12:00:00+02:00,220,27,193,18.729640796362187,218,24,194,22.73300845004657,13,1024,0.0,16
2020-04-15 13:00:00+02:00,220,29,191,18.729640796362187,218,24,194,22.73300845004657,13,1024,0.0,16
2020-04-15 14:00:00+02:00,220,29,191,18.729640796362187,218,24,194,22.73300845004657,13,1024,0.0,16
2020-04-15 15:00:00+02:00,241,32,209,22.882071172466965,222,24,198,23.940731731626443,13,1024,0.0,16
2020-04-15 16:00:00+02:00,269,33,236,18.12289110818214,260,32,228,23.629514257400476,13,1024,0.0,16
2020-04-15 17:00:00+02:00,380,46,334,21.43528591263335,356,37,319,15.115185640587857,13,1024,0.0,16
2020-04-15 18:00:00+02:00,400,54,346,24.218092797619367,378,40,338,19.72856450330425,13,1024,0.0,16
2020-04-15 19:00:00+02:00,287,34,253,21.022527027479835,273,27,246,26.59294853191911,13,1024,0.0,16
2020-04-15 20:00:00+02:00,294,36,258,24.118136039782872,271,27,244,21.366756148139427,13,1024,0.0,16
2020-04-15 21:00:00+02:00,225,27,198,24.523176463388204,215,26,189,19.111985716553264,13,1024,0.0,16
2020-04-15 22:00:00+02:00,155,19,136,20.64602175207135,156,17,139,25.60353225427304,13,1024,0.0,16
2020-04-15 23:00:00+02:00,111,13,98,14.865011441200156,107,13,94,14.004294924356088,13,1024,0.0,16
2020-04-16 00:00:00+02:00,243,16,227,18.936896488437778,234,28,206,19.754580108435302,18,1018,0.0,8
2020-04-16 01:00:00+02:00,144,9,135,22.91915418498221,154,19,135,23.457384968254527,18,1018,0.0,8
2020-04-16 02:00:00+02:00,144,10,134,22.91915418498221,154,19,135,23.457384968254527,18,1018,0.0,8
2020-04-16 03:00:00+02:00,215,15,200,23.830284677030114,243,31,212,18.936896488437778,18,1018,0.0,8
2020-04-16 04:00:00+02:00,382,26,356,19.255057171585772,385,49,336,23.62167138094536,18,1018,0.0,8
2020-04-16 05:00:00+02:00,718,44,674,20.275643080512808,715,71,644,24.714514015464268,18,1018,0.0,8
2020-04-16 06:00:00+02:00,804,57,747,21.607637868650773,866,105,761,21.671956407237744,18,1018,0.0,8
2020-04-16 07:00:00+02:00,1371,93,1278,26.191664168422527,1344,165,1179,29.263004845931782,18,1018,0.0,8
2020-04-16 08:00:00+02:00,1310,80,1230,21.89340036796216,1489,168,1321,17.79667103217417,18,1018,0.0,8
2020-04-16 09:00:00+02:00,955,57,898,20.539635785693793,921,112,809,22.555607901844795,18,1018,0.0,8
2020-04-16 10:00:00+02:00,767,55,712,18.22280569593287,764,98,666,26.163227189245884,18,1018,0.0,8
2020-04-16 11:00:00+02:00,958,67,891,19.15346532293557,921,112,809,22.555607901844795,18,1018,0.0,8
2020-04-16 12:00:00+02:00,767,55,712,18.22280569593287,764,98,666,26.163227189245884,18,1018,0.0,8
2020-04-16 13:00:00+02:00,798,56,742,21.901691075721356,776,76,700,20.16450692078572,18,1018,0.0,8
2020-04-16 14:00:00+02:00,715,44,671,24.714514015464268,767,97,670,18.22280569593287,18,1018,0.0,8
2020-04-16 15:00:00+02:00,792,57,735,24.002822951179763,897,105,792,13.339843441511245,18,1018,0.0,8
2020-04-16 16:00:00+02:00,869,62,807,16.817772040585538,986,109,877,18.105683797551546,18,1018,0.0,8
2020-04-16 17:00:00+02:00,1319,94,1225,23.85154708813739,1402,162,1240,22.516514362217915,18,1018,0.0,8
2020-04-16 18:00:00+02:00,1291,83,1208,15.54478992717997,1442,185,1257,24.542604369545202,18,1018,0.0,8
2020-04-16 19:00:00+02:00,1017,71,946,15.537362908944555,1072,134,938,19.703130686025048,18,1018,0.0,8
2020-04-16 20:00:00+02:00,1029,74,955,23.166364229688753,1017,109,908,15.537362908944555,18,1018,0.0,8
2020-04-16 21:00:00+02:00,832,51,781,21.837109952376025,817,99,718,19.725478578125138,18,1018,0.0,8
2020-04-16 22:00:00+02:00,542,34,508,18.696090470502615,561,55,506,19.266161028294455,18,1018,0.0,8
2020-04-16 23:00:00+02:00,385,24,361,23.62167138094536,410,47,363,20.532450928302634,18,1018,0.0,8
2020-04-17 00:00:00+02:00,268,23,245,16.114987230113258,264,19,245,20.665980174270672,19,1016,0.1,4
2020-04-17 01:00:00+02:00,177,13,164,20.028957588616944,184,14,170,20.655558446800804,19,1016,0.1,4
2020-04-17 02:00:00+02:00,177,12,165,20.028957588616944,184,14,170,20.655558446800804,19,1016,0.1,4
2020-04-17 03:00:00+02:00,268,19,249,16.114987230113258,264,19,245,20.665980174270672,19,1016,0.1,4
2020-04-17 04:00:00+02:00,449,33,416,18.601165629732545,439,35,404,18.965638166337634,19,1016,0.1,4
2020-04-17 05:00:00+02:00,794,57,737,21.034097759158378,836,67,769,21.975494772407213,19,1016,0.1,4
2020-04-17 06:00:00+02:00,993,77,916,26.634563598746347,972,84,888,18.51800523035567,19,1016,0.1,4
2020-04-17 07:00:00+02:00,1516,112,1404,14.536565347890463,1579,112,1467,24.005962427689305,19,1016,0.1,4
2020-04-17 08:00:00+02:00,1673,135,1538,21.18148165102872,1607,126,1481,24.187067838092315,19,1016,0.1,4
2020-04-17 09:00:00+02:00,1115,82,1033,21.64260854806507,1091,96,995,22.614634389934974,19,1016,0.1,4
2020-04-17 10:00:00+02:00,902,78,824,23.54203327885049,909,67,842,16.22614210101317,19,1016,0.1,4
2020-04-17 11:00:00+02:00,1091,85,1006,22.614634389934974,1070,97,973,21.082010363695602,19,1016,0.1,4
2020-04-17 12:00:00+02:00,909,78,831,16.22614210101317,902,69,833,23.54203327885049,19,1016,0.1,4
2020-04-17 13:00:00+02:00,909,69,840,16.22614210101317,902,69,833,23.54203327885049,19,1016,0.1,4
2020-04-17 14:00:00+02:00,909,69,840,16.22614210101317,902,69,833,23.54203327885049,19,1016,0.1,4
2020-04-17 15:00:00+02:00,1004,76,928,24.012923051124588,983,68,915,23.614713777448785,19,1016,0.1,4
2020-04-17 16:00:00+02:00,1108,84,1024,18.527702459693625,1084,83,1001,22.775468480720445,19,1016,0.1,4
2020-04-17 17:00:00+02:00,1572,123,1449,17.678837730739687,1603,130,1473,21.068324996153297,19,1016,0.1,4
2020-04-17 18:00:00+02:00,1683,147,1536,24.451734471728432,1673,120,1553,21.18148165102872,19,1016,0.1,4
2020-04-17 19:00:00+02:00,1220,100,1120,21.61107219660081,1129,102,1027,21.098436571025903,19,1016,0.1,4
2020-04-17 20:00:00+02:00,1206,99,1107,21.39194938487086,1202,100,1102,13.943128272482273,19,1016,0.1,4
2020-04-17 21:00:00+02:00,941,77,864,14.09335980286241,913,76,837,15.388244950924985,19,1016,0.1,4
2020-04-17 22:00:00+02:00,631,55,576,19.637448203371804,599,40,559,22.66737383874895,19,1016,0.1,4
2020-04-17 23:00:00+02:00,467,38,429,22.874976747697783,435,30,405,21.80027200191571,19,1016,0.1,4
2020-04-18 00:00:00+02:00,77,3,74,11.693765322784895,83,3,80,9.333357558089729,19,1014,5.7,12
2020-04-18 01:00:00+02:00,54,2,52,11.483713237443984,54,2,52,11.483713237443984,19,1014,5.7,12
2020-04-18 02:00:00+02:00,51,2,49,13.024781207847502,55,2,53,10.027044718132117,19,1014,5.7,12
2020-04-18 03:00:00+02:00,76,3,73,13.279950485691732,83,4,79,9.333357558089729,19,1014,5.7,12
2020-04-18 04:00:00+02:00,108,5,103,15.795702759121413,109,5,104,18.214376818550008,19,1014,5.7,12
2020-04-18 05:00:00+02:00,132,6,126,15.82621260035259,139,5,134,19.408576933840735,19,1014,5.7,12
2020-04-18 06:00:00+02:00,216,11,205,17.62117954457743,217,10,207,18.791759657796693,19,1014,5.7,12
2020-04-18 07:00:00+02:00,324,14,310,18.672846971084997,334,14,320,17.139636433234756,19,1014,5.7,12
2020-04-18 08:00:00+02:00,421,18,403,23.577567366465193,437,18,419,20.40675859398746,19,1014,5.7,12
2020-04-18 09:00:00+02:00,450,21,429,15.953303206406003,471,24,447,21.514046870792356,19,1014,5.7,12
2020-04-18 10:00:00+02:00,396,18,378,19.03159851440849,416,17,399,20.665581485173448,19,1014,5.7,12
2020-04-18 11:00:00+02:00,324,17,307,18.672846971084997,334,14,320,17.139636433234756,19,1014,5.7,12
2020-04-18 12:00:00+02:00,316,14,302,17.068110656006358,332,17,315,20.862138293674573,19,1014,5.7,12
2020-04-18 13:00:00+02:00,344,16,328,19.49330876116528,355,16,339,19.867707600873487,19,1014,5.7,12
2020-04-18 14:00:00+02:00,318,16,302,22.522150292755875,332,17,315,20.862138293674573,19,1014,5.7,12
2020-04-18 15:00:00+02:00,371,18,353,18.297011572558848,387,17,370,20.68470776467254,19,1014,5.7,12
2020-04-18 16:00:00+02:00,376,19,357,20.486350839145686,390,18,372,22.823808870670177,19,1014,5.7,12
2020-04-18 17:00:00+02:00,411,20,391,17.61880175865933,441,22,419,18.66415998446817,19,1014,5.7,12
2020-04-18 18:00:00+02:00,386,19,367,22.495942580430874,412,18,394,17.611789385078108,19,1014,5.7,12
2020-04-18 19:00:00+02:00,314,17,297,19.77016372636934,335,16,319,21.63506552863301,19,1014,5.7,12
2020-04-18 20:00:00+02:00,291,14,277,14.14711867692869,304,15,289,24.382586098170826,19,1014,5.7,12
2020-04-18 21:00:00+02:00,256,13,243,19.922633354103812,277,14,263,19.768862676933345,19,1014,5.7,12
2020-04-18 22:00:00+02:00,208,9,199,18.807092053665322,220,11,209,20.77869221062603,19,1014,5.7,12
2020-04-18 23:00:00+02:00,101,4,97,14.022694861996197,111,5,106,16.60196152330297,19,1014,5.7,12
2020-04-19 00:00:00+02:00,129,4,125,12.81298343964759,158,4,154,19.40470350916573,18,1017,0.0,10
2020-04-19 01:00:00+02:00,89,2,87,10.527801976587284,89,2,87,10.527801976587284,18,1017,0.0,10
2020-04-19 02:00:00+02:00,80,2,78,12.9514806028411,112,3,109,19.016823421759323,18,1017,0.0,10
2020-04-19 03:00:00+02:00,129,4,125,12.81298343964759,158,4,154,19.40470350916573,18,1017,0.0,10
2020-04-19 04:00:00+02:00,178,5,173,18.00585359354758,178,4,174,18.00585359354758,18,1017,0.0,10
2020-04-19 05:00:00+02:00,201,5,196,21.060930109433922,259,6,253,22.975221531884507,18,1017,0.0,10
2020-04-19 06:00:00+02:00,354,11,343,22.475031570210557,469,13,456,17.241075976543623,18,1017,0.0,10
2020-04-19 07:00:00+02:00,504,16,488,18.186363959256344,533,16,517,18.204577838335723,18,1017,0.0,10
2020-04-19 08:00:00+02:00,717,23,694,14.645847754944892,913,27,886,19.819954080226285,18,1017,0.0,10
2020-04-19 09:00:00+02:00,757,25,732,23.979959928500918,887,29,858,18.1980613183627,18,1017,0.0,10
2020-04-19 10:00:00+02:00,611,20,591,20.09744642918199,781,25,756,18.849219637300322,18,1017,0.0,10
2020-04-19 11:00:00+02:00,530,16,514,19.266675842235646,657,18,639,18.41823661952385,18,1017,0.0,10
2020-04-19 12:00:00+02:00,530,17,513,19.266675842235646,657,18,639,18.41823661952385,18,1017,0.0,10
2020-04-19 13:00:00+02:00,573,18,555,20.236010926878542,642,17,625,21.972910755183353,18,1017,0.0,10
2020-04-19 14:00:00+02:00,492,14,478,23.51531207195642,668,18,650,14.894863684358564,18,1017,0.0,10
2020-04-19 15:00:00+02:00,599,20,579,13.487647988809618,809,24,785,21.107922107899956,18,1017,0.0,10
2020-04-19 16:00:00+02:00,613,19,594,17.497047599626537,671,20,651,19.7199914355923,18,1017,0.0,10
2020-04-19 17:00:00+02:00,714,21,693,18.82580238349392,913,27,886,19.819954080226285,18,1017,0.0,10
2020-04-19 18:00:00+02:00,668,22,646,14.894863684358564,798,27,771,19.836593484092674,18,1017,0.0,10
2020-04-19 19:00:00+02:00,536,17,519,13.147585514482932,616,16,600,20.64561882033615,18,1017,0.0,10
2020-04-19 20:00:00+02:00,489,14,475,20.73788413871882,662,23,639,21.573583600756407,18,1017,0.0,10
2020-04-19 21:00:00+02:00,438,13,425,18.033066079167238,469,14,455,17.241075976543623,18,1017,0.0,10
2020-04-19 22:00:00+02:00,337,10,327,20.189680789887703,409,11,398,21.901781937406163,18,1017,0.0,10
2020-04-19 23:00:00+02:00,170,5,165,18.89757152881458,204,7,197,20.27930898180519,18,1017,0.0,10
2020-04-20 00:00:00+02:00,146,11,135,20.98788244482569,146,13,133,20.98788244482569,15,1013,0.0,18
2020-04-20 01:00:00+02:00,96,6,90,11.83328593996439,91,8,83,13.154481673544206,15,1013,0.0,18
2020-04-20 02:00:00+02:00,91,6,85,13.154481673544206,96,9,87,11.83328593996439,15,1013,0.0,18
2020-04-20 03:00:00+02:00,135,11,124,21.280002906629502,146,11,135,20.98788244482569,15,1013,0.0,18
2020-04-20 04:00:00+02:00,241,17,224,21.076687701702674,244,20,224,17.108671526861457,15,1013,0.0,18
2020-04-20 05:00:00+02:00,421,34,387,22.41212221732918,430,37,393,19.32256414396262,15,1013,0.0,18
2020-04-20 06:00:00+02:00,509,37,472,12.20192288247499,539,41,498,14.75171382469777,15,1013,0.0,18
2020-04-20 07:00:00+02:00,819,65,754,23.568150525298396,823,73,750,17.202808811289078,15,1013,0.0,18
2020-04-20 08:00:00+02:00,835,65,770,20.372323083489245,849,73,776,23.73991393289528,15,1013,0.0,18
2020-04-20 09:00:00+02:00,588,46,542,15.545784204606317,586,46,540,18.247067316767854,15,1013,0.0,18
2020-04-20 10:00:00+02:00,458,37,421,24.591159780297854,482,47,435,19.903175971447034,15,1013,0.0,18
2020-04-20 11:00:00+02:00,581,43,538,20.147223383764217,590,48,542,24.741329330337763,15,1013,0.0,18
2020-04-20 12:00:00+02:00,458,37,421,24.591159780297854,482,47,435,19.903175971447034,15,1013,0.0,18
2020-04-20 13:00:00+02:00,484,36,448,17.863314460235074,481,38,443,25.78446993067148,15,1013,0.0,18
2020-04-20 14:00:00+02:00,484,36,448,17.863314460235074,481,38,443,25.78446993067148,15,1013,0.0,18
2020-04-20 15:00:00+02:00,534,40,494,22.13831863455401,514,45,469,17.018673574730677,15,1013,0.0,18
2020-04-20 16:00:00+02:00,562,46,516,17.57000312304836,590,53,537,24.741329330337763,15,1013,0.0,18
2020-04-20 17:00:00+02:00,778,63,715,17.086438590718235,801,77,724,23.10339814621197,15,1013,0.0,18
2020-04-20 18:00:00+02:00,810,68,742,22.708324160653998,833,76,757,17.006735714661623,15,1013,0.0,18
2020-04-20 19:00:00+02:00,606,47,559,24.38243055199842,639,60,579,21.888977134041827,15,1013,0.0,18
2020-04-20 20:00:00+02:00,599,46,553,22.66737383874895,636,59,577,21.66562740120439,15,1013,0.0,18
2020-04-20 21:00:00+02:00,470,40,430,21.98902238846196,474,41,433,24.663345069259766,15,1013,0.0,18
2020-04-20 22:00:00+02:00,327,25,302,17.492932564197055,341,34,307,14.480776847696712,15,1013,0.0,18
2020-04-20 23:00:00+02:00,239,17,222,13.74553452780325,241,24,217,21.076687701702674,15,1013,0.0,18
2020-04-21 00:00:00+02:00,126,8,118,21.990298593101397,123,10,113,19.074654696202938,15,1011,0.0,20
2020-04-21 01:00:00+02:00,76,5,71,16.686685835236233,84,7,77,14.398269762880606,15,1011,0.0,20
2020-04-21 02:00:00+02:00,84,6,78,14.398269762880606,88,7,81,17.756927742208592,15,1011,0.0,20
2020-04-21 03:00:00+02:00,126,9,117,21.990298593101397,123,10,113,19.074654696202938,15,1011,0.0,20
2020-04-21 04:00:00+02:00,193,14,179,21.558071117560736,216,16,200,21.273439412003903,15,1011,0.0,20
2020-04-21 05:00:00+02:00,358,28,330,18.044939279580262,380,32,348,15.070197513038655,15,1011,0.0,20
2020-04-21 06:00:00+02:00,413,32,381,24.398754434847095,455,35,420,18.957107089369835,15,1011,0.0,20
2020-04-21 07:00:00+02:00,713,48,665,21.970165024978442,708,62,646,23.057413052758587,15,1011,0.0,20
2020-04-21 08:00:00+02:00,674,46,628,19.944091763626055,803,66,737,22.17490533017417,15,1011,0.0,20
2020-04-21 09:00:00+02:00,499,37,462,21.95846674548548,533,38,495,22.139738081927035,15,1011,0.0,20
2020-04-21 10:00:00+02:00,404,28,376,21.094548442403457,415,30,385,23.376361640310524,15,1011,0.0,20
2020-04-21 11:00:00+02:00,477,37,440,19.637502490728593,536,42,494,19.543488507279786,15,1011,0.0,20
2020-04-21 12:00:00+02:00,399,29,370,20.89817652151005,426,35,391,20.8097346735364,15,1011,0.0,20
2020-04-21 13:00:00+02:00,376,28,348,15.920759199358614,433,31,402,15.756615810687446,15,1011,0.0,20
2020-04-21 14:00:00+02:00,376,26,350,15.920759199358614,433,31,402,15.756615810687446,15,1011,0.0,20
2020-04-21 15:00:00+02:00,413,29,384,24.398754434847095,455,35,420,18.957107089369835,15,1011,0.0,20
2020-04-21 16:00:00+02:00,502,34,468,11.735836537408174,514,43,471,17.018673574730677,15,1011,0.0,20
2020-04-21 17:00:00+02:00,699,55,644,25.275934758615588,700,49,651,20.872865652778124,15,1011,0.0,20
2020-04-21 18:00:00+02:00,667,44,623,22.082918216313388,766,56,710,25.027999628136882,15,1011,0.0,20
2020-04-21 19:00:00+02:00,549,43,506,18.718889066861195,560,41,519,19.606018509461766,15,1011,0.0,20
2020-04-21 20:00:00+02:00,502,35,467,11.735836537408174,558,47,511,21.887504875695765,15,1011,0.0,20
2020-04-21 21:00:00+02:00,416,27,389,17.117872401421668,413,32,381,24.398754434847095,15,1011,0.0,20
2020-04-21 22:00:00+02:00,288,21,267,22.858888837585067,313,21,292,23.332837891570005,15,1011,0.0,20
2020-04-21 23:00:00+02:00,193,12,181,21.558071117560736,216,16,200,21.273439412003903,15,1011,0.0,20
2020-04-22 00:00:00+02:00,141,15,126,16.082921323202,130,10,120,18.726979359073987,16,1013,0.0,19
2020-04-22 01:00:00+02:00,93,9,84,19.729575953685952,95,8,87,17.590478556460255,16,1013,0.0,19
2020-04-22 02:00:00+02:00,95,10,85,17.590478556460255,95,9,86,17.590478556460255,16,1013,0.0,19
2020-04-22 03:00:00+02:00,143,15,128,20.96438623620443,134,12,122,19.23518886649871,16,1013,0.0,19
2020-04-22 04:00:00+02:00,231,22,209,18.00711943545906,208,19,189,20.206401668793205,16,1013,0.0,19
2020-04-22 05:00:00+02:00,418,40,378,18.499784205499356,418,39,379,18.499784205499356,16,1013,0.0,19
2020-04-22 06:00:00+02:00,523,54,469,19.232400876414125,510,51,459,18.942458099303334,16,1013,0.0,19
2020-04-22 07:00:00+02:00,807,82,725,19.482572079647852,730,55,675,25.442771050333448,16,1013,0.0,19
2020-04-22 08:00:00+02:00,853,84,769,22.20545790631648,859,78,781,19.314655554509162,16,1013,0.0,19
2020-04-22 09:00:00+02:00,565,50,515,19.535939348866478,516,43,473,19.477342984372644,16,1013,0.0,19
2020-04-22 10:00:00+02:00,477,45,432,20.74628437555386,427,33,394,20.04761786859743,16,1013,0.0,19
2020-04-22 11:00:00+02:00,563,61,502,22.589818073805013,533,46,487,16.489207387178066,16,1013,0.0,19
2020-04-22 12:00:00+02:00,477,43,434,20.74628437555386,427,33,394,20.04761786859743,16,1013,0.0,19
2020-04-22 13:00:00+02:00,470,51,419,23.537297655736996,468,44,424,20.750300610230987,16,1013,0.0,19
2020-04-22 14:00:00+02:00,473,45,428,16.817858484085946,464,36,428,11.70672666270294,16,1013,0.0,19
2020-04-22 15:00:00+02:00,521,56,465,19.159809424934927,510,51,459,18.942458099303334,16,1013,0.0,19
2020-04-22 16:00:00+02:00,569,57,512,21.5152841392816,521,44,477,19.159809424934927,16,1013,0.0,19
2020-04-22 17:00:00+02:00,807,88,719,19.482572079647852,730,55,675,25.442771050333448,16,1013,0.0,19
2020-04-22 18:00:00+02:00,853,84,769,22.20545790631648,859,78,781,19.314655554509162,16,1013,0.0,19
2020-04-22 19:00:00+02:00,613,55,558,18.98973058101067,546,48,498,23.163613366507786,16,1013,0.0,19
2020-04-22 20:00:00+02:00,613,56,557,18.98973058101067,546,48,498,23.163613366507786,16,1013,0.0,19
2020-04-22 21:00:00+02:00,471,43,428,19.847986208788534,464,36,428,11.70672666270294,16,1013,0.0,19
2020-04-22 22:00:00+02:00,332,35,297,19.089795695646295,330,33,297,22.0130860795424,16,1013,0.0,19
2020-04-22 23:00:00+02:00,238,26,212,26.357922750399336,235,23,212,18.630545719736677,16,1013,0.0,19
2020-04-23 00:00:00+02:00,260,16,244,21.14564444182058,250,31,219,14.642007731534619,21,1017,0.0,9
2020-04-23 01:00:00+02:00,164,11,153,22.827361263214527,164,17,147,22.827361263214527,21,1017,0.0,9
2020-04-23 02:00:00+02:00,155,10,145,19.469409355748308,161,20,141,19.983041252146048,21,1017,0.0,9
2020-04-23 03:00:00+02:00,224,13,211,16.30248157536985,253,24,229,24.084070139549794,21,1017,0.0,9
2020-04-23 04:00:00+02:00,415,28,387,23.376361640310524,432,54,378,18.473076954520703,21,1017,0.0,9
2020-04-23 05:00:00+02:00,702,46,656,17.538529369117686,781,93,688,21.0241020485366,21,1017,0.0,9
2020-04-23 06:00:00+02:00,900,62,838,18.281455764020304,946,100,846,18.982808272150088,21,1017,0.0,9
2020-04-23 07:00:00+02:00,1315,86,1229,12.201444551903807,1404,164,1240,21.989467089679458,21,1017,0.0,9
2020-04-23 08:00:00+02:00,1381,89,1292,20.166227716381844,1484,153,1331,22.56379397230916,21,1017,0.0,9
2020-04-23 09:00:00+02:00,986,67,919,18.105683797551546,1015,128,887,21.650236474626826,21,1017,0.0,9
2020-04-23 10:00:00+02:00,864,53,811,24.209267295838718,883,114,769,21.71548520064973,21,1017,0.0,9
2020-04-23 11:00:00+02:00,910,59,851,22.029259811173716,989,116,873,24.032627358494853,21,1017,0.0,9
2020-04-23 12:00:00+02:00,807,56,751,20.873467374868373,817,103,714,19.725478578125138,21,1017,0.0,9
2020-04-23 13:00:00+02:00,827,52,775,23.921163219726846,883,113,770,21.71548520064973,21,1017,0.0,9
2020-04-23 14:00:00+02:00,758,49,709,22.232044845919173,873,98,775,27.880668244208938,21,1017,0.0,9
2020-04-23 15:00:00+02:00,873,55,818,27.880668244208938,913,96,817,15.388244950924985,21,1017,0.0,9
2020-04-23 16:00:00+02:00,995,72,923,19.05470158517254,1025,129,896,11.976122264921507,21,1017,0.0,9
2020-04-23 17:00:00+02:00,1362,95,1267,15.513700961999985,1431,174,1257,18.941747158008383,21,1017,0.0,9
2020-04-23 18:00:00+02:00,1586,115,1471,19.502628903734546,1566,184,1382,22.656039221067736,21,1017,0.0,9
2020-04-23 19:00:00+02:00,1147,74,1073,17.056273962656327,1150,147,1003,26.87092182669306,21,1017,0.0,9
2020-04-23 20:00:00+02:00,1104,78,1026,20.236267897544444,1055,124,931,21.575595690912497,21,1017,0.0,9
2020-04-23 21:00:00+02:00,844,53,791,19.50123206290508,860,98,762,20.630248434592975,21,1017,0.0,9
2020-04-23 22:00:00+02:00,580,38,542,24.24750544028644,587,72,515,20.028899672241884,21,1017,0.0,9
2020-04-23 23:00:00+02:00,435,29,406,21.80027200191571,415,47,368,23.376361640310524,21,1017,0.0,9
2020-04-24 00:00:00+02:00,304,26,278,22.339067945756394,292,26,266,18.509650933155072,22,1017,0.0,4
2020-04-24 01:00:00+02:00,199,16,183,21.764655927821806,206,14,192,22.241507594869486,22,1017,0.0,4
2020-04-24 02:00:00+02:00,195,15,180,23.83440770251287,206,14,192,22.241507594869486,22,1017,0.0,4
2020-04-24 03:00:00+02:00,296,23,273,20.454116986907042,308,24,284,20.24805474367896,22,1017,0.0,4
2020-04-24 04:00:00+02:00,519,39,480,18.136209473828288,511,43,468,22.27774281923901,22,1017,0.0,4
2020-04-24 05:00:00+02:00,944,68,876,16.930081638691814,870,68,802,21.08765866587288,22,1017,0.0,4
2020-04-24 06:00:00+02:00,1135,89,1046,20.000586413935558,1124,87,1037,25.74434919243855,22,1017,0.0,4
2020-04-24 07:00:00+02:00,1682,135,1547,23.190804916806506,1690,117,1573,20.129991832831198,22,1017,0.0,4
2020-04-24 08:00:00+02:00,1783,130,1653,19.37600371542589,1775,148,1627,25.681621239678265,22,1017,0.0,4
2020-04-24 09:00:00+02:00,1194,99,1095,22.850349364469974,1178,91,1087,23.729777527432024,22,1017,0.0,4
2020-04-24 10:00:00+02:00,991,76,915,29.40963784487163,1046,94,952,25.216776344373386,22,1017,0.0,4
2020-04-24 11:00:00+02:00,1252,102,1150,16.67724694524948,1249,106,1143,24.22980832737812,22,1017,0.0,4
2020-04-24 12:00:00+02:00,1003,78,925,22.362259366128942,999,69,930,20.76575231505416,22,1017,0.0,4
2020-04-24 13:00:00+02:00,1042,80,962,20.902134839283526,1007,78,929,21.476527208055813,22,1017,0.0,4
2020-04-24 14:00:00+02:00,995,75,920,19.05470158517254,1010,89,921,13.04378527338052,22,1017,0.0,4
2020-04-24 15:00:00+02:00,1155,99,1056,23.598323364142068,1096,98,998,21.88737025121773,22,1017,0.0,4
2020-04-24 16:00:00+02:00,1241,96,1145,23.437408627937337,1213,101,1112,18.348727324994908,22,1017,0.0,4
2020-04-24 17:00:00+02:00,1697,126,1571,21.92187213287153,1690,154,1536,20.129991832831198,22,1017,0.0,4
2020-04-24 18:00:00+02:00,1783,130,1653,19.37600371542589,1775,148,1627,25.681621239678265,22,1017,0.0,4
2020-04-24 19:00:00+02:00,1291,107,1184,15.54478992717997,1319,119,1200,23.85154708813739,22,1017,0.0,4
2020-04-24 20:00:00+02:00,1342,108,1234,19.29955187785579,1264,89,1175,23.950520912634502,22,1017,0.0,4
2020-04-24 21:00:00+02:00,1034,75,959,26.219059645421154,991,74,917,29.40963784487163,22,1017,0.0,4
2020-04-24 22:00:00+02:00,722,62,660,18.234239016269186,733,58,675,24.172082306056087,22,1017,0.0,4
2020-04-24 23:00:00+02:00,523,44,479,16.192550011919526,499,44,455,21.95846674548548,22,1017,0.0,4
2020-04-25 00:00:00+02:00,206,10,196,20.90053052788098,211,10,201,15.949558582123627,18,1013,0.1,12
2020-04-25 01:00:00+02:00,131,6,125,17.703689985975256,139,6,133,19.408576933840735,18,1013,0.1,12
2020-04-25 02:00:00+02:00,139,7,132,19.408576933840735,141,7,134,17.007652233540448,18,1013,0.1,12
2020-04-25 03:00:00+02:00,206,10,196,20.90053052788098,211,10,201,15.949558582123627,18,1013,0.1,12
2020-04-25 04:00:00+02:00,262,12,250,13.900090096773878,281,11,270,18.053311879599764,18,1013,0.1,12
2020-04-25 05:00:00+02:00,327,17,310,19.796623391570257,358,15,343,16.774588466913123,18,1013,0.1,12
2020-04-25 06:00:00+02:00,533,29,504,18.204577838335723,574,27,547,14.666429953470098,18,1013,0.1,12
2020-04-25 07:00:00+02:00,804,43,761,23.917469151531613,858,44,814,16.14481855828614,18,1013,0.1,12
2020-04-25 08:00:00+02:00,1095,60,1035,20.455527014772745,1118,54,1064,19.880251422880846,18,1013,0.1,12
2020-04-25 09:00:00+02:00,1185,60,1125,16.150652334655096,1188,55,1133,21.92580287253377,18,1013,0.1,12
2020-04-25 10:00:00+02:00,1039,49,990,22.22298154454294,1046,53,993,20.15056804866435,18,1013,0.1,12
2020-04-25 11:00:00+02:00,806,38,768,24.686785985329347,837,40,797,22.344019312766623,18,1013,0.1,12
2020-04-25 12:00:00+02:00,817,43,774,16.465327530571592,850,39,811,15.369011089934117,18,1013,0.1,12
2020-04-25 13:00:00+02:00,902,43,859,15.902654725284378,917,48,869,21.32888712831126,18,1013,0.1,12
2020-04-25 14:00:00+02:00,812,39,773,15.689646848811535,850,39,811,15.369011089934117,18,1013,0.1,12
2020-04-25 15:00:00+02:00,971,46,925,15.265912760392823,982,41,941,20.66561614858334,18,1013,0.1,12
2020-04-25 16:00:00+02:00,956,51,905,20.2411253532615,995,51,944,22.508966125543704,18,1013,0.1,12
2020-04-25 17:00:00+02:00,1108,52,1056,17.28871214935311,1124,47,1077,20.051734044528573,18,1013,0.1,12
2020-04-25 18:00:00+02:00,987,48,939,18.508101465977145,1075,48,1027,20.73357190058295,18,1013,0.1,12
2020-04-25 19:00:00+02:00,809,38,771,21.107922107899956,858,40,818,16.14481855828614,18,1013,0.1,12
2020-04-25 20:00:00+02:00,752,41,711,23.063828869178057,778,41,737,23.754924038873337,18,1013,0.1,12
2020-04-25 21:00:00+02:00,690,35,655,24.427983614474908,698,34,664,17.759863122235235,18,1013,0.1,12
2020-04-25 22:00:00+02:00,523,27,496,15.86377141768892,569,25,544,19.424344306636577,18,1013,0.1,12
2020-04-25 23:00:00+02:00,260,13,247,14.992506001947714,283,14,269,18.945435241048195,18,1013,0.1,12
2020-04-26 00:00:00+02:00,110,3,107,20.964248322238312,128,3,125,16.268122259148125,18,1011,0.0,13
2020-04-26 01:00:00+02:00,74,2,72,9.886934519670994,103,3,100,17.210287037863655,18,1011,0.0,13
2020-04-26 02:00:00+02:00,79,2,77,13.473204105951462,79,2,77,13.473204105951462,18,1011,0.0,13
2020-04-26 03:00:00+02:00,108,3,105,15.795702759121413,128,4,124,16.268122259148125,18,1011,0.0,13
2020-04-26 04:00:00+02:00,149,5,144,17.937448228249327,170,5,165,18.89757152881458,18,1011,0.0,13
2020-04-26 05:00:00+02:00,188,6,182,19.664617237016223,221,6,215,21.310706623471727,18,1011,0.0,13
2020-04-26 06:00:00+02:00,288,8,280,15.693687299637316,332,8,324,20.862138293674573,18,1011,0.0,13
2020-04-26 07:00:00+02:00,466,14,452,21.82685485689329,541,16,525,18.81222066269775,18,1011,0.0,13
2020-04-26 08:00:00+02:00,610,20,590,21.74090977767113,654,20,634,17.672629386873176,18,1011,0.0,13
2020-04-26 09:00:00+02:00,674,21,653,18.789264429297337,917,26,891,21.32888712831126,18,1011,0.0,13
2020-04-26 10:00:00+02:00,574,17,557,14.666429953470098,677,23,654,21.53593373202197,18,1011,0.0,13
2020-04-26 11:00:00+02:00,481,14,467,24.07638671243709,579,18,561,18.984539240055984,18,1011,0.0,13
2020-04-26 12:00:00+02:00,461,14,447,21.59648486572868,589,17,572,8.723723696629444,18,1011,0.0,13
2020-04-26 13:00:00+02:00,492,15,477,23.51531207195642,649,18,631,20.34487337835388,18,1011,0.0,13
2020-04-26 14:00:00+02:00,435,15,420,17.70683292278672,502,15,487,16.39928567380866,18,1011,0.0,13
2020-04-26 15:00:00+02:00,559,18,541,16.28017139379397,708,21,687,25.605883478195476,18,1011,0.0,13
2020-04-26 16:00:00+02:00,528,15,513,15.389090213676,685,18,667,20.743347438909645,18,1011,0.0,13
2020-04-26 17:00:00+02:00,579,16,563,18.984539240055984,767,24,743,19.795029542543528,18,1011,0.0,13
2020-04-26 18:00:00+02:00,605,17,588,16.706179884848982,613,19,594,17.497047599626537,18,1011,0.0,13
2020-04-26 19:00:00+02:00,445,14,431,21.520045849832552,602,17,585,17.424831150133677,18,1011,0.0,13
2020-04-26 20:00:00+02:00,432,13,419,19.977965204645113,471,13,458,21.514046870792356,18,1011,0.0,13
2020-04-26 21:00:00+02:00,386,11,375,22.495942580430874,458,13,445,23.935839893982745,18,1011,0.0,13
2020-04-26 22:00:00+02:00,293,8,285,17.329297501722674,334,9,325,17.139636433234756,18,1011,0.0,13
2020-04-26 23:00:00+02:00,152,4,148,18.686880121910534,154,4,150,19.868163821621103,18,1011,0.0,13
2020-04-27 00:00:00+02:00,264,19,245,20.665980174270672,278,22,256,17.988889489265482,19,1010,0.0,5
2020-04-27 01:00:00+02:00,180,14,166,20.970253971133605,187,17,170,20.5323189366488,19,1010,0.0,5
2020-04-27 02:00:00+02:00,177,13,164,20.028957588616944,191,17,174,20.658016380524305,19,1010,0.0,5
2020-04-27 03:00:00+02:00,288,23,265,22.858888837585067,285,22,263,23.62629721954127,19,1010,0.0,5
2020-04-27 04:00:00+02:00,483,41,442,21.366599546374843,462,41,421,18.95008410951899,19,1010,0.0,5
2020-04-27 05:00:00+02:00,810,59,751,22.708324160653998,821,74,747,16.339670302135517,19,1010,0.0,5
2020-04-27 06:00:00+02:00,1068,85,983,18.655979859513685,1023,79,944,21.98131373048716,19,1010,0.0,5
2020-04-27 07:00:00+02:00,1576,120,1456,23.397350986220356,1621,151,1470,20.23291949931915,19,1010,0.0,5
2020-04-27 08:00:00+02:00,1604,118,1486,21.90751728385986,1688,158,1530,19.87680325803267,19,1010,0.0,5
2020-04-27 09:00:00+02:00,1061,77,984,18.550552764358454,1103,92,1011,18.353142391121665,19,1010,0.0,5
2020-04-27 10:00:00+02:00,901,74,827,22.78945543194896,939,77,862,19.315291673680008,19,1010,0.0,5
2020-04-27 11:00:00+02:00,1058,77,981,24.139244092444383,1155,104,1051,23.598323364142068,19,1010,0.0,5
2020-04-27 12:00:00+02:00,918,79,839,20.922410825719005,950,79,871,17.81827084059518,19,1010,0.0,5
2020-04-27 13:00:00+02:00,964,72,892,18.78605866980557,971,91,880,17.52485827025155,19,1010,0.0,5
2020-04-27 14:00:00+02:00,925,76,849,23.033306576068764,946,76,870,18.982808272150088,19,1010,0.0,5
2020-04-27 15:00:00+02:00,985,77,908,21.522944481257788,1026,101,925,16.212449823690427,19,1010,0.0,5
2020-04-27 16:00:00+02:00,1117,83,1034,18.940485450940074,1127,110,1017,21.405421540571112,19,1010,0.0,5
2020-04-27 17:00:00+02:00,1531,119,1412,21.823968998273884,1576,128,1448,23.397350986220356,19,1010,0.0,5
2020-04-27 18:00:00+02:00,1740,143,1597,24.910715352359354,1722,159,1563,25.615814604734805,19,1010,0.0,5
2020-04-27 19:00:00+02:00,1190,103,1087,17.777886359993257,1221,112,1109,24.609627533974752,19,1010,0.0,5
2020-04-27 20:00:00+02:00,1200,104,1096,20.712101125225026,1259,117,1142,21.17549648137175,19,1010,0.0,5
2020-04-27 21:00:00+02:00,908,75,833,19.675855376140884,922,84,838,20.207847827712897,19,1010,0.0,5
2020-04-27 22:00:00+02:00,643,50,593,17.945088215014433,643,62,581,17.945088215014433,19,1010,0.0,5
2020-04-27 23:00:00+02:00,452,38,414,20.424814624877964,476,40,436,21.50817112871545,19,1010,0.0,5
2020-04-28 00:00:00+02:00,218,16,202,22.57742359713229,231,20,211,16.702836426900134,16,1005,0.1,8
2020-04-28 01:00:00+02:00,137,9,128,18.928795118329443,143,11,132,22.510370466296816,16,1005,0.1,8
2020-04-28 02:00:00+02:00,132,10,122,19.37004764296085,151,13,138,19.408157188048275,16,1005,0.1,8
2020-04-28 03:00:00+02:00,206,13,193,22.241507594869486,218,16,202,22.57742359713229,16,1005,0.1,8
2020-04-28 04:00:00+02:00,350,27,323,21.39774246689966,383,31,352,23.132924781238575,16,1005,0.1,8
2020-04-28 05:00:00+02:00,648,51,597,21.117444098521716,656,53,603,18.67676415580104,16,1005,0.1,8
2020-04-28 06:00:00+02:00,800,57,743,20.925446011042194,869,61,808,16.817772040585538,16,1005,0.1,8
2020-04-28 07:00:00+02:00,1211,86,1125,26.420821746988196,1269,99,1170,23.367601325573045,16,1005,0.1,8
2020-04-28 08:00:00+02:00,1275,84,1191,15.755531987325151,1352,117,1235,17.115450879346067,16,1005,0.1,8
2020-04-28 09:00:00+02:00,896,70,826,20.028318940598915,869,77,792,16.817772040585538,16,1005,0.1,8
2020-04-28 10:00:00+02:00,712,50,662,24.36731955046189,758,53,705,22.232044845919173,16,1005,0.1,8
2020-04-28 11:00:00+02:00,850,61,789,21.219070362639208,874,66,808,22.731615929515666,16,1005,0.1,8
2020-04-28 12:00:00+02:00,670,46,624,16.908196156468264,792,57,735,24.002822951179763,16,1005,0.1,8
2020-04-28 13:00:00+02:00,706,52,654,19.75534206734452,725,62,663,27.6201430329488,16,1005,0.1,8
2020-04-28 14:00:00+02:00,720,52,668,19.944056890178263,772,68,704,21.008712606183504,16,1005,0.1,8
2020-04-28 15:00:00+02:00,792,61,731,24.002822951179763,855,70,785,19.962425752581876,16,1005,0.1,8
2020-04-28 16:00:00+02:00,781,57,724,21.0241020485366,902,76,826,23.54203327885049,16,1005,0.1,8
2020-04-28 17:00:00+02:00,1184,82,1102,19.553049265064693,1327,118,1209,19.43281921119358,16,1005,0.1,8
2020-04-28 18:00:00+02:00,1219,85,1134,22.328031632882436,1410,122,1288,25.328387962824422,16,1005,0.1,8
2020-04-28 19:00:00+02:00,938,63,875,14.640917048168077,1001,83,918,19.972180747232336,16,1005,0.1,8
2020-04-28 20:00:00+02:00,954,66,888,19.940202369040847,954,81,873,19.940202369040847,16,1005,0.1,8
2020-04-28 21:00:00+02:00,662,50,612,20.979149623229564,745,62,683,24.741896667257816,16,1005,0.1,8
2020-04-28 22:00:00+02:00,463,33,430,21.06469305151698,516,36,480,23.45871840478751,16,1005,0.1,8
2020-04-28 23:00:00+02:00,361,23,338,19.1870055662437,378,34,344,19.765573549462566,16,1005,0.1,8
2020-04-29 00:00:00+02:00,138,12,126,21.813750779140573,129,12,117,12.321757402623772,14,1007,0.0,17
2020-04-29 01:00:00+02:00,92,9,83,14.440667881435587,94,8,86,15.983412444109252,14,1007,0.0,17
2020-04-29 02:00:00+02:00,94,10,84,15.983412444109252,94,9,85,15.983412444109252,14,1007,0.0,17
2020-04-29 03:00:00+02:00,141,15,126,16.082921323202,129,10,119,12.321757402623772,14,1007,0.0,17
2020-04-29 04:00:00+02:00,234,23,211,23.965088279957833,210,20,190,22.373575210561917,14,1007,0.0,17
2020-04-29 05:00:00+02:00,415,42,373,16.256703031864188,380,38,342,21.43528591263335,14,1007,0.0,17
2020-04-29 06:00:00+02:00,511,49,462,23.46483660517307,502,50,452,17.102378314033963,14,1007,0.0,17
2020-04-29 07:00:00+02:00,803,83,720,24.33793537735206,770,68,702,30.80507069223336,14,1007,0.0,17
2020-04-29 08:00:00+02:00,838,89,749,21.314812929620796,840,65,775,22.145459563785934,14,1007,0.0,17
2020-04-29 09:00:00+02:00,569,60,509,21.5152841392816,516,44,472,19.477342984372644,14,1007,0.0,17
2020-04-29 10:00:00+02:00,472,44,428,16.716083148489194,469,44,425,22.98744594026073,14,1007,0.0,17
2020-04-29 11:00:00+02:00,567,59,508,23.36809092648519,569,51,518,21.5152841392816,14,1007,0.0,17
2020-04-29 12:00:00+02:00,462,45,417,21.602707594400176,471,38,433,19.847986208788534,14,1007,0.0,17
2020-04-29 13:00:00+02:00,471,43,428,19.847986208788534,460,36,424,18.80828405121806,14,1007,0.0,17
2020-04-29 14:00:00+02:00,469,45,424,22.98744594026073,469,44,425,22.98744594026073,14,1007,0.0,17
2020-04-29 15:00:00+02:00,520,54,466,11.068838816920296,493,50,443,19.413114642597456,14,1007,0.0,17
2020-04-29 16:00:00+02:00,562,52,510,25.337764963562588,528,46,482,22.202095855996042,14,1007,0.0,17
2020-04-29 17:00:00+02:00,793,83,710,14.640141810596411,791,71,720,22.800458032026814,14,1007,0.0,17
2020-04-29 18:00:00+02:00,847,82,765,21.566957764400883,770,58,712,30.80507069223336,14,1007,0.0,17
2020-04-29 19:00:00+02:00,605,64,541,24.70813035887608,605,49,556,24.70813035887608,14,1007,0.0,17
2020-04-29 20:00:00+02:00,614,57,557,21.415297218291705,597,52,545,27.42561338780647,14,1007,0.0,17
2020-04-29 21:00:00+02:00,472,43,429,16.716083148489194,469,44,425,22.98744594026073,14,1007,0.0,17
2020-04-29 22:00:00+02:00,331,34,297,19.342929405123495,316,30,286,12.954823545566947,14,1007,0.0,17
2020-04-29 23:00:00+02:00,236,25,211,11.423053117408324,222,17,205,23.940731731626443,14,1007,0.0,17
2020-04-30 00:00:00+02:00,71,4,67,15.50461576454985,78,10,68,16.41986115786707,13,1005,0.5,22
2020-04-30 01:00:00+02:00,51,3,48,7.252205043556333,50,5,45,13.688855833793909,13,1005,0.5,22
2020-04-30 02:00:00+02:00,49,3,46,13.911731041947528,50,5,45,13.688855833793909,13,1005,0.5,22
2020-04-30 03:00:00+02:00,74,4,70,19.513800836509724,80,9,71,18.237765354324676,13,1005,0.5,22
2020-04-30 04:00:00+02:00,128,7,121,19.601953989978306,129,12,117,17.995114557081255,13,1005,0.5,22
2020-04-30 05:00:00+02:00,228,13,215,15.818609956751573,222,22,200,18.77573498601868,13,1005,0.5,22
2020-04-30 06:00:00+02:00,251,17,234,19.570183352800104,283,34,249,21.015453076893927,13,1005,0.5,22
2020-04-30 07:00:00+02:00,430,27,403,19.32256414396262,431,43,388,17.591114272986506,13,1005,0.5,22
2020-04-30 08:00:00+02:00,472,34,438,21.284214830242632,484,60,424,17.863314460235074,13,1005,0.5,22
2020-04-30 09:00:00+02:00,325,20,305,19.331050121665143,322,40,282,22.976009334024873,13,1005,0.5,22
2020-04-30 10:00:00+02:00,245,15,230,18.942213831390788,257,31,226,24.369710124951805,13,1005,0.5,22
2020-04-30 11:00:00+02:00,319,19,300,20.382766877627866,322,40,282,22.976009334024873,13,1005,0.5,22
2020-04-30 12:00:00+02:00,245,15,230,18.942213831390788,257,31,226,24.369710124951805,13,1005,0.5,22
2020-04-30 13:00:00+02:00,266,16,250,24.416240816629376,255,27,228,21.41944964647189,13,1005,0.5,22
2020-04-30 14:00:00+02:00,266,16,250,24.416240816629376,255,27,228,21.41944964647189,13,1005,0.5,22
2020-04-30 15:00:00+02:00,293,18,275,19.851789935750844,292,33,259,18.509650933155072,13,1005,0.5,22
2020-04-30 16:00:00+02:00,280,19,261,25.91177046818179,310,38,272,16.921651532922695,13,1005,0.5,22
2020-04-30 17:00:00+02:00,433,27,406,15.756615810687446,425,47,378,20.977086023346995,13,1005,0.5,22
2020-04-30 18:00:00+02:00,459,30,429,21.314720332142485,470,48,422,21.98902238846196,13,1005,0.5,22
2020-04-30 19:00:00+02:00,330,21,309,16.43301680059058,328,35,293,17.860857228116767,13,1005,0.5,22
2020-04-30 20:00:00+02:00,318,19,299,21.634505447676812,326,37,289,15.279514269305528,13,1005,0.5,22
2020-04-30 21:00:00+02:00,245,15,230,18.942213831390788,257,31,226,24.369710124951805,13,1005,0.5,22
2020-04-30 22:00:00+02:00,186,11,175,22.772295906033783,172,17,155,19.644113972447897,13,1005,0.5,22
2020-04-30 23:00:00+02:00,128,9,119,19.601953989978306,129,12,117,17.995114557081255,13,1005,0.5,22
2020-05-01 00:00:00+02:00,78,5,73,16.41986115786707,78,6,72,16.41986115786707,14,1005,0.2,24
2020-05-01 01:00:00+02:00,52,4,48,6.894026658963235,50,3,47,13.688855833793909,14,1005,0.2,24
2020-05-01 02:00:00+02:00,53,4,49,8.976459755768028,53,4,49,8.976459755768028,14,1005,0.2,24
2020-05-01 03:00:00+02:00,79,6,73,16.382916607013883,78,6,72,16.41986115786707,14,1005,0.2,24
2020-05-01 04:00:00+02:00,130,10,120,15.65660051079879,129,8,121,17.995114557081255,14,1005,0.2,24
2020-05-01 05:00:00+02:00,234,17,217,19.754580108435302,224,17,207,16.30248157536985,14,1005,0.2,24
2020-05-01 06:00:00+02:00,286,20,266,20.398524223626136,296,25,271,20.454116986907042,14,1005,0.2,24
2020-05-01 07:00:00+02:00,449,35,414,18.601165629732545,428,34,394,17.985011931135546,14,1005,0.2,24
2020-05-01 08:00:00+02:00,464,34,430,21.884111394069308,451,31,420,20.489203978314702,14,1005,0.2,24
2020-05-01 09:00:00+02:00,318,24,294,21.634505447676812,301,24,277,16.897732473063776,14,1005,0.2,24
2020-05-01 10:00:00+02:00,257,19,238,24.369710124951805,264,18,246,20.665980174270672,14,1005,0.2,24
2020-05-01 11:00:00+02:00,311,23,288,16.325599187415413,310,23,287,16.921651532922695,14,1005,0.2,24
2020-05-01 12:00:00+02:00,260,19,241,21.14564444182058,254,22,232,21.33413531955627,14,1005,0.2,24
2020-05-01 13:00:00+02:00,260,22,238,21.14564444182058,254,22,232,21.33413531955627,14,1005,0.2,24
2020-05-01 14:00:00+02:00,260,22,238,21.14564444182058,254,22,232,21.33413531955627,14,1005,0.2,24
2020-05-01 15:00:00+02:00,286,25,261,20.398524223626136,296,25,271,20.454116986907042,14,1005,0.2,24
2020-05-01 16:00:00+02:00,317,25,292,23.692514426518255,301,24,277,16.897732473063776,14,1005,0.2,24
2020-05-01 17:00:00+02:00,437,32,405,22.67431624563715,460,33,427,18.198266997149677,14,1005,0.2,24
2020-05-01 18:00:00+02:00,461,37,424,24.16987876504356,441,35,406,21.65218956350676,14,1005,0.2,24
2020-05-01 19:00:00+02:00,335,25,310,21.419812345615075,322,27,295,22.976009334024873,14,1005,0.2,24
2020-05-01 20:00:00+02:00,352,29,323,20.33829699034963,331,26,305,18.08059708638437,14,1005,0.2,24
2020-05-01 21:00:00+02:00,257,19,238,24.369710124951805,264,18,246,20.665980174270672,14,1005,0.2,24
2020-05-01 22:00:00+02:00,181,13,168,20.051163259817507,178,12,166,19.804789777436813,14,1005,0.2,24
2020-05-01 23:00:00+02:00,129,9,120,17.995114557081255,129,8,121,17.995114557081255,14,1005,0.2,24
2020-05-02 00:00:00+02:00,120,5,115,15.329119598546,125,5,120,11.899638158178501,13,1010,0.0,18
2020-05-02 01:00:00+02:00,80,4,76,12.9514806028411,85,4,81,9.516934044829473,13,1010,0.0,18
2020-05-02 02:00:00+02:00,82,3,79,8.6962433625344,85,4,81,9.516934044829473,13,1010,0.0,18
2020-05-02 03:00:00+02:00,123,5,118,13.78591137222831,125,5,120,11.899638158178501,13,1010,0.0,18
2020-05-02 04:00:00+02:00,161,8,153,19.39413115763897,168,7,161,15.312398611458734,13,1010,0.0,18
2020-05-02 05:00:00+02:00,207,10,197,18.76558942906742,213,10,203,20.238518600536185,13,1010,0.0,18
2020-05-02 06:00:00+02:00,325,17,308,18.163130994775884,339,17,322,18.9351903306688,13,1010,0.0,18
2020-05-02 07:00:00+02:00,487,26,461,20.801132823441247,518,25,493,17.06195195164026,13,1010,0.0,18
2020-05-02 08:00:00+02:00,638,33,605,20.631985761091233,672,30,642,17.965544150858715,13,1010,0.0,18
2020-05-02 09:00:00+02:00,709,36,673,19.749072253568023,735,30,705,19.672506751132385,13,1010,0.0,18
2020-05-02 10:00:00+02:00,591,28,563,19.701338578215633,635,26,609,14.00526989171057,13,1010,0.0,18
2020-05-02 11:00:00+02:00,500,25,475,17.53149172402289,517,25,492,16.994238402717986,13,1010,0.0,18
2020-05-02 12:00:00+02:00,501,23,478,17.91816636651384,517,25,492,16.994238402717986,13,1010,0.0,18
2020-05-02 13:00:00+02:00,543,25,518,21.26508543455116,557,24,533,12.160249077344764,13,1010,0.0,18
2020-05-02 14:00:00+02:00,480,23,457,22.699493069996517,512,24,488,16.667622950500245,13,1010,0.0,18
2020-05-02 15:00:00+02:00,568,29,539,17.29878687814385,602,24,578,17.424831150133677,13,1010,0.0,18
2020-05-02 16:00:00+02:00,577,28,549,17.038371488313466,591,24,567,19.701338578215633,13,1010,0.0,18
2020-05-02 17:00:00+02:00,641,29,612,20.968994853354097,672,30,642,17.965544150858715,13,1010,0.0,18
2020-05-02 18:00:00+02:00,625,31,594,19.162963208321358,649,26,623,20.34487337835388,13,1010,0.0,18
2020-05-02 19:00:00+02:00,472,25,447,15.966412489673269,515,25,490,18.515381952439686,13,1010,0.0,18
2020-05-02 20:00:00+02:00,460,21,439,21.56348705434536,470,23,447,16.224212326735135,13,1010,0.0,18
2020-05-02 21:00:00+02:00,415,21,394,20.29207139621444,425,22,403,17.81110597716838,13,1010,0.0,18
2020-05-02 22:00:00+02:00,323,17,306,19.446887597808452,340,16,324,14.37984208663957,13,1010,0.0,18
2020-05-02 23:00:00+02:00,157,8,149,19.700921436065542,171,7,164,17.45819407743446,13,1010,0.0,18
2020-05-03 00:00:00+02:00,136,4,132,17.36617287321582,145,4,141,19.922746131926434,16,1017,0.0,7
2020-05-03 01:00:00+02:00,89,2,87,10.527801976587284,92,3,89,9.485995969760566,16,1017,0.0,7
2020-05-03 02:00:00+02:00,86,2,84,9.565861223121674,121,3,118,11.617438248542046,16,1017,0.0,7
2020-05-03 03:00:00+02:00,124,3,121,14.467255533674502,136,3,133,17.36617287321582,16,1017,0.0,7
2020-05-03 04:00:00+02:00,169,5,164,20.526675282456768,243,7,236,15.58217691478424,16,1017,0.0,7
2020-05-03 05:00:00+02:00,216,7,209,17.62117954457743,219,6,213,18.74397758884313,16,1017,0.0,7
2020-05-03 06:00:00+02:00,332,10,322,20.862138293674573,460,13,447,21.56348705434536,16,1017,0.0,7
2020-05-03 07:00:00+02:00,534,17,517,10.719794673298331,635,17,618,14.00526989171057,16,1017,0.0,7
2020-05-03 08:00:00+02:00,739,24,715,16.2492981775581,918,26,892,23.151756051255308,16,1017,0.0,7
2020-05-03 09:00:00+02:00,757,26,731,23.979959928500918,915,30,885,21.167567547657367,16,1017,0.0,7
2020-05-03 10:00:00+02:00,668,20,648,14.894863684358564,823,28,795,18.877168409303753,16,1017,0.0,7
2020-05-03 11:00:00+02:00,537,18,519,17.84682050697329,579,18,561,18.984539240055984,16,1017,0.0,7
2020-05-03 12:00:00+02:00,531,17,514,16.61168707204345,677,18,659,21.53593373202197,16,1017,0.0,7
2020-05-03 13:00:00+02:00,600,17,583,16.529480639330192,775,23,752,14.546756589008417,16,1017,0.0,7
2020-05-03 14:00:00+02:00,558,16,542,16.564894338026185,600,17,583,16.529480639330192,16,1017,0.0,7
2020-05-03 15:00:00+02:00,653,21,632,19.852184178371132,843,26,817,21.613182140958614,16,1017,0.0,7
2020-05-03 16:00:00+02:00,650,21,629,20.406208347277076,716,23,693,25.392995166433195,16,1017,0.0,7
2020-05-03 17:00:00+02:00,722,23,699,20.35341293328173,748,20,728,18.02787833872048,16,1017,0.0,7
2020-05-03 18:00:00+02:00,653,21,632,19.852184178371132,906,29,877,25.14622129911813,16,1017,0.0,7
2020-05-03 19:00:00+02:00,517,17,500,16.994238402717986,612,20,592,14.880406360759972,16,1017,0.0,7
2020-05-03 20:00:00+02:00,490,15,475,25.075248566874926,570,18,552,20.82588012119089,16,1017,0.0,7
2020-05-03 21:00:00+02:00,416,14,402,20.665581485173448,549,16,533,18.842448340385054,16,1017,0.0,7
2020-05-03 22:00:00+02:00,356,11,345,20.05958990150746,407,14,393,18.86836233630375,16,1017,0.0,7
2020-05-03 23:00:00+02:00,181,6,175,16.606730094694083,196,5,191,22.483124652822625,16,1017,0.0,7
2020-05-04 00:00:00+02:00,260,20,240,21.14564444182058,270,26,244,23.920073269237992,18,1018,0.0,5
2020-05-04 01:00:00+02:00,182,13,169,17.128604685093855,179,13,166,19.18236787964663,18,1018,0.0,5
2020-05-04 02:00:00+02:00,182,15,167,17.128604685093855,179,13,166,19.18236787964663,18,1018,0.0,5
2020-05-04 03:00:00+02:00,277,23,254,24.920160895876304,277,25,252,24.920160895876304,18,1018,0.0,5
2020-05-04 04:00:00+02:00,470,38,432,21.98902238846196,453,39,414,18.726095790194968,18,1018,0.0,5
2020-05-04 05:00:00+02:00,798,64,734,21.901691075721356,808,61,747,21.000145261642547,18,1018,0.0,5
2020-05-04 06:00:00+02:00,954,81,873,19.940202369040847,984,93,891,22.781558795375634,18,1018,0.0,5
2020-05-04 07:00:00+02:00,1529,131,1398,18.198576059485266,1532,125,1407,18.74941403544615,18,1018,0.0,5
2020-05-04 08:00:00+02:00,1694,135,1559,19.897370030997088,1667,149,1518,21.13705342510251,18,1018,0.0,5
2020-05-04 09:00:00+02:00,1129,92,1037,21.098436571025903,1116,104,1012,23.656778551310683,18,1018,0.0,5
2020-05-04 10:00:00+02:00,913,77,836,15.388244950924985,906,91,815,23.428830164515258,18,1018,0.0,5
2020-05-04 11:00:00+02:00,1113,93,1020,19.842220166347598,1096,107,989,21.88737025121773,18,1018,0.0,5
2020-05-04 12:00:00+02:00,933,72,861,21.585263800476984,903,85,818,18.37149569119113,18,1018,0.0,5
2020-05-04 13:00:00+02:00,913,69,844,15.388244950924985,906,91,815,23.428830164515258,18,1018,0.0,5
2020-05-04 14:00:00+02:00,926,78,848,21.2225271136678,920,74,846,17.831951809597363,18,1018,0.0,5
2020-05-04 15:00:00+02:00,1025,78,947,11.976122264921507,987,94,893,17.729507247457875,18,1018,0.0,5
2020-05-04 16:00:00+02:00,1079,92,987,24.79830428587415,1099,85,1014,19.77884999150702,18,1018,0.0,5
2020-05-04 17:00:00+02:00,1583,131,1452,23.51918594734625,1579,157,1422,24.005962427689305,18,1018,0.0,5
2020-05-04 18:00:00+02:00,1701,137,1564,23.27659572589562,1640,138,1502,22.611699908818007,18,1018,0.0,5
2020-05-04 19:00:00+02:00,1126,98,1028,15.859778961493305,1214,96,1118,20.62160945430093,18,1018,0.0,5
2020-05-04 20:00:00+02:00,1207,102,1105,24.020256611516658,1197,111,1086,25.25740485301948,18,1018,0.0,5
2020-05-04 21:00:00+02:00,893,75,818,23.549492661662494,940,87,853,17.27693484402804,18,1018,0.0,5
2020-05-04 22:00:00+02:00,639,52,587,21.888977134041827,629,54,575,19.562414399045025,18,1018,0.0,5
2020-05-04 23:00:00+02:00,429,30,399,21.355504409446556,449,35,414,18.601165629732545,18,1018,0.0,5
2020-05-05 00:00:00+02:00,135,9,126,21.280002906629502,148,11,137,18.058884943386857,13,1018,0.0,15
2020-05-05 01:00:00+02:00,98,7,91,10.878679660088993,98,7,91,10.878679660088993,13,1018,0.0,15
2020-05-05 02:00:00+02:00,89,6,83,17.562315027840828,100,6,94,11.502705756568044,13,1018,0.0,15
2020-05-05 03:00:00+02:00,141,10,131,21.00935462418931,159,12,147,17.78748005044877,13,1018,0.0,15
2020-05-05 04:00:00+02:00,230,15,215,17.120376816836934,259,18,241,22.988395045636892,13,1018,0.0,15
2020-05-05 05:00:00+02:00,401,27,374,26.708807440790352,456,37,419,14.42236972784694,13,1018,0.0,15
2020-05-05 06:00:00+02:00,547,37,510,20.747394942344446,544,42,502,25.1241889325097,13,1018,0.0,15
2020-05-05 07:00:00+02:00,837,55,782,21.759514900649297,861,66,795,25.343549464556432,13,1018,0.0,15
2020-05-05 08:00:00+02:00,898,65,833,13.340164376112321,889,78,811,27.731520419986133,13,1018,0.0,15
2020-05-05 09:00:00+02:00,560,40,520,19.606018509461766,609,46,563,17.500922035745717,13,1018,0.0,15
2020-05-05 10:00:00+02:00,486,34,452,18.71988428719074,527,38,489,18.36347321630945,13,1018,0.0,15
2020-05-05 11:00:00+02:00,603,46,557,20.350290442155355,594,43,551,19.89554555447028,13,1018,0.0,15
2020-05-05 12:00:00+02:00,449,34,415,18.601165629732545,499,40,459,21.95846674548548,13,1018,0.0,15
2020-05-05 13:00:00+02:00,486,36,450,18.71988428719074,527,38,489,18.36347321630945,13,1018,0.0,15
2020-05-05 14:00:00+02:00,503,38,465,18.697693722393225,529,38,491,16.445273293132438,13,1018,0.0,15
2020-05-05 15:00:00+02:00,534,35,499,22.13831863455401,547,43,504,20.747394942344446,13,1018,0.0,15
2020-05-05 16:00:00+02:00,590,39,551,24.741329330337763,597,49,548,20.96302352029361,13,1018,0.0,15
2020-05-05 17:00:00+02:00,785,52,733,19.91443463428047,904,77,827,20.69263283613475,13,1018,0.0,15
2020-05-05 18:00:00+02:00,841,62,779,20.63744972669111,904,61,843,20.69263283613475,13,1018,0.0,15
2020-05-05 19:00:00+02:00,607,45,562,24.800962727758165,696,54,642,26.69245726125086,13,1018,0.0,15
2020-05-05 20:00:00+02:00,575,42,533,21.211821520021783,635,56,579,19.585358081724554,13,1018,0.0,15
2020-05-05 21:00:00+02:00,462,36,426,18.95008410951899,497,34,463,23.514377363791095,13,1018,0.0,15
2020-05-05 22:00:00+02:00,323,24,299,19.17862862818099,371,32,339,20.767700865402965,13,1018,0.0,15
2020-05-05 23:00:00+02:00,226,15,211,20.308697708911414,246,19,227,17.57126233227549,13,1018,0.0,15
2020-05-06 00:00:00+02:00,243,25,218,25.380099969640305,230,22,208,17.60723498396665,17,1019,0.0,7
2020-05-06 01:00:00+02:00,166,15,151,19.683348994848064,153,15,138,18.89706115395996,17,1019,0.0,7
2020-05-06 02:00:00+02:00,160,17,143,21.971340940322392,150,13,137,18.780420376145724,17,1019,0.0,7
2020-05-06 03:00:00+02:00,246,24,222,23.31403953539513,249,20,229,17.9608555538356,17,1019,0.0,7
2020-05-06 04:00:00+02:00,406,42,364,23.347397986470767,415,34,381,16.256703031864188,17,1019,0.0,7
2020-05-06 05:00:00+02:00,729,79,650,18.56108310370918,692,61,631,26.8377277358448,17,1019,0.0,7
2020-05-06 06:00:00+02:00,889,82,807,15.40324298576158,858,81,777,19.509564236678926,17,1019,0.0,7
2020-05-06 07:00:00+02:00,1397,125,1272,24.60141114978918,1243,121,1122,20.41360596174645,17,1019,0.0,7
2020-05-06 08:00:00+02:00,1453,146,1307,19.576564032285997,1493,144,1349,21.117496644135638,17,1019,0.0,7
2020-05-06 09:00:00+02:00,1000,105,895,20.174292304894557,957,95,862,14.170253486260943,17,1019,0.0,7
2020-05-06 10:00:00+02:00,825,77,748,17.542093611289136,803,71,732,24.33793537735206,17,1019,0.0,7
2020-05-06 11:00:00+02:00,988,98,890,22.229163024924386,954,79,875,17.134846164931268,17,1019,0.0,7
2020-05-06 12:00:00+02:00,825,77,748,17.542093611289136,803,71,732,24.33793537735206,17,1019,0.0,7
2020-05-06 13:00:00+02:00,825,82,743,17.542093611289136,803,71,732,24.33793537735206,17,1019,0.0,7
2020-05-06 14:00:00+02:00,825,82,743,17.542093611289136,803,71,732,24.33793537735206,17,1019,0.0,7
2020-05-06 15:00:00+02:00,905,90,815,13.637828638699958,800,68,732,25.677627216329988,17,1019,0.0,7
2020-05-06 16:00:00+02:00,982,98,884,18.21194811397264,902,72,830,22.221922861980417,17,1019,0.0,7
2020-05-06 17:00:00+02:00,1376,149,1227,24.71363427979236,1348,110,1238,15.314592806023153,17,1019,0.0,7
2020-05-06 18:00:00+02:00,1490,158,1332,24.784983054940405,1370,131,1239,15.799481280202858,17,1019,0.0,7
2020-05-06 19:00:00+02:00,1059,96,963,22.523591839797913,1003,82,921,21.66984872353106,17,1019,0.0,7
2020-05-06 20:00:00+02:00,1068,98,970,18.31875507352194,1052,98,954,21.24383554364071,17,1019,0.0,7
2020-05-06 21:00:00+02:00,806,85,721,17.36544103467151,815,66,749,24.50547044406609,17,1019,0.0,7
2020-05-06 22:00:00+02:00,578,61,517,17.852029647201853,572,46,526,16.900703125946286,17,1019,0.0,7
2020-05-06 23:00:00+02:00,412,40,372,18.26785157491369,403,31,372,13.914029524281172,17,1019,0.0,7
2020-05-07 00:00:00+02:00,237,15,222,15.922060682410839,246,31,215,17.57126233227549,17,1025,0.0,7
2020-05-07 01:00:00+02:00,151,10,141,19.408157188048275,157,15,142,23.857880119976507,17,1025,0.0,7
2020-05-07 02:00:00+02:00,154,10,144,23.457384968254527,151,19,132,19.408157188048275,17,1025,0.0,7
2020-05-07 03:00:00+02:00,237,14,223,15.922060682410839,246,31,215,17.57126233227549,17,1025,0.0,7
2020-05-07 04:00:00+02:00,382,26,356,19.255057171585772,385,49,336,23.62167138094536,17,1025,0.0,7
2020-05-07 05:00:00+02:00,718,44,674,20.275643080512808,715,71,644,24.714514015464268,17,1025,0.0,7
2020-05-07 06:00:00+02:00,805,57,748,24.432728502533333,913,105,808,15.388244950924985,17,1025,0.0,7
2020-05-07 07:00:00+02:00,1320,95,1225,22.95002505990789,1363,167,1196,23.625407529205518,17,1025,0.0,7
2020-05-07 08:00:00+02:00,1369,87,1282,19.73862630829249,1477,155,1322,22.84031269791589,17,1025,0.0,7
2020-05-07 09:00:00+02:00,946,67,879,18.982808272150088,919,102,817,23.683478011893353,17,1025,0.0,7
2020-05-07 10:00:00+02:00,768,55,713,19.17235077337456,764,98,666,26.163227189245884,17,1025,0.0,7
2020-05-07 11:00:00+02:00,959,67,892,18.6743360930744,971,122,849,17.52485827025155,17,1025,0.0,7
2020-05-07 12:00:00+02:00,777,53,724,18.08257285275898,829,104,725,23.423176775424896,17,1025,0.0,7
2020-05-07 13:00:00+02:00,768,50,718,19.17235077337456,764,98,666,26.163227189245884,17,1025,0.0,7
2020-05-07 14:00:00+02:00,798,56,742,21.901691075721356,777,76,701,18.08257285275898,17,1025,0.0,7
2020-05-07 15:00:00+02:00,842,59,783,18.43657043535353,857,83,774,21.1040884197244,17,1025,0.0,7
2020-05-07 16:00:00+02:00,842,56,786,18.43657043535353,937,91,846,13.26837624383386,17,1025,0.0,7
2020-05-07 17:00:00+02:00,1369,93,1276,19.73862630829249,1394,146,1248,16.39342487904114,17,1025,0.0,7
2020-05-07 18:00:00+02:00,1499,93,1406,23.897924113154247,1422,158,1264,18.594581813284307,17,1025,0.0,7
2020-05-07 19:00:00+02:00,1085,77,1008,22.165939472579062,1073,138,935,23.883254001158953,17,1025,0.0,7
2020-05-07 20:00:00+02:00,1030,74,956,24.578352092880596,1058,122,936,24.139244092444383,17,1025,0.0,7
2020-05-07 21:00:00+02:00,712,46,666,24.36731955046189,792,79,713,24.002822951179763,17,1025,0.0,7
2020-05-07 22:00:00+02:00,573,38,535,13.397132275797208,549,69,480,18.718889066861195,17,1025,0.0,7
2020-05-07 23:00:00+02:00,391,24,367,20.019115852021912,388,39,349,23.106523601706122,17,1025,0.0,7
2020-05-08 00:00:00+02:00,267,20,247,13.385499595100717,264,19,245,20.665980174270672,19,1021,0.0,6
2020-05-08 01:00:00+02:00,172,12,160,19.644113972447897,172,15,157,19.644113972447897,19,1021,0.0,6
2020-05-08 02:00:00+02:00,176,15,161,20.324791671108635,172,15,157,19.644113972447897,19,1021,0.0,6
2020-05-08 03:00:00+02:00,264,22,242,20.665980174270672,257,18,239,24.369710124951805,19,1021,0.0,6
2020-05-08 04:00:00+02:00,444,32,412,14.679521920211366,427,34,393,18.502781357559265,19,1021,0.0,6
2020-05-08 05:00:00+02:00,783,67,716,22.386866745743653,776,65,711,20.16450692078572,19,1021,0.0,6
2020-05-08 06:00:00+02:00,1007,73,934,21.476527208055813,929,68,861,20.10775148029194,19,1021,0.0,6
2020-05-08 07:00:00+02:00,1549,122,1427,19.246177792898536,1417,101,1316,20.131993417269204,19,1021,0.0,6
2020-05-08 08:00:00+02:00,1621,126,1495,20.23291949931915,1512,107,1405,17.97568505544746,19,1021,0.0,6
2020-05-08 09:00:00+02:00,1037,83,954,22.83203548329178,1041,76,965,20.49520589951316,19,1021,0.0,6
2020-05-08 10:00:00+02:00,881,69,812,16.814929476277918,851,63,788,22.04119359069634,19,1021,0.0,6
2020-05-08 11:00:00+02:00,1081,85,996,17.268255240736107,1088,86,1002,20.981781843022254,19,1021,0.0,6
2020-05-08 12:00:00+02:00,905,69,836,26.04340494897988,881,73,808,16.814929476277918,19,1021,0.0,6
2020-05-08 13:00:00+02:00,871,66,805,22.042013524243377,888,73,815,25.15497866670607,19,1021,0.0,6
2020-05-08 14:00:00+02:00,898,65,833,13.340164376112321,841,74,767,20.63744972669111,19,1021,0.0,6
2020-05-08 15:00:00+02:00,959,69,890,18.6743360930744,980,86,894,24.65392099510518,19,1021,0.0,6
2020-05-08 16:00:00+02:00,1068,89,979,18.655979859513685,1037,72,965,22.83203548329178,19,1021,0.0,6
2020-05-08 17:00:00+02:00,1492,112,1380,21.36383402888926,1546,115,1431,21.580775510576444,19,1021,0.0,6
2020-05-08 18:00:00+02:00,1549,115,1434,19.246177792898536,1502,108,1394,15.538198214777958,19,1021,0.0,6
2020-05-08 19:00:00+02:00,1146,96,1050,22.491549341606877,1146,99,1047,22.491549341606877,19,1021,0.0,6
2020-05-08 20:00:00+02:00,1180,91,1089,13.393899153064936,1088,82,1006,20.981781843022254,19,1021,0.0,6
2020-05-08 21:00:00+02:00,905,69,836,26.04340494897988,881,73,808,16.814929476277918,19,1021,0.0,6
2020-05-08 22:00:00+02:00,610,46,564,19.929525822534373,640,50,590,16.53063246999195,19,1021,0.0,6
2020-05-08 23:00:00+02:00,434,36,398,17.25970681294468,454,30,424,21.947231747967304,19,1021,0.0,6
2020-05-09 00:00:00+02:00,128,8,120,16.268122259148125,135,8,127,20.27811899595658,19,1014,0.0,5
2020-05-09 01:00:00+02:00,87,5,82,9.504121716770046,90,4,86,10.477669283936715,19,1014,0.0,5
2020-05-09 02:00:00+02:00,83,5,78,9.333357558089729,90,4,86,10.477669283936715,19,1014,0.0,5
2020-05-09 03:00:00+02:00,125,8,117,11.899638158178501,135,8,127,20.27811899595658,19,1014,0.0,5
2020-05-09 04:00:00+02:00,174,10,164,17.20816352324012,181,9,172,16.606730094694083,19,1014,0.0,5
2020-05-09 05:00:00+02:00,212,12,200,14.709005856097448,226,14,212,15.467390071610119,19,1014,0.0,5
2020-05-09 06:00:00+02:00,337,20,317,20.189680789887703,362,19,343,18.876684992305748,19,1014,0.0,5
2020-05-09 07:00:00+02:00,505,34,471,13.420156221106103,554,28,526,14.24598637599239,19,1014,0.0,5
2020-05-09 08:00:00+02:00,714,49,665,18.82580238349392,735,42,693,19.672506751132385,19,1014,0.0,5
2020-05-09 09:00:00+02:00,717,43,674,14.645847754944892,780,45,735,19.42485763338679,19,1014,0.0,5
2020-05-09 10:00:00+02:00,672,40,632,17.965544150858715,693,42,651,20.01623129813222,19,1014,0.0,5
2020-05-09 11:00:00+02:00,519,29,490,19.377864226097874,554,28,526,14.24598637599239,19,1014,0.0,5
2020-05-09 12:00:00+02:00,536,36,500,13.147585514482932,547,27,520,18.31342997105543,19,1014,0.0,5
2020-05-09 13:00:00+02:00,557,31,526,12.160249077344764,588,33,555,18.625003459627973,19,1014,0.0,5
2020-05-09 14:00:00+02:00,529,36,493,16.649089834553955,550,29,521,19.63353059078091,19,1014,0.0,5
2020-05-09 15:00:00+02:00,627,35,592,16.49762012359718,637,33,604,18.70777261267793,19,1014,0.0,5
2020-05-09 16:00:00+02:00,627,40,587,16.49762012359718,637,33,604,18.70777261267793,19,1014,0.0,5
2020-05-09 17:00:00+02:00,717,46,671,14.645847754944892,735,42,693,19.672506751132385,19,1014,0.0,5
2020-05-09 18:00:00+02:00,630,37,593,13.503006235616843,689,37,652,19.72727483528297,19,1014,0.0,5
2020-05-09 19:00:00+02:00,505,28,477,13.420156221106103,554,28,526,14.24598637599239,19,1014,0.0,5
2020-05-09 20:00:00+02:00,491,33,458,20.639383164942465,498,31,467,14.222982449555595,19,1014,0.0,5
2020-05-09 21:00:00+02:00,442,30,412,22.71527178577055,452,26,426,22.405685364755907,19,1014,0.0,5
2020-05-09 22:00:00+02:00,358,20,338,16.774588466913123,362,24,338,18.876684992305748,19,1014,0.0,5
2020-05-09 23:00:00+02:00,167,11,156,19.047083059371815,184,10,174,19.759138180971462,19,1014,0.0,5
2020-05-10 00:00:00+02:00,58,2,56,11.561797090249616,58,2,56,11.561797090249616,19,1007,0.6,6
2020-05-10 01:00:00+02:00,36,1,35,2.727177547566476,52,2,50,14.472017643602554,19,1007,0.6,6
2020-05-10 02:00:00+02:00,38,1,37,5.960450042509954,52,2,50,14.472017643602554,19,1007,0.6,6
2020-05-10 03:00:00+02:00,58,2,56,11.561797090249616,58,2,56,11.561797090249616,19,1007,0.6,6
2020-05-10 04:00:00+02:00,72,2,70,10.765287360581397,99,4,95,10.313624634117142,19,1007,0.6,6
2020-05-10 05:00:00+02:00,99,4,95,10.313624634117142,127,5,122,18.022773693841014,19,1007,0.6,6
2020-05-10 06:00:00+02:00,152,6,146,18.686880121910534,158,5,153,19.40470350916573,19,1007,0.6,6
2020-05-10 07:00:00+02:00,249,9,240,14.961614479066911,299,10,289,16.471342376610473,19,1007,0.6,6
2020-05-10 08:00:00+02:00,302,12,290,20.352052927472357,374,13,361,18.684901759797462,19,1007,0.6,6
2020-05-10 09:00:00+02:00,349,13,336,19.114918279434413,377,13,364,20.61326270709296,19,1007,0.6,6
2020-05-10 10:00:00+02:00,299,12,287,16.471342376610473,319,13,306,23.232042011552885,19,1007,0.6,6
2020-05-10 11:00:00+02:00,227,8,219,13.349035543905368,288,12,276,15.693687299637316,19,1007,0.6,6
2020-05-10 12:00:00+02:00,224,8,216,19.039166559272836,249,9,240,14.961614479066911,19,1007,0.6,6
2020-05-10 13:00:00+02:00,255,9,246,13.80583098758932,338,14,324,21.621773010719025,19,1007,0.6,6
2020-05-10 14:00:00+02:00,236,10,226,18.261863976847756,277,10,267,19.768862676933345,19,1007,0.6,6
2020-05-10 15:00:00+02:00,269,10,259,22.758175655823944,347,11,336,19.911580344317716,19,1007,0.6,6
2020-05-10 16:00:00+02:00,277,11,266,19.768862676933345,324,11,313,18.672846971084997,19,1007,0.6,6
2020-05-10 17:00:00+02:00,327,12,315,19.796623391570257,438,15,423,18.033066079167238,19,1007,0.6,6
2020-05-10 18:00:00+02:00,283,11,272,18.945435241048195,336,11,325,15.374523455613796,19,1007,0.6,6
2020-05-10 19:00:00+02:00,241,8,233,17.853279648834448,241,7,234,17.853279648834448,19,1007,0.6,6
2020-05-10 20:00:00+02:00,202,7,195,21.075229783177793,263,8,255,18.06193495748254,19,1007,0.6,6
2020-05-10 21:00:00+02:00,191,7,184,21.61132830766016,252,8,244,19.00138202247206,19,1007,0.6,6
2020-05-10 22:00:00+02:00,152,6,146,18.686880121910534,158,5,153,19.40470350916573,19,1007,0.6,6
2020-05-10 23:00:00+02:00,83,3,80,9.333357558089729,88,2,86,8.437594054986977,19,1007,0.6,6
2020-05-11 00:00:00+02:00,36,3,33,3.0873599992209124,39,3,36,6.782457974710225,9,1004,0.1,29
2020-05-11 01:00:00+02:00,24,2,22,1.5004308879154395,26,2,24,1.5382661455122164,9,1004,0.1,29
2020-05-11 02:00:00+02:00,24,2,22,1.5004308879154395,26,2,24,1.5382661455122164,9,1004,0.1,29
2020-05-11 03:00:00+02:00,37,3,34,2.066086063070793,39,4,35,6.782457974710225,9,1004,0.1,29
2020-05-11 04:00:00+02:00,60,5,55,10.583722413773145,62,6,56,14.48690450543278,9,1004,0.1,29
2020-05-11 05:00:00+02:00,108,10,98,14.813734676069407,112,11,101,14.898852003445265,9,1004,0.1,29
2020-05-11 06:00:00+02:00,136,13,123,16.594078125250377,142,16,126,21.623487252479663,9,1004,0.1,29
2020-05-11 07:00:00+02:00,226,22,204,20.308697708911414,214,23,191,18.560318290748608,9,1004,0.1,29
2020-05-11 08:00:00+02:00,239,24,215,13.74553452780325,235,29,206,20.674840106170866,9,1004,0.1,29
2020-05-11 09:00:00+02:00,154,16,138,23.457384968254527,151,18,133,19.408157188048275,9,1004,0.1,29
2020-05-11 10:00:00+02:00,128,11,117,19.601953989978306,128,12,116,19.601953989978306,9,1004,0.1,29
2020-05-11 11:00:00+02:00,152,13,139,20.188330220444417,154,15,139,23.457384968254527,9,1004,0.1,29
2020-05-11 12:00:00+02:00,123,13,110,19.074654696202938,128,14,114,19.601953989978306,9,1004,0.1,29
2020-05-11 13:00:00+02:00,127,11,116,19.116953333289125,125,13,112,23.026828253397017,9,1004,0.1,29
2020-05-11 14:00:00+02:00,127,11,116,19.116953333289125,125,13,112,23.026828253397017,9,1004,0.1,29
2020-05-11 15:00:00+02:00,139,12,127,18.732486269107348,137,15,122,18.928795118329443,9,1004,0.1,29
2020-05-11 16:00:00+02:00,145,14,131,18.85528596371164,157,17,140,23.857880119976507,9,1004,0.1,29
2020-05-11 17:00:00+02:00,216,21,195,21.273439412003903,220,27,193,16.758079648934128,9,1004,0.1,29
2020-05-11 18:00:00+02:00,228,21,207,15.818609956751573,225,22,203,17.07968654570721,9,1004,0.1,29
2020-05-11 19:00:00+02:00,168,15,153,20.304807772345505,167,18,149,21.39117903937357,9,1004,0.1,29
2020-05-11 20:00:00+02:00,166,16,150,18.57114730689396,170,20,150,19.775542485132945,9,1004,0.1,29
2020-05-11 21:00:00+02:00,122,13,109,20.245567873519157,131,15,116,14.183230975852695,9,1004,0.1,29
2020-05-11 22:00:00+02:00,89,8,81,17.562315027840828,89,8,81,17.562315027840828,9,1004,0.1,29
2020-05-11 23:00:00+02:00,63,5,58,14.929801273937542,62,6,56,14.48690450543278,9,1004,0.1,29
2020-05-12 00:00:00+02:00,33,2,31,5.985660510090718,39,3,36,6.782457974710225,10,1019,0.0,24
2020-05-12 01:00:00+02:00,22,1,21,0.1277873501672996,26,2,24,1.5382661455122164,10,1019,0.0,24
2020-05-12 02:00:00+02:00,25,2,23,1.1875344360364632,27,2,25,1.9016023008994223,10,1019,0.0,24
2020-05-12 03:00:00+02:00,38,3,35,11.101073107969722,40,4,36,5.275608835029151,10,1019,0.0,24
2020-05-12 04:00:00+02:00,62,5,57,14.48690450543278,62,5,57,14.48690450543278,10,1019,0.0,24
2020-05-12 05:00:00+02:00,101,8,93,11.280950715811313,121,12,109,20.317620945183666,10,1019,0.0,24
2020-05-12 06:00:00+02:00,138,11,127,20.21600799483387,138,14,124,20.21600799483387,10,1019,0.0,24
2020-05-12 07:00:00+02:00,192,17,175,21.295822766447603,225,21,204,17.07968654570721,10,1019,0.0,24
2020-05-12 08:00:00+02:00,218,18,200,22.57742359713229,242,27,215,20.990360069331732,10,1019,0.0,24
2020-05-12 09:00:00+02:00,142,13,129,21.623487252479663,164,16,148,22.827361263214527,10,1019,0.0,24
2020-05-12 10:00:00+02:00,129,10,119,17.995114557081255,131,11,120,14.183230975852695,10,1019,0.0,24
2020-05-12 11:00:00+02:00,142,11,131,21.623487252479663,164,16,148,22.827361263214527,10,1019,0.0,24
2020-05-12 12:00:00+02:00,129,10,119,17.995114557081255,131,11,120,14.183230975852695,10,1019,0.0,24
2020-05-12 13:00:00+02:00,119,9,110,22.46945513312648,129,12,117,17.995114557081255,10,1019,0.0,24
2020-05-12 14:00:00+02:00,119,9,110,22.46945513312648,129,12,117,17.995114557081255,10,1019,0.0,24
2020-05-12 15:00:00+02:00,130,10,120,15.65660051079879,144,12,132,22.91915418498221,10,1019,0.0,24
2020-05-12 16:00:00+02:00,139,13,126,18.732486269107348,150,15,135,17.939622434692456,10,1019,0.0,24
2020-05-12 17:00:00+02:00,209,17,192,22.16757043059366,224,19,205,16.30248157536985,10,1019,0.0,24
2020-05-12 18:00:00+02:00,213,17,196,20.488166305452438,246,24,222,17.57126233227549,10,1019,0.0,24
2020-05-12 19:00:00+02:00,153,14,139,14.915022999208679,172,15,157,19.644113972447897,10,1019,0.0,24
2020-05-12 20:00:00+02:00,155,15,140,19.469409355748308,165,18,147,20.56038540292619,10,1019,0.0,24
2020-05-12 21:00:00+02:00,119,11,108,22.46945513312648,129,12,117,17.995114557081255,10,1019,0.0,24
2020-05-12 22:00:00+02:00,83,6,77,18.699193296190067,90,9,81,13.960700117154147,10,1019,0.0,24
2020-05-12 23:00:00+02:00,58,4,54,10.505136369992313,67,7,60,12.5039951599288,10,1019,0.0,24
2020-05-13 00:00:00+02:00,58,7,51,10.220927905289535,57,6,51,8.81765387708464,12,1017,0.0,17
2020-05-13 01:00:00+02:00,38,4,34,7.590795833711637,35,3,32,9.728270456817627,12,1017,0.0,17
2020-05-13 02:00:00+02:00,38,4,34,7.590795833711637,35,3,32,9.728270456817627,12,1017,0.0,17
2020-05-13 03:00:00+02:00,57,6,51,8.81765387708464,54,5,49,10.817024136428179,12,1017,0.0,17
2020-05-13 04:00:00+02:00,99,11,88,14.833512798015287,97,9,88,13.44369084549097,12,1017,0.0,17
2020-05-13 05:00:00+02:00,175,19,156,17.379188401043834,179,17,162,9.836620485396171,12,1017,0.0,17
2020-05-13 06:00:00+02:00,215,29,186,19.111985716553264,198,22,176,16.831897106241644,12,1017,0.0,17
2020-05-13 07:00:00+02:00,333,40,293,20.360845500171493,338,43,295,25.380150029874855,12,1017,0.0,17
2020-05-13 08:00:00+02:00,350,39,311,22.47956536478983,336,41,295,21.23683051193233,12,1017,0.0,17
2020-05-13 09:00:00+02:00,238,32,206,26.357922750399336,238,29,209,26.357922750399336,12,1017,0.0,17
2020-05-13 10:00:00+02:00,198,26,172,16.831897106241644,186,19,167,14.511740402245575,12,1017,0.0,17
2020-05-13 11:00:00+02:00,237,31,206,21.958682170629807,224,22,202,23.328062540910114,12,1017,0.0,17
2020-05-13 12:00:00+02:00,196,26,170,22.82713881382587,198,20,178,16.831897106241644,12,1017,0.0,17
2020-05-13 13:00:00+02:00,195,23,172,21.502321255791472,181,18,163,22.79969312673797,12,1017,0.0,17
2020-05-13 14:00:00+02:00,195,26,169,21.502321255791472,181,18,163,22.79969312673797,12,1017,0.0,17
2020-05-13 15:00:00+02:00,215,29,186,19.111985716553264,198,22,176,16.831897106241644,12,1017,0.0,17
2020-05-13 16:00:00+02:00,235,28,207,18.630545719736677,224,22,202,23.328062540910114,12,1017,0.0,17
2020-05-13 17:00:00+02:00,334,45,289,20.287002205644253,338,43,295,25.380150029874855,12,1017,0.0,17
2020-05-13 18:00:00+02:00,350,39,311,22.47956536478983,336,41,295,21.23683051193233,12,1017,0.0,17
2020-05-13 19:00:00+02:00,258,35,223,18.393934187206664,244,26,218,19.94485885962816,12,1017,0.0,17
2020-05-13 20:00:00+02:00,254,32,222,25.080256727773573,254,26,228,25.080256727773573,12,1017,0.0,17
2020-05-13 21:00:00+02:00,198,23,175,16.831897106241644,186,19,167,14.511740402245575,12,1017,0.0,17
2020-05-13 22:00:00+02:00,137,18,119,20.553143352452523,128,12,116,21.820504905688143,12,1017,0.0,17
2020-05-13 23:00:00+02:00,97,12,85,13.44369084549097,89,8,81,16.127888447212325,12,1017,0.0,17
2020-05-14 00:00:00+02:00,32,2,30,5.041092888653022,38,6,32,11.101073107969722,11,1014,0.0,23
2020-05-14 01:00:00+02:00,23,2,21,0.4122417358964417,25,3,22,1.1875344360364632,11,1014,0.0,23
2020-05-14 02:00:00+02:00,25,2,23,1.1875344360364632,25,3,22,1.1875344360364632,11,1014,0.0,23
2020-05-14 03:00:00+02:00,37,3,34,2.066086063070793,38,5,33,11.101073107969722,11,1014,0.0,23
2020-05-14 04:00:00+02:00,59,5,54,10.572210467564378,58,7,51,10.505136369992313,11,1014,0.0,23
2020-05-14 05:00:00+02:00,106,9,97,12.94750706735717,114,18,96,18.09348958441383,11,1014,0.0,23
2020-05-14 06:00:00+02:00,124,11,113,17.53992981591413,129,19,110,17.995114557081255,11,1014,0.0,23
2020-05-14 07:00:00+02:00,195,14,181,23.83440770251287,216,27,189,21.273439412003903,11,1014,0.0,23
2020-05-14 08:00:00+02:00,212,19,193,18.597605283865732,231,33,198,16.702836426900134,11,1014,0.0,23
2020-05-14 09:00:00+02:00,140,10,130,15.331768592489755,140,20,120,15.331768592489755,11,1014,0.0,23
2020-05-14 10:00:00+02:00,109,9,100,14.645038576883659,117,15,102,21.891304075969387,11,1014,0.0,23
2020-05-14 11:00:00+02:00,150,12,138,17.939622434692456,153,18,135,14.915022999208679,11,1014,0.0,23
2020-05-14 12:00:00+02:00,115,8,107,27.52702584121565,121,19,102,20.317620945183666,11,1014,0.0,23
2020-05-14 13:00:00+02:00,122,9,113,20.245567873519157,128,19,109,19.601953989978306,11,1014,0.0,23
2020-05-14 14:00:00+02:00,114,8,106,18.09348958441383,121,19,102,20.317620945183666,11,1014,0.0,23
2020-05-14 15:00:00+02:00,134,10,124,14.701306049248211,135,21,114,21.280002906629502,11,1014,0.0,23
2020-05-14 16:00:00+02:00,149,11,138,20.003285796587473,153,18,135,14.915022999208679,11,1014,0.0,23
2020-05-14 17:00:00+02:00,196,15,181,20.04912381427717,216,27,189,21.273439412003903,11,1014,0.0,23
2020-05-14 18:00:00+02:00,212,19,193,18.597605283865732,231,33,198,16.702836426900134,11,1014,0.0,23
2020-05-14 19:00:00+02:00,152,11,141,20.188330220444417,162,21,141,19.08849102929865,11,1014,0.0,23
2020-05-14 20:00:00+02:00,165,13,152,20.56038540292619,160,24,136,19.89239402952506,11,1014,0.0,23
2020-05-14 21:00:00+02:00,127,10,117,19.116953333289125,117,15,102,21.891304075969387,11,1014,0.0,23
2020-05-14 22:00:00+02:00,87,7,80,17.896548892855574,85,10,75,19.289671453475872,11,1014,0.0,23
2020-05-14 23:00:00+02:00,56,4,52,10.152150256689218,64,8,56,14.414592943793718,11,1014,0.0,23
2020-05-15 00:00:00+02:00,38,3,35,11.101073107969722,38,4,34,11.101073107969722,12,1016,0.0,23
2020-05-15 01:00:00+02:00,25,2,23,1.1875344360364632,25,2,23,1.1875344360364632,12,1016,0.0,23
2020-05-15 02:00:00+02:00,25,2,23,1.1875344360364632,25,2,23,1.1875344360364632,12,1016,0.0,23
2020-05-15 03:00:00+02:00,37,3,34,2.066086063070793,38,4,34,11.101073107969722,12,1016,0.0,23
2020-05-15 04:00:00+02:00,63,6,57,14.929801273937542,58,5,53,10.505136369992313,12,1016,0.0,23
2020-05-15 05:00:00+02:00,113,12,101,20.093188266697116,113,11,102,20.093188266697116,12,1016,0.0,23
2020-05-15 06:00:00+02:00,140,13,127,15.331768592489755,129,13,116,17.995114557081255,12,1016,0.0,23
2020-05-15 07:00:00+02:00,210,19,191,16.3212742992447,212,18,194,18.597605283865732,12,1016,0.0,23
2020-05-15 08:00:00+02:00,228,23,205,15.818609956751573,211,19,192,18.759232281731908,12,1016,0.0,23
2020-05-15 09:00:00+02:00,147,14,133,20.208056467665056,153,13,140,14.915022999208679,12,1016,0.0,23
2020-05-15 10:00:00+02:00,124,11,113,17.53992981591413,117,12,105,21.891304075969387,12,1016,0.0,23
2020-05-15 11:00:00+02:00,153,15,138,14.915022999208679,148,13,135,18.058884943386857,12,1016,0.0,23
2020-05-15 12:00:00+02:00,129,13,116,17.995114557081255,123,10,113,19.074654696202938,12,1016,0.0,23
2020-05-15 13:00:00+02:00,124,12,112,17.53992981591413,117,12,105,21.891304075969387,12,1016,0.0,23
2020-05-15 14:00:00+02:00,128,12,116,19.601953989978306,123,10,113,19.074654696202938,12,1016,0.0,23
2020-05-15 15:00:00+02:00,136,14,122,16.594078125250377,138,14,124,20.21600799483387,12,1016,0.0,23
2020-05-15 16:00:00+02:00,145,14,131,18.85528596371164,154,15,139,23.457384968254527,12,1016,0.0,23
2020-05-15 17:00:00+02:00,207,22,185,21.877297854955202,202,19,183,22.500350864850866,12,1016,0.0,23
2020-05-15 18:00:00+02:00,218,21,197,22.57742359713229,227,25,202,19.269071808142694,12,1016,0.0,23
2020-05-15 19:00:00+02:00,158,15,143,21.67102174389251,159,15,144,17.78748005044877,12,1016,0.0,23
2020-05-15 20:00:00+02:00,160,14,146,19.89239402952506,159,13,146,17.78748005044877,12,1016,0.0,23
2020-05-15 21:00:00+02:00,123,11,112,19.074654696202938,123,12,111,19.074654696202938,12,1016,0.0,23
2020-05-15 22:00:00+02:00,86,8,78,21.204994436842384,85,7,78,19.289671453475872,12,1016,0.0,23
2020-05-15 23:00:00+02:00,61,6,55,12.362973378192347,58,5,53,10.505136369992313,12,1016,0.0,23
2020-05-16 00:00:00+02:00,84,5,79,7.6306798135980785,88,4,84,8.437594054986977,16,1024,0.0,14
2020-05-16 01:00:00+02:00,54,3,51,11.483713237443984,59,3,56,11.512224289105106,16,1024,0.0,14
2020-05-16 02:00:00+02:00,56,3,53,11.681432660358455,56,3,53,11.681432660358455,16,1024,0.0,14
2020-05-16 03:00:00+02:00,82,5,77,8.6962433625344,88,4,84,8.437594054986977,16,1024,0.0,14
2020-05-16 04:00:00+02:00,109,6,103,18.214376818550008,118,6,112,16.65435568776215,16,1024,0.0,14
2020-05-16 05:00:00+02:00,143,8,135,15.49985590484046,150,9,141,19.93003466929675,16,1024,0.0,14
2020-05-16 06:00:00+02:00,225,12,213,16.518156382279376,241,15,226,17.853279648834448,16,1024,0.0,14
2020-05-16 07:00:00+02:00,330,18,312,18.864376108789497,359,20,339,19.276631617836294,16,1024,0.0,14
2020-05-16 08:00:00+02:00,451,30,421,21.269750099500666,471,31,440,21.514046870792356,16,1024,0.0,14
2020-05-16 09:00:00+02:00,487,28,459,20.801132823441247,514,32,482,17.757565512121285,16,1024,0.0,14
2020-05-16 10:00:00+02:00,439,25,414,16.88815045240334,455,29,426,20.707907447169188,16,1024,0.0,14
2020-05-16 11:00:00+02:00,350,22,328,19.39294883514927,355,19,336,19.867707600873487,16,1024,0.0,14
2020-05-16 12:00:00+02:00,346,22,324,17.93974987663749,362,22,340,18.876684992305748,16,1024,0.0,14
2020-05-16 13:00:00+02:00,357,24,333,16.579219218063535,391,21,370,20.537782610304173,16,1024,0.0,14
2020-05-16 14:00:00+02:00,330,20,310,18.864376108789497,359,20,339,19.276631617836294,16,1024,0.0,14
2020-05-16 15:00:00+02:00,394,26,368,20.620478231973475,414,25,389,20.92110305719904,16,1024,0.0,14
2020-05-16 16:00:00+02:00,396,26,370,19.03159851440849,421,21,400,23.577567366465193,16,1024,0.0,14
2020-05-16 17:00:00+02:00,446,25,421,16.392503795900122,485,26,459,23.26524199136097,16,1024,0.0,14
2020-05-16 18:00:00+02:00,423,27,396,16.440651492044253,442,25,417,22.71527178577055,16,1024,0.0,14
2020-05-16 19:00:00+02:00,334,21,313,17.139636433234756,357,17,340,16.579219218063535,16,1024,0.0,14
2020-05-16 20:00:00+02:00,318,18,300,22.522150292755875,330,21,309,18.864376108789497,16,1024,0.0,14
2020-05-16 21:00:00+02:00,287,17,270,13.917461050382924,298,17,281,19.413448672737985,16,1024,0.0,14
2020-05-16 22:00:00+02:00,221,14,207,21.310706623471727,234,12,222,18.523045519331724,16,1024,0.0,14
2020-05-16 23:00:00+02:00,111,7,104,16.60196152330297,118,6,112,16.65435568776215,16,1024,0.0,14
2020-05-17 00:00:00+02:00,61,2,59,13.45123014142322,61,2,59,13.45123014142322,17,1025,0.0,10
2020-05-17 01:00:00+02:00,36,1,35,2.727177547566476,52,2,50,14.472017643602554,17,1025,0.0,10
2020-05-17 02:00:00+02:00,38,1,37,5.960450042509954,52,2,50,14.472017643602554,17,1025,0.0,10
2020-05-17 03:00:00+02:00,58,2,56,11.561797090249616,58,2,56,11.561797090249616,17,1025,0.0,10
2020-05-17 04:00:00+02:00,72,2,70,10.765287360581397,100,4,96,12.129363492765288,17,1025,0.0,10
2020-05-17 05:00:00+02:00,100,4,96,12.129363492765288,128,5,123,16.268122259148125,17,1025,0.0,10
2020-05-17 06:00:00+02:00,153,6,147,18.67945251137068,158,5,153,19.40470350916573,17,1025,0.0,10
2020-05-17 07:00:00+02:00,250,9,241,19.251014174910523,250,8,242,19.251014174910523,17,1025,0.0,10
2020-05-17 08:00:00+02:00,300,11,289,22.416712006057992,334,13,321,17.139636433234756,17,1025,0.0,10
2020-05-17 09:00:00+02:00,336,12,324,15.374523455613796,448,14,434,19.19628206057244,17,1025,0.0,10
2020-05-17 10:00:00+02:00,311,11,300,18.777054340822975,320,12,308,21.84611391715035,17,1025,0.0,10
2020-05-17 11:00:00+02:00,247,10,237,19.091366395871336,300,11,289,22.416712006057992,17,1025,0.0,10
2020-05-17 12:00:00+02:00,225,9,216,16.518156382279376,250,9,241,19.251014174910523,17,1025,0.0,10
2020-05-17 13:00:00+02:00,245,9,236,17.30944248589229,348,15,333,18.741511759901247,17,1025,0.0,10
2020-05-17 14:00:00+02:00,245,10,235,17.30944248589229,320,14,306,21.84611391715035,17,1025,0.0,10
2020-05-17 15:00:00+02:00,289,12,277,18.938144972747136,300,10,290,22.416712006057992,17,1025,0.0,10
2020-05-17 16:00:00+02:00,261,10,251,17.831444140197515,384,14,370,20.93762948810624,17,1025,0.0,10
2020-05-17 17:00:00+02:00,328,13,315,18.977288676463566,439,15,424,16.88815045240334,17,1025,0.0,10
2020-05-17 18:00:00+02:00,284,11,273,16.935782048371557,336,11,325,15.374523455613796,17,1025,0.0,10
2020-05-17 19:00:00+02:00,242,8,234,18.93135513529779,278,11,267,19.287262138921047,17,1025,0.0,10
2020-05-17 20:00:00+02:00,211,8,203,15.949558582123627,231,8,223,18.808415660395674,17,1025,0.0,10
2020-05-17 21:00:00+02:00,200,8,192,21.668114478408352,236,8,228,18.261863976847756,17,1025,0.0,10
2020-05-17 22:00:00+02:00,153,6,147,18.67945251137068,158,5,153,19.40470350916573,17,1025,0.0,10
2020-05-17 23:00:00+02:00,83,3,80,9.333357558089729,89,2,87,10.527801976587284,17,1025,0.0,10
2020-05-18 00:00:00+02:00,107,11,96,12.156196464705383,113,14,99,20.093188266697116,19,1023,0.0,10
2020-05-18 01:00:00+02:00,74,7,67,19.513800836509724,77,8,69,16.632320143368542,19,1023,0.0,10
2020-05-18 02:00:00+02:00,77,8,69,16.632320143368542,77,9,68,16.632320143368542,19,1023,0.0,10
2020-05-18 03:00:00+02:00,116,12,104,23.67872830820291,116,14,102,23.67872830820291,19,1023,0.0,10
2020-05-18 04:00:00+02:00,194,19,175,21.593451125557873,194,23,171,21.593451125557873,19,1023,0.0,10
2020-05-18 05:00:00+02:00,353,32,321,20.016393666106563,350,43,307,21.39774246689966,19,1023,0.0,10
2020-05-18 06:00:00+02:00,425,43,382,20.977086023346995,422,46,376,20.257299015157166,19,1023,0.0,10
2020-05-18 07:00:00+02:00,631,68,563,19.637448203371804,637,60,577,20.615078570692955,19,1023,0.0,10
2020-05-18 08:00:00+02:00,685,73,612,22.980275291432218,685,68,617,22.980275291432218,19,1023,0.0,10
2020-05-18 09:00:00+02:00,451,42,409,20.489203978314702,466,49,417,20.265872741633896,19,1023,0.0,10
2020-05-18 10:00:00+02:00,368,33,335,19.722641588533307,377,42,335,16.83689607567409,19,1023,0.0,10
2020-05-18 11:00:00+02:00,475,46,429,26.73035993542065,463,48,415,21.06469305151698,19,1023,0.0,10
2020-05-18 12:00:00+02:00,368,33,335,19.722641588533307,377,42,335,16.83689607567409,19,1023,0.0,10
2020-05-18 13:00:00+02:00,395,38,357,19.65690968439359,383,41,342,23.132924781238575,19,1023,0.0,10
2020-05-18 14:00:00+02:00,392,39,353,15.515848376438075,383,41,342,23.132924781238575,19,1023,0.0,10
2020-05-18 15:00:00+02:00,431,43,388,17.591114272986506,425,53,372,20.977086023346995,19,1023,0.0,10
2020-05-18 16:00:00+02:00,457,45,412,24.393218626777333,469,58,411,24.504404421652193,19,1023,0.0,10
2020-05-18 17:00:00+02:00,667,65,602,22.082918216313388,670,77,593,16.908196156468264,19,1023,0.0,10
2020-05-18 18:00:00+02:00,670,64,606,16.908196156468264,706,70,636,19.75534206734452,19,1023,0.0,10
2020-05-18 19:00:00+02:00,469,49,420,24.504404421652193,505,53,452,18.43415123810773,19,1023,0.0,10
2020-05-18 20:00:00+02:00,502,54,448,11.735836537408174,496,58,438,19.543873703625547,19,1023,0.0,10
2020-05-18 21:00:00+02:00,380,39,341,15.070197513038655,377,46,331,16.83689607567409,19,1023,0.0,10
2020-05-18 22:00:00+02:00,275,26,249,24.67224255888931,269,34,235,17.49919499982951,19,1023,0.0,10
2020-05-18 23:00:00+02:00,188,17,171,22.908938245974742,194,21,173,21.593451125557873,19,1023,0.0,10
2020-05-19 00:00:00+02:00,118,11,107,23.272574380346793,128,12,116,19.601953989978306,20,1026,0.0,9
2020-05-19 01:00:00+02:00,73,6,67,16.592478063282112,86,8,78,21.204994436842384,20,1026,0.0,9
2020-05-19 02:00:00+02:00,73,6,67,16.592478063282112,86,8,78,21.204994436842384,20,1026,0.0,9
2020-05-19 03:00:00+02:00,112,9,103,14.898852003445265,121,11,110,20.317620945183666,20,1026,0.0,9
2020-05-19 04:00:00+02:00,201,16,185,22.51450761920508,201,20,181,22.51450761920508,20,1026,0.0,9
2020-05-19 05:00:00+02:00,329,30,299,19.339935066365534,384,38,346,23.18758332904822,20,1026,0.0,9
2020-05-19 06:00:00+02:00,438,43,395,22.221490993016946,438,37,401,22.221490993016946,20,1026,0.0,9
2020-05-19 07:00:00+02:00,611,50,561,19.45228913824497,729,69,660,21.58109769638764,20,1026,0.0,9
2020-05-19 08:00:00+02:00,736,71,665,21.05706952478318,781,78,703,21.0241020485366,20,1026,0.0,9
2020-05-19 09:00:00+02:00,496,42,454,19.543873703625547,502,53,449,11.735836537408174,20,1026,0.0,9
2020-05-19 10:00:00+02:00,380,35,345,15.070197513038655,406,45,361,17.471736216533994,20,1026,0.0,9
2020-05-19 11:00:00+02:00,483,40,443,21.366599546374843,496,50,446,19.543873703625547,20,1026,0.0,9
2020-05-19 12:00:00+02:00,380,35,345,15.070197513038655,406,45,361,17.471736216533994,20,1026,0.0,9
2020-05-19 13:00:00+02:00,400,33,367,22.17455177589486,406,37,369,17.471736216533994,20,1026,0.0,9
2020-05-19 14:00:00+02:00,400,33,367,22.17455177589486,406,37,369,17.471736216533994,20,1026,0.0,9
2020-05-19 15:00:00+02:00,441,36,405,21.65218956350676,454,40,414,21.947231747967304,20,1026,0.0,9
2020-05-19 16:00:00+02:00,454,43,411,21.947231747967304,502,54,448,11.735836537408174,20,1026,0.0,9
2020-05-19 17:00:00+02:00,646,61,585,22.66748986971251,685,69,616,22.980275291432218,20,1026,0.0,9
2020-05-19 18:00:00+02:00,678,57,621,23.0345965861014,752,80,672,22.67041366966842,20,1026,0.0,9
2020-05-19 19:00:00+02:00,496,47,449,19.543873703625547,544,57,487,25.1241889325097,20,1026,0.0,9
2020-05-19 20:00:00+02:00,528,44,484,18.074163042875583,550,61,489,18.784836702474678,20,1026,0.0,9
2020-05-19 21:00:00+02:00,377,31,346,16.83689607567409,435,41,394,21.80027200191571,20,1026,0.0,9
2020-05-19 22:00:00+02:00,259,23,236,22.988395045636892,284,26,258,21.60666647068217,20,1026,0.0,9
2020-05-19 23:00:00+02:00,188,15,173,22.908938245974742,214,23,191,18.560318290748608,20,1026,0.0,9
2020-05-20 00:00:00+02:00,117,14,103,12.235552510813584,105,11,94,16.064586492970292,21,1024,0.0,11
2020-05-20 01:00:00+02:00,77,9,68,18.339246781129614,74,7,67,17.73542510561878,21,1024,0.0,11
2020-05-20 02:00:00+02:00,77,9,68,18.339246781129614,74,7,67,17.73542510561878,21,1024,0.0,11
2020-05-20 03:00:00+02:00,117,14,103,12.235552510813584,105,11,94,16.064586492970292,21,1024,0.0,11
2020-05-20 04:00:00+02:00,195,25,170,21.502321255791472,180,18,162,12.812395378741206,21,1024,0.0,11
2020-05-20 05:00:00+02:00,353,47,306,16.072474715915927,335,38,297,22.25380340127623,21,1024,0.0,11
2020-05-20 06:00:00+02:00,428,48,380,23.45979362673577,394,49,345,22.05126282448999,21,1024,0.0,11
2020-05-20 07:00:00+02:00,664,77,587,22.61074383090897,614,71,543,21.415297218291705,21,1024,0.0,11
2020-05-20 08:00:00+02:00,714,88,626,21.081745806887525,630,74,556,18.08859787789587,21,1024,0.0,11
2020-05-20 09:00:00+02:00,471,58,413,19.847986208788534,468,46,422,20.750300610230987,21,1024,0.0,11
2020-05-20 10:00:00+02:00,394,47,347,22.05126282448999,360,35,325,16.973963768814748,21,1024,0.0,11
2020-05-20 11:00:00+02:00,468,58,410,20.750300610230987,459,47,412,18.82558288556513,21,1024,0.0,11
2020-05-20 12:00:00+02:00,400,47,353,24.218092797619367,369,39,330,19.817242898821007,21,1024,0.0,11
2020-05-20 13:00:00+02:00,397,47,350,17.68183590028467,350,38,312,22.47956536478983,21,1024,0.0,11
2020-05-20 14:00:00+02:00,394,52,342,22.05126282448999,360,35,325,16.973963768814748,21,1024,0.0,11
2020-05-20 15:00:00+02:00,428,53,375,23.45979362673577,394,49,345,22.05126282448999,21,1024,0.0,11
2020-05-20 16:00:00+02:00,468,54,414,20.750300610230987,459,47,412,18.82558288556513,21,1024,0.0,11
2020-05-20 17:00:00+02:00,679,79,600,18.393282470342562,658,65,593,15.999136717904042,21,1024,0.0,11
2020-05-20 18:00:00+02:00,698,79,619,14.099832565474687,676,83,593,23.647869444147233,21,1024,0.0,11
2020-05-20 19:00:00+02:00,515,60,455,22.381653126515868,515,49,466,22.381653126515868,21,1024,0.0,11
2020-05-20 20:00:00+02:00,518,59,459,19.12914003399451,515,52,463,22.381653126515868,21,1024,0.0,11
2020-05-20 21:00:00+02:00,397,45,352,17.68183590028467,350,38,312,22.47956536478983,21,1024,0.0,11
2020-05-20 22:00:00+02:00,273,36,237,26.59294853191911,276,30,246,17.34974806433115,21,1024,0.0,11
2020-05-20 23:00:00+02:00,195,22,173,21.502321255791472,180,18,162,12.812395378741206,21,1024,0.0,11
2020-05-21 00:00:00+02:00,129,11,118,17.995114557081255,137,17,120,18.928795118329443,24,1021,0.0,7
2020-05-21 01:00:00+02:00,80,6,74,18.237765354324676,91,11,80,13.154481673544206,24,1021,0.0,7
2020-05-21 02:00:00+02:00,95,8,87,11.735389228725284,91,12,79,13.154481673544206,24,1021,0.0,7
2020-05-21 03:00:00+02:00,141,12,129,21.00935462418931,145,20,125,18.85528596371164,24,1021,0.0,7
2020-05-21 04:00:00+02:00,229,18,211,19.950856030294574,236,30,206,19.106111918840778,24,1021,0.0,7
2020-05-21 05:00:00+02:00,397,35,362,20.240119954252663,416,61,355,17.117872401421668,24,1021,0.0,7
2020-05-21 06:00:00+02:00,515,39,476,22.56064635427968,515,76,439,22.56064635427968,24,1021,0.0,7
2020-05-21 07:00:00+02:00,790,71,719,21.457979516538586,805,111,694,24.432728502533333,24,1021,0.0,7
2020-05-21 08:00:00+02:00,836,70,766,21.975494772407213,836,116,720,21.975494772407213,24,1021,0.0,7
2020-05-21 09:00:00+02:00,519,42,477,18.136209473828288,572,87,485,22.464428218647974,24,1021,0.0,7
2020-05-21 10:00:00+02:00,469,37,432,24.504404421652193,484,66,418,17.863314460235074,24,1021,0.0,7
2020-05-21 11:00:00+02:00,545,42,503,19.63111833719715,534,68,466,22.13831863455401,24,1021,0.0,7
2020-05-21 12:00:00+02:00,423,34,389,23.290663678046883,473,76,397,22.543653481241357,24,1021,0.0,7
2020-05-21 13:00:00+02:00,435,35,400,21.80027200191571,458,65,393,24.591159780297854,24,1021,0.0,7
2020-05-21 14:00:00+02:00,458,41,417,24.591159780297854,488,77,411,14.865596092809506,24,1021,0.0,7
2020-05-21 15:00:00+02:00,492,41,451,19.891083729909596,534,74,460,22.13831863455401,24,1021,0.0,7
2020-05-21 16:00:00+02:00,507,41,466,20.732028813124888,538,76,462,22.05606214078663,24,1021,0.0,7
2020-05-21 17:00:00+02:00,706,56,650,19.75534206734452,759,116,643,23.764447281483374,24,1021,0.0,7
2020-05-21 18:00:00+02:00,813,67,746,22.527079347661243,870,132,738,21.08765866587288,24,1021,0.0,7
2020-05-21 19:00:00+02:00,637,53,584,20.615078570692955,610,97,513,19.929525822534373,24,1021,0.0,7
2020-05-21 20:00:00+02:00,599,49,550,22.66737383874895,610,75,535,19.929525822534373,24,1021,0.0,7
2020-05-21 21:00:00+02:00,461,37,424,24.16987876504356,442,64,378,20.352399635415985,24,1021,0.0,7
2020-05-21 22:00:00+02:00,297,23,274,18.348417493587977,316,39,277,20.52457281115525,24,1021,0.0,7
2020-05-21 23:00:00+02:00,240,18,222,16.023164601360044,232,33,199,14.357520231191923,24,1021,0.0,7
2020-05-22 00:00:00+02:00,122,11,111,20.245567873519157,125,13,112,23.026828253397017,22,1020,0.0,10
2020-05-22 01:00:00+02:00,79,7,72,16.382916607013883,79,7,72,16.382916607013883,22,1020,0.0,10
2020-05-22 02:00:00+02:00,79,7,72,16.382916607013883,79,7,72,16.382916607013883,22,1020,0.0,10
2020-05-22 03:00:00+02:00,122,11,111,20.245567873519157,125,13,112,23.026828253397017,22,1020,0.0,10
2020-05-22 04:00:00+02:00,204,18,186,12.517560993101368,195,21,174,23.83440770251287,22,1020,0.0,10
2020-05-22 05:00:00+02:00,380,40,340,15.070197513038655,353,39,314,20.016393666106563,22,1020,0.0,10
2020-05-22 06:00:00+02:00,456,49,407,14.42236972784694,439,44,395,18.965638166337634,22,1020,0.0,10
2020-05-22 07:00:00+02:00,677,61,616,20.739584517025623,704,79,625,26.58879619211277,22,1020,0.0,10
2020-05-22 08:00:00+02:00,763,82,681,23.496566522844443,740,81,659,22.499704569771684,22,1020,0.0,10
2020-05-22 09:00:00+02:00,489,51,438,13.901530333723658,499,51,448,21.95846674548548,22,1020,0.0,10
2020-05-22 10:00:00+02:00,419,43,376,22.446709242047174,409,46,363,21.723119645649348,22,1020,0.0,10
2020-05-22 11:00:00+02:00,482,52,430,19.903175971447034,505,45,460,18.43415123810773,22,1020,0.0,10
2020-05-22 12:00:00+02:00,413,45,368,24.398754434847095,390,38,352,23.204029211730827,22,1020,0.0,10
2020-05-22 13:00:00+02:00,406,44,362,17.471736216533994,390,36,354,23.204029211730827,22,1020,0.0,10
2020-05-22 14:00:00+02:00,406,44,362,17.471736216533994,390,36,354,23.204029211730827,22,1020,0.0,10
2020-05-22 15:00:00+02:00,446,48,398,22.957333740469338,436,44,392,21.770703310925605,22,1020,0.0,10
2020-05-22 16:00:00+02:00,479,43,436,24.037051458292083,479,48,431,24.037051458292083,22,1020,0.0,10
2020-05-22 17:00:00+02:00,690,69,621,25.111985253913545,704,77,627,26.58879619211277,22,1020,0.0,10
2020-05-22 18:00:00+02:00,763,82,681,23.496566522844443,740,81,659,22.499704569771684,22,1020,0.0,10
2020-05-22 19:00:00+02:00,532,55,477,22.31530989594808,548,51,497,21.450998981477422,22,1020,0.0,10
2020-05-22 20:00:00+02:00,532,50,482,22.31530989594808,548,51,497,21.450998981477422,22,1020,0.0,10
2020-05-22 21:00:00+02:00,409,39,370,21.723119645649348,393,44,349,19.01393712330975,22,1020,0.0,10
2020-05-22 22:00:00+02:00,281,28,253,17.665733770068634,287,32,255,21.927304089805975,22,1020,0.0,10
2020-05-22 23:00:00+02:00,204,19,185,12.517560993101368,195,21,174,23.83440770251287,22,1020,0.0,10
2020-05-23 00:00:00+02:00,128,8,120,16.268122259148125,132,8,124,15.82621260035259,18,1024,0.1,4
2020-05-23 01:00:00+02:00,81,5,76,13.380409900215524,88,4,84,8.437594054986977,18,1024,0.1,4
2020-05-23 02:00:00+02:00,81,5,76,13.380409900215524,88,4,84,8.437594054986977,18,1024,0.1,4
2020-05-23 03:00:00+02:00,122,7,115,15.53082002471091,132,6,126,15.82621260035259,18,1024,0.1,4
2020-05-23 04:00:00+02:00,166,11,155,16.094287115128708,176,11,165,16.20057962349047,18,1024,0.1,4
2020-05-23 05:00:00+02:00,203,11,192,16.97445579481889,220,11,209,20.77869221062603,18,1024,0.1,4
2020-05-23 06:00:00+02:00,328,19,309,18.977288676463566,359,19,340,19.276631617836294,18,1024,0.1,4
2020-05-23 07:00:00+02:00,501,34,467,17.91816636651384,538,33,505,19.746681426359476,18,1024,0.1,4
2020-05-23 08:00:00+02:00,694,39,655,21.443594821216653,701,36,665,20.941035743755,18,1024,0.1,4
2020-05-23 09:00:00+02:00,694,45,649,21.443594821216653,742,38,704,24.496625617076848,18,1024,0.1,4
2020-05-23 10:00:00+02:00,620,37,583,15.579919444904501,657,33,624,18.41823661952385,18,1024,0.1,4
2020-05-23 11:00:00+02:00,518,33,485,17.06195195164026,528,33,495,15.389090213676,18,1024,0.1,4
2020-05-23 12:00:00+02:00,511,29,482,19.764267366555824,538,34,504,19.746681426359476,18,1024,0.1,4
2020-05-23 13:00:00+02:00,562,32,530,20.69762036490505,582,31,551,19.823905045221323,18,1024,0.1,4
2020-05-23 14:00:00+02:00,508,32,476,11.879495628294928,538,36,502,19.746681426359476,18,1024,0.1,4
2020-05-23 15:00:00+02:00,606,34,572,21.223883053081224,613,37,576,17.497047599626537,18,1024,0.1,4
2020-05-23 16:00:00+02:00,582,36,546,19.823905045221323,623,37,586,14.07878882035954,18,1024,0.1,4
2020-05-23 17:00:00+02:00,657,37,620,18.41823661952385,718,43,675,20.462615963204737,18,1024,0.1,4
2020-05-23 18:00:00+02:00,643,40,603,20.52198944499182,654,33,621,17.672629386873176,18,1024,0.1,4
2020-05-23 19:00:00+02:00,518,32,486,17.06195195164026,528,33,495,15.389090213676,18,1024,0.1,4
2020-05-23 20:00:00+02:00,467,27,440,16.282567715081857,488,30,458,21.564433597573284,18,1024,0.1,4
2020-05-23 21:00:00+02:00,423,28,395,16.440651492044253,437,25,412,20.40675859398746,18,1024,0.1,4
2020-05-23 22:00:00+02:00,342,20,322,17.3694729072073,355,21,334,19.867707600873487,18,1024,0.1,4
2020-05-23 23:00:00+02:00,169,10,159,20.526675282456768,179,10,169,21.74229179161351,18,1024,0.1,4
2020-05-24 00:00:00+02:00,53,2,51,12.671576687621188,56,2,54,11.681432660358455,18,1032,0.0,12
2020-05-24 01:00:00+02:00,35,1,34,5.369702870779087,37,1,36,3.5125252112896685,18,1032,0.0,12
2020-05-24 02:00:00+02:00,37,1,36,3.5125252112896685,51,2,49,13.024781207847502,18,1032,0.0,12
2020-05-24 03:00:00+02:00,56,2,54,11.681432660358455,56,2,54,11.681432660358455,18,1032,0.0,12
2020-05-24 04:00:00+02:00,70,2,68,11.628132043946147,83,3,80,9.333357558089729,18,1032,0.0,12
2020-05-24 05:00:00+02:00,91,3,88,8.844154374326946,113,4,109,20.97275705288615,18,1032,0.0,12
2020-05-24 06:00:00+02:00,148,5,143,21.655119289441767,177,6,171,13.959346220493531,18,1032,0.0,12
2020-05-24 07:00:00+02:00,221,8,213,21.310706623471727,234,8,226,18.523045519331724,18,1032,0.0,12
2020-05-24 08:00:00+02:00,299,12,287,16.471342376610473,328,13,315,18.977288676463566,18,1032,0.0,12
2020-05-24 09:00:00+02:00,337,12,325,20.189680789887703,388,13,375,20.16254491947918,18,1032,0.0,12
2020-05-24 10:00:00+02:00,299,12,287,16.471342376610473,310,13,297,15.258998808795859,18,1032,0.0,12
2020-05-24 11:00:00+02:00,218,8,210,17.36015147829793,229,9,220,20.858973540615885,18,1032,0.0,12
2020-05-24 12:00:00+02:00,226,9,217,15.467390071610119,242,9,233,18.93135513529779,18,1032,0.0,12
2020-05-24 13:00:00+02:00,242,10,232,18.93135513529779,291,11,280,14.14711867692869,18,1032,0.0,12
2020-05-24 14:00:00+02:00,231,9,222,18.808415660395674,302,13,289,20.352052927472357,18,1032,0.0,12
2020-05-24 15:00:00+02:00,264,10,254,17.866837611646663,337,11,326,20.189680789887703,18,1032,0.0,12
2020-05-24 16:00:00+02:00,264,9,255,17.866837611646663,337,11,326,20.189680789887703,18,1032,0.0,12
2020-05-24 17:00:00+02:00,302,11,291,20.352052927472357,364,13,351,14.261868127983336,18,1032,0.0,12
2020-05-24 18:00:00+02:00,302,12,290,20.352052927472357,339,12,327,18.9351903306688,18,1032,0.0,12
2020-05-24 19:00:00+02:00,229,10,219,20.858973540615885,280,11,269,18.26048171051442,18,1032,0.0,12
2020-05-24 20:00:00+02:00,207,7,200,18.76558942906742,280,10,270,18.26048171051442,18,1032,0.0,12
2020-05-24 21:00:00+02:00,188,6,182,19.664617237016223,223,7,216,18.802339292525456,18,1032,0.0,12
2020-05-24 22:00:00+02:00,151,6,145,19.14578123638998,177,5,172,13.959346220493531,18,1032,0.0,12
2020-05-24 23:00:00+02:00,72,2,70,10.765287360581397,97,4,93,12.91170780960746,18,1032,0.0,12
2020-05-25 00:00:00+02:00,114,11,103,18.09348958441383,114,14,100,18.09348958441383,19,1034,0.0,10
2020-05-25 01:00:00+02:00,75,8,67,14.734681497037354,78,8,70,16.41986115786707,19,1034,0.0,10
2020-05-25 02:00:00+02:00,75,7,68,14.734681497037354,78,8,70,16.41986115786707,19,1034,0.0,10
2020-05-25 03:00:00+02:00,114,11,103,18.09348958441383,114,14,100,18.09348958441383,19,1034,0.0,10
2020-05-25 04:00:00+02:00,186,20,166,22.772295906033783,198,18,180,18.14522738171017,19,1034,0.0,10
2020-05-25 05:00:00+02:00,354,32,322,21.22371738501729,357,36,321,21.912097396672888,19,1034,0.0,10
2020-05-25 06:00:00+02:00,414,39,375,21.211929621647883,435,51,384,21.80027200191571,19,1034,0.0,10
2020-05-25 07:00:00+02:00,636,63,573,21.66562740120439,654,81,573,19.20246702812759,19,1034,0.0,10
2020-05-25 08:00:00+02:00,654,65,589,19.20246702812759,675,75,600,21.979534499692953,19,1034,0.0,10
2020-05-25 09:00:00+02:00,465,50,415,19.650501243200726,477,56,421,19.637502490728593,19,1034,0.0,10
2020-05-25 10:00:00+02:00,399,39,360,20.89817652151005,381,43,338,21.060383299923174,19,1034,0.0,10
2020-05-25 11:00:00+02:00,468,47,421,19.71650853762924,453,43,410,18.726095790194968,19,1034,0.0,10
2020-05-25 12:00:00+02:00,375,38,337,22.64494297948435,384,40,344,23.18758332904822,19,1034,0.0,10
2020-05-25 13:00:00+02:00,393,39,354,19.01393712330975,378,42,336,19.765573549462566,19,1034,0.0,10
2020-05-25 14:00:00+02:00,384,35,349,23.18758332904822,393,49,344,19.01393712330975,19,1034,0.0,10
2020-05-25 15:00:00+02:00,408,41,367,21.369431512154076,417,52,365,23.51661645113794,19,1034,0.0,10
2020-05-25 16:00:00+02:00,441,43,398,21.65218956350676,456,45,411,14.42236972784694,19,1034,0.0,10
2020-05-25 17:00:00+02:00,636,64,572,21.66562740120439,654,81,573,19.20246702812759,19,1034,0.0,10
2020-05-25 18:00:00+02:00,654,65,589,19.20246702812759,675,75,600,21.979534499692953,19,1034,0.0,10
2020-05-25 19:00:00+02:00,504,54,450,17.785796251967053,501,56,445,20.940750692732994,19,1034,0.0,10
2020-05-25 20:00:00+02:00,501,50,451,20.940750692732994,501,56,445,20.940750692732994,19,1034,0.0,10
2020-05-25 21:00:00+02:00,384,38,346,23.18758332904822,393,49,344,19.01393712330975,19,1034,0.0,10
2020-05-25 22:00:00+02:00,261,26,235,21.270868579361668,267,32,235,13.385499595100717,19,1034,0.0,10
2020-05-25 23:00:00+02:00,192,18,174,21.295822766447603,192,20,172,21.295822766447603,19,1034,0.0,10
2020-05-26 00:00:00+02:00,104,9,95,11.935148455597123,116,13,103,23.67872830820291,20,1034,0.0,12
2020-05-26 01:00:00+02:00,72,6,66,19.53768091870668,78,7,71,16.41986115786707,20,1034,0.0,12
2020-05-26 02:00:00+02:00,69,6,63,19.29595730158091,72,7,65,19.53768091870668,20,1034,0.0,12
2020-05-26 03:00:00+02:00,107,9,98,12.156196464705383,110,12,98,16.975871844207738,20,1034,0.0,12
2020-05-26 04:00:00+02:00,162,14,148,19.08849102929865,189,16,173,18.951286202533417,20,1034,0.0,12
2020-05-26 05:00:00+02:00,305,26,279,19.342371998402466,334,30,304,23.256671102053218,20,1034,0.0,12
2020-05-26 06:00:00+02:00,386,35,351,18.304254687443294,436,41,395,21.770703310925605,20,1034,0.0,12
2020-05-26 07:00:00+02:00,555,45,510,17.57269749774077,672,70,602,20.239222641694617,20,1034,0.0,12
2020-05-26 08:00:00+02:00,654,55,599,19.20246702812759,657,66,591,15.746859620588204,20,1034,0.0,12
2020-05-26 09:00:00+02:00,442,42,400,20.352399635415985,450,40,410,19.966269019650863,20,1034,0.0,12
2020-05-26 10:00:00+02:00,360,31,329,23.455775768432638,378,43,335,19.765573549462566,20,1034,0.0,12
2020-05-26 11:00:00+02:00,418,35,383,19.740254716385955,462,52,410,18.95008410951899,20,1034,0.0,12
2020-05-26 12:00:00+02:00,372,35,337,17.388398109436665,381,35,346,21.060383299923174,20,1034,0.0,12
2020-05-26 13:00:00+02:00,372,33,339,17.388398109436665,381,35,346,21.060383299923174,20,1034,0.0,12
2020-05-26 14:00:00+02:00,372,33,339,17.388398109436665,381,35,346,21.060383299923174,20,1034,0.0,12
2020-05-26 15:00:00+02:00,410,37,373,20.532450928302634,407,46,361,19.32368199778255,20,1034,0.0,12
2020-05-26 16:00:00+02:00,401,39,362,26.708807440790352,453,47,406,18.726095790194968,20,1034,0.0,12
2020-05-26 17:00:00+02:00,637,54,583,20.615078570692955,651,72,579,21.210094405241282,20,1034,0.0,12
2020-05-26 18:00:00+02:00,590,54,536,24.741329330337763,669,69,600,21.432133936827082,20,1034,0.0,12
2020-05-26 19:00:00+02:00,450,40,410,19.966269019650863,514,49,465,17.018673574730677,20,1034,0.0,12
2020-05-26 20:00:00+02:00,474,47,427,24.663345069259766,497,48,449,23.514377363791095,20,1034,0.0,12
2020-05-26 21:00:00+02:00,346,32,314,20.434066589603663,386,44,342,18.304254687443294,20,1034,0.0,12
2020-05-26 22:00:00+02:00,253,22,231,24.084070139549794,264,28,236,20.665980174270672,20,1034,0.0,12
2020-05-26 23:00:00+02:00,171,14,157,22.137070929890193,186,17,169,22.772295906033783,20,1034,0.0,12
2020-05-27 00:00:00+02:00,118,13,105,10.554596808477891,118,12,106,10.554596808477891,21,1034,0.0,11
2020-05-27 01:00:00+02:00,77,9,68,18.339246781129614,74,7,67,17.73542510561878,21,1034,0.0,11
2020-05-27 02:00:00+02:00,77,9,68,18.339246781129614,74,7,67,17.73542510561878,21,1034,0.0,11
2020-05-27 03:00:00+02:00,118,14,104,10.554596808477891,118,12,106,10.554596808477891,21,1034,0.0,11
2020-05-27 04:00:00+02:00,199,24,175,17.787925292792103,183,18,165,17.172205393338412,21,1034,0.0,11
2020-05-27 05:00:00+02:00,355,48,307,20.819485457974345,336,33,303,21.23683051193233,21,1034,0.0,11
2020-05-27 06:00:00+02:00,439,60,379,16.350256884360807,392,42,350,15.3731079641605,21,1034,0.0,11
2020-05-27 07:00:00+02:00,675,92,583,15.477752346599248,666,77,589,21.837239142201785,21,1034,0.0,11
2020-05-27 08:00:00+02:00,710,85,625,16.035875168174858,635,62,573,21.88621109522368,21,1034,0.0,11
2020-05-27 09:00:00+02:00,467,52,415,23.392169574456698,460,47,413,18.80828405121806,21,1034,0.0,11
2020-05-27 10:00:00+02:00,395,47,348,23.668029988595116,386,41,345,23.082433245575533,21,1034,0.0,11
2020-05-27 11:00:00+02:00,473,55,418,16.817858484085946,470,46,424,23.537297655736996,21,1034,0.0,11
2020-05-27 12:00:00+02:00,398,52,346,17.528461730035602,398,47,351,17.528461730035602,21,1034,0.0,11
2020-05-27 13:00:00+02:00,401,52,349,22.736863038328757,395,42,353,23.668029988595116,21,1034,0.0,11
2020-05-27 14:00:00+02:00,398,48,350,17.528461730035602,398,47,351,17.528461730035602,21,1034,0.0,11
2020-05-27 15:00:00+02:00,439,57,382,16.350256884360807,392,42,350,15.3731079641605,21,1034,0.0,11
2020-05-27 16:00:00+02:00,476,64,412,21.264665184026093,429,41,388,17.80816630829195,21,1034,0.0,11
2020-05-27 17:00:00+02:00,672,82,590,21.36791382683399,622,63,559,18.37367322896824,21,1034,0.0,11
2020-05-27 18:00:00+02:00,703,89,614,22.01266771154431,635,73,562,21.88621109522368,21,1034,0.0,11
2020-05-27 19:00:00+02:00,504,56,448,23.46731722283721,479,56,423,11.814570973379602,21,1034,0.0,11
2020-05-27 20:00:00+02:00,510,62,448,18.942458099303334,507,57,450,15.628100284848658,21,1034,0.0,11
2020-05-27 21:00:00+02:00,392,50,342,15.3731079641605,389,49,340,21.07501193814523,21,1034,0.0,11
2020-05-27 22:00:00+02:00,277,31,246,22.842683015901265,264,25,239,19.326928751905097,21,1034,0.0,11
2020-05-27 23:00:00+02:00,193,22,171,18.658224506029875,180,18,162,12.812395378741206,21,1034,0.0,11
2020-05-28 00:00:00+02:00,88,7,81,17.756927742208592,99,15,84,10.779955578794215,20,1033,0.0,15
2020-05-28 01:00:00+02:00,57,4,53,10.480552878481939,65,8,57,15.361527134905547,20,1033,0.0,15
2020-05-28 02:00:00+02:00,65,5,60,15.361527134905547,65,10,55,15.361527134905547,20,1033,0.0,15
2020-05-28 03:00:00+02:00,99,8,91,10.779955578794215,93,13,80,12.914854269394333,20,1033,0.0,15
2020-05-28 04:00:00+02:00,159,12,147,17.78748005044877,159,19,140,17.78748005044877,20,1033,0.0,15
2020-05-28 05:00:00+02:00,297,23,274,18.348417493587977,279,35,244,23.809963875172556,20,1033,0.0,15
2020-05-28 06:00:00+02:00,333,30,303,26.7685298712925,349,54,295,16.300891984453436,20,1033,0.0,15
2020-05-28 07:00:00+02:00,516,40,476,23.45871840478751,519,72,447,18.136209473828288,20,1033,0.0,15
2020-05-28 08:00:00+02:00,547,47,500,20.747394942344446,555,76,479,17.57269749774077,20,1033,0.0,15
2020-05-28 09:00:00+02:00,372,31,341,17.388398109436665,383,51,332,23.132924781238575,20,1033,0.0,15
2020-05-28 10:00:00+02:00,331,28,303,18.08059708638437,312,41,271,18.640393178431868,20,1033,0.0,15
2020-05-28 11:00:00+02:00,393,35,358,19.01393712330975,375,54,321,22.64494297948435,20,1033,0.0,15
2020-05-28 12:00:00+02:00,297,23,274,18.348417493587977,310,38,272,16.921651532922695,20,1033,0.0,15
2020-05-28 13:00:00+02:00,299,23,276,15.06368464327721,307,43,264,19.62844127124222,20,1033,0.0,15
2020-05-28 14:00:00+02:00,289,25,264,20.14984129628082,307,40,267,19.62844127124222,20,1033,0.0,15
2020-05-28 15:00:00+02:00,318,28,290,21.634505447676812,341,49,292,14.480776847696712,20,1033,0.0,15
2020-05-28 16:00:00+02:00,367,27,340,20.047055443111752,367,59,308,20.047055443111752,20,1033,0.0,15
2020-05-28 17:00:00+02:00,482,43,439,19.903175971447034,563,73,490,20.337981892053655,20,1033,0.0,15
2020-05-28 18:00:00+02:00,534,43,491,22.13831863455401,560,79,481,19.606018509461766,20,1033,0.0,15
2020-05-28 19:00:00+02:00,386,31,355,18.304254687443294,435,59,376,21.80027200191571,20,1033,0.0,15
2020-05-28 20:00:00+02:00,380,31,349,15.070197513038655,404,64,340,21.094548442403457,20,1033,0.0,15
2020-05-28 21:00:00+02:00,315,24,291,16.084372336057935,310,44,266,16.921651532922695,20,1033,0.0,15
2020-05-28 22:00:00+02:00,208,16,192,17.851758798784658,226,28,198,20.308697708911414,20,1033,0.0,15
2020-05-28 23:00:00+02:00,143,11,132,22.510370466296816,156,24,132,23.175119746499636,20,1033,0.0,15
2020-05-29 00:00:00+02:00,78,8,70,16.41986115786707,81,7,74,16.076626545182606,18,1028,0.0,17
2020-05-29 01:00:00+02:00,54,5,49,10.37826089518735,54,6,48,10.37826089518735,18,1028,0.0,17
2020-05-29 02:00:00+02:00,54,5,49,10.37826089518735,54,6,48,10.37826089518735,18,1028,0.0,17
2020-05-29 03:00:00+02:00,81,8,73,16.076626545182606,81,7,74,16.076626545182606,18,1028,0.0,17
2020-05-29 04:00:00+02:00,138,13,125,20.21600799483387,127,13,114,19.116953333289125,18,1028,0.0,17
2020-05-29 05:00:00+02:00,239,22,217,13.74553452780325,252,28,224,18.51064847889223,18,1028,0.0,17
2020-05-29 06:00:00+02:00,298,31,267,18.335119688608,287,25,262,21.927304089805975,18,1028,0.0,17
2020-05-29 07:00:00+02:00,460,43,417,18.198266997149677,442,45,397,20.352399635415985,18,1028,0.0,17
2020-05-29 08:00:00+02:00,484,45,439,17.863314460235074,502,45,457,11.735836537408174,18,1028,0.0,17
2020-05-29 09:00:00+02:00,324,33,291,20.507764200909268,337,37,300,21.494538760895587,18,1028,0.0,17
2020-05-29 10:00:00+02:00,276,26,250,21.646913060128323,265,25,240,24.143057918667047,18,1028,0.0,17
2020-05-29 11:00:00+02:00,324,31,293,20.507764200909268,337,37,300,21.494538760895587,18,1028,0.0,17
2020-05-29 12:00:00+02:00,276,26,250,21.646913060128323,265,25,240,24.143057918667047,18,1028,0.0,17
2020-05-29 13:00:00+02:00,269,26,243,17.49919499982951,267,23,244,13.385499595100717,18,1028,0.0,17
2020-05-29 14:00:00+02:00,278,26,252,17.988889489265482,265,25,240,24.143057918667047,18,1028,0.0,17
2020-05-29 15:00:00+02:00,296,28,268,20.454116986907042,304,30,274,22.339067945756394,18,1028,0.0,17
2020-05-29 16:00:00+02:00,337,31,306,21.494538760895587,337,31,306,21.494538760895587,18,1028,0.0,17
2020-05-29 17:00:00+02:00,471,44,427,24.71489709392721,445,38,407,19.037524313009598,18,1028,0.0,17
2020-05-29 18:00:00+02:00,482,48,434,19.903175971447034,502,45,457,11.735836537408174,18,1028,0.0,17
2020-05-29 19:00:00+02:00,353,36,317,20.016393666106563,361,40,321,19.1870055662437,18,1028,0.0,17
2020-05-29 20:00:00+02:00,366,39,327,21.40807985369936,348,39,309,20.566317862558048,18,1028,0.0,17
2020-05-29 21:00:00+02:00,269,26,243,17.49919499982951,267,23,244,13.385499595100717,18,1028,0.0,17
2020-05-29 22:00:00+02:00,195,18,177,23.83440770251287,192,17,175,21.295822766447603,18,1028,0.0,17
2020-05-29 23:00:00+02:00,135,13,122,21.280002906629502,131,12,119,14.183230975852695,18,1028,0.0,17
2020-05-30 00:00:00+02:00,110,6,104,20.964248322238312,116,6,110,11.000262455867666,20,1023,0.0,11
2020-05-30 01:00:00+02:00,71,4,67,11.584371388309396,77,5,72,11.693765322784895,20,1023,0.0,11
2020-05-30 02:00:00+02:00,74,4,70,9.886934519670994,77,4,73,11.693765322784895,20,1023,0.0,11
2020-05-30 03:00:00+02:00,113,7,106,20.97275705288615,116,6,110,11.000262455867666,20,1023,0.0,11
2020-05-30 04:00:00+02:00,146,9,137,19.4340926707284,155,8,147,18.708796369633056,20,1023,0.0,11
2020-05-30 05:00:00+02:00,179,10,169,21.74229179161351,194,10,184,19.241214114048436,20,1023,0.0,11
2020-05-30 06:00:00+02:00,299,17,282,16.471342376610473,308,19,289,19.852115147138527,20,1023,0.0,11
2020-05-30 07:00:00+02:00,437,27,410,20.40675859398746,473,25,448,14.300214591159298,20,1023,0.0,11
2020-05-30 08:00:00+02:00,596,36,560,15.148785058807846,620,33,587,15.579919444904501,20,1023,0.0,11
2020-05-30 09:00:00+02:00,617,35,582,19.544255715952797,671,34,637,19.7199914355923,20,1023,0.0,11
2020-05-30 10:00:00+02:00,575,34,541,15.295280006044948,596,32,564,15.148785058807846,20,1023,0.0,11
2020-05-30 11:00:00+02:00,437,25,412,20.40675859398746,473,25,448,14.300214591159298,20,1023,0.0,11
2020-05-30 12:00:00+02:00,446,27,419,16.392503795900122,476,25,451,20.090041264055532,20,1023,0.0,11
2020-05-30 13:00:00+02:00,485,29,456,23.26524199136097,509,31,478,20.085378936033393,20,1023,0.0,11
2020-05-30 14:00:00+02:00,449,29,420,17.9741178967318,470,25,445,16.224212326735135,20,1023,0.0,11
2020-05-30 15:00:00+02:00,536,33,503,13.147585514482932,548,28,520,19.206613944955244,20,1023,0.0,11
2020-05-30 16:00:00+02:00,527,33,494,19.476857580866454,551,30,521,17.61916856629276,20,1023,0.0,11
2020-05-30 17:00:00+02:00,587,35,552,17.903545492966053,632,33,599,21.20851016574696,20,1023,0.0,11
2020-05-30 18:00:00+02:00,551,33,518,17.61916856629276,584,32,552,20.69288146543853,20,1023,0.0,11
2020-05-30 19:00:00+02:00,461,26,435,21.59648486572868,473,26,447,14.300214591159298,20,1023,0.0,11
2020-05-30 20:00:00+02:00,410,25,385,17.249472070304,434,26,408,21.64946895511234,20,1023,0.0,11
2020-05-30 21:00:00+02:00,368,21,347,19.848434815045938,392,20,372,22.18304148250548,20,1023,0.0,11
2020-05-30 22:00:00+02:00,293,18,275,17.329297501722674,311,16,295,18.777054340822975,20,1023,0.0,11
2020-05-30 23:00:00+02:00,143,9,134,15.49985590484046,158,9,149,19.40470350916573,20,1023,0.0,11
2020-05-31 00:00:00+02:00,56,2,54,11.681432660358455,54,2,52,11.483713237443984,19,1020,0.0,14
2020-05-31 01:00:00+02:00,33,1,32,6.0078012500217595,46,1,45,9.91060285131841,19,1020,0.0,14
2020-05-31 02:00:00+02:00,33,1,32,6.0078012500217595,46,1,45,9.91060285131841,19,1020,0.0,14
2020-05-31 03:00:00+02:00,51,2,49,13.024781207847502,69,2,67,11.382640456570568,19,1020,0.0,14
2020-05-31 04:00:00+02:00,75,3,72,11.283880560685672,93,3,90,7.996959659096201,19,1020,0.0,14
2020-05-31 05:00:00+02:00,90,3,87,10.477669283936715,95,3,92,10.506818941407664,19,1020,0.0,14
2020-05-31 06:00:00+02:00,137,5,132,15.965917364236809,196,7,189,22.483124652822625,19,1020,0.0,14
2020-05-31 07:00:00+02:00,209,8,201,16.60419034744366,292,11,281,17.87884891495493,19,1020,0.0,14
2020-05-31 08:00:00+02:00,282,10,272,20.995138580232226,336,11,325,15.374523455613796,19,1020,0.0,14
2020-05-31 09:00:00+02:00,318,11,307,22.522150292755875,414,17,397,20.92110305719904,19,1020,0.0,14
2020-05-31 10:00:00+02:00,274,11,263,20.52791870989968,323,11,312,19.446887597808452,19,1020,0.0,14
2020-05-31 11:00:00+02:00,220,8,212,20.77869221062603,225,7,218,16.518156382279376,19,1020,0.0,14
2020-05-31 12:00:00+02:00,230,9,221,16.58682627515864,259,10,249,22.975221531884507,19,1020,0.0,14
2020-05-31 13:00:00+02:00,246,9,237,21.917745613565252,246,8,238,21.917745613565252,19,1020,0.0,14
2020-05-31 14:00:00+02:00,207,7,200,18.76558942906742,292,11,281,17.87884891495493,19,1020,0.0,14
2020-05-31 15:00:00+02:00,246,9,237,21.917745613565252,264,8,256,17.866837611646663,19,1020,0.0,14
2020-05-31 16:00:00+02:00,256,9,247,19.922633354103812,339,14,325,18.9351903306688,19,1020,0.0,14
2020-05-31 17:00:00+02:00,292,12,280,17.87884891495493,318,10,308,22.522150292755875,19,1020,0.0,14
2020-05-31 18:00:00+02:00,279,11,268,20.757341864573803,323,11,312,19.446887597808452,19,1020,0.0,14
2020-05-31 19:00:00+02:00,220,8,212,20.77869221062603,225,7,218,16.518156382279376,19,1020,0.0,14
2020-05-31 20:00:00+02:00,212,9,203,14.709005856097448,256,11,245,19.922633354103812,19,1020,0.0,14
2020-05-31 21:00:00+02:00,186,7,179,20.400698976924794,222,8,214,17.594973015311762,19,1020,0.0,14
2020-05-31 22:00:00+02:00,142,6,136,19.57947604189084,199,7,192,19.11274068140836,19,1020,0.0,14
2020-05-31 23:00:00+02:00,72,2,70,10.765287360581397,93,3,90,7.996959659096201,19,1020,0.0,14
2020-06-01 00:00:00+02:00,105,10,95,15.778065052313549,105,13,92,15.778065052313549,21,1019,0.0,15
2020-06-01 01:00:00+02:00,70,7,63,13.53852946044019,70,7,63,13.53852946044019,21,1019,0.0,15
2020-06-01 02:00:00+02:00,70,6,64,13.53852946044019,70,7,63,13.53852946044019,21,1019,0.0,15
2020-06-01 03:00:00+02:00,105,9,96,15.778065052313549,105,13,92,15.778065052313549,21,1019,0.0,15
2020-06-01 04:00:00+02:00,175,19,156,17.666202741429842,178,19,159,19.804789777436813,21,1019,0.0,15
2020-06-01 05:00:00+02:00,305,27,278,19.342371998402466,307,30,277,19.62844127124222,21,1019,0.0,15
2020-06-01 06:00:00+02:00,367,39,328,20.047055443111752,372,46,326,17.388398109436665,21,1019,0.0,15
2020-06-01 07:00:00+02:00,583,55,528,17.990582160320795,593,67,526,19.094221191408877,21,1019,0.0,15
2020-06-01 08:00:00+02:00,602,61,541,18.30446366877723,610,77,533,19.929525822534373,21,1019,0.0,15
2020-06-01 09:00:00+02:00,421,40,381,22.41212221732918,418,45,373,19.740254716385955,21,1019,0.0,15
2020-06-01 10:00:00+02:00,345,37,308,18.48984602659702,348,44,304,20.566317862558048,21,1019,0.0,15
2020-06-01 11:00:00+02:00,404,40,364,21.094548442403457,423,41,382,23.290663678046883,21,1019,0.0,15
2020-06-01 12:00:00+02:00,345,37,308,18.48984602659702,348,44,304,20.566317862558048,21,1019,0.0,15
2020-06-01 13:00:00+02:00,337,33,304,21.494538760895587,350,35,315,21.39774246689966,21,1019,0.0,15
2020-06-01 14:00:00+02:00,348,35,313,20.566317862558048,342,37,305,17.147818156889407,21,1019,0.0,15
2020-06-01 15:00:00+02:00,359,38,321,21.41163694321985,377,44,333,16.83689607567409,21,1019,0.0,15
2020-06-01 16:00:00+02:00,429,41,388,21.355504409446556,410,40,370,20.532450928302634,21,1019,0.0,15
2020-06-01 17:00:00+02:00,566,61,505,17.19426395043967,602,63,539,18.30446366877723,21,1019,0.0,15
2020-06-01 18:00:00+02:00,596,65,531,17.72863338968537,618,60,558,19.55823856061009,21,1019,0.0,15
2020-06-01 19:00:00+02:00,453,42,411,18.726095790194968,467,47,420,22.874976747697783,21,1019,0.0,15
2020-06-01 20:00:00+02:00,431,39,392,17.591114272986506,453,56,397,18.726095790194968,21,1019,0.0,15
2020-06-01 21:00:00+02:00,337,34,303,21.494538760895587,350,35,315,21.39774246689966,21,1019,0.0,15
2020-06-01 22:00:00+02:00,242,24,218,20.990360069331732,240,27,213,16.023164601360044,21,1019,0.0,15
2020-06-01 23:00:00+02:00,170,17,153,19.775542485132945,178,17,161,19.804789777436813,21,1019,0.0,15
2020-06-02 00:00:00+02:00,119,9,110,22.46945513312648,129,12,117,17.995114557081255,24,1018,0.0,11
2020-06-02 01:00:00+02:00,78,6,72,16.41986115786707,88,8,80,17.756927742208592,24,1018,0.0,11
2020-06-02 02:00:00+02:00,81,7,74,16.076626545182606,88,8,80,17.756927742208592,24,1018,0.0,11
2020-06-02 03:00:00+02:00,126,12,114,21.990298593101397,126,13,113,21.990298593101397,24,1018,0.0,11
2020-06-02 04:00:00+02:00,191,18,173,20.658016380524305,228,25,203,15.818609956751573,24,1018,0.0,11
2020-06-02 05:00:00+02:00,348,29,319,20.566317862558048,396,39,357,20.199948477295223,24,1018,0.0,11
2020-06-02 06:00:00+02:00,423,38,385,23.290663678046883,498,56,442,21.292954399658242,24,1018,0.0,11
2020-06-02 07:00:00+02:00,689,65,624,23.980963452069407,740,64,676,22.499704569771684,24,1018,0.0,11
2020-06-02 08:00:00+02:00,727,69,658,16.475797179385555,843,83,760,17.037882589890646,24,1018,0.0,11
2020-06-02 09:00:00+02:00,525,46,479,19.51145717098526,515,56,459,22.56064635427968,24,1018,0.0,11
2020-06-02 10:00:00+02:00,430,42,388,19.32256414396262,440,38,402,19.57754243382943,24,1018,0.0,11
2020-06-02 11:00:00+02:00,481,46,435,25.78446993067148,556,50,506,17.490996909750756,24,1018,0.0,11
2020-06-02 12:00:00+02:00,409,36,373,21.723119645649348,433,49,384,15.756615810687446,24,1018,0.0,11
2020-06-02 13:00:00+02:00,392,35,357,15.515848376438075,450,43,407,19.966269019650863,24,1018,0.0,11
2020-06-02 14:00:00+02:00,423,37,386,23.290663678046883,454,51,403,21.947231747967304,24,1018,0.0,11
2020-06-02 15:00:00+02:00,443,42,401,13.62175880122913,481,48,433,25.78446993067148,24,1018,0.0,11
2020-06-02 16:00:00+02:00,522,47,475,19.599053099291446,532,58,474,22.31530989594808,24,1018,0.0,11
2020-06-02 17:00:00+02:00,717,62,655,21.920103302141136,761,66,695,23.273645119817076,24,1018,0.0,11
2020-06-02 18:00:00+02:00,785,78,707,19.91443463428047,840,90,750,19.47195227165947,24,1018,0.0,11
2020-06-02 19:00:00+02:00,522,46,476,19.599053099291446,577,63,514,23.103874122084292,24,1018,0.0,11
2020-06-02 20:00:00+02:00,570,49,521,25.11924504296083,573,53,520,13.397132275797208,24,1018,0.0,11
2020-06-02 21:00:00+02:00,433,37,396,15.756615810687446,433,42,391,15.756615810687446,24,1018,0.0,11
2020-06-02 22:00:00+02:00,273,24,249,23.61851837889036,320,28,292,21.04137400974582,24,1018,0.0,11
2020-06-02 23:00:00+02:00,215,21,194,23.830284677030114,228,25,203,15.818609956751573,24,1018,0.0,11
2020-06-03 00:00:00+02:00,121,14,107,14.174023637152917,115,14,101,14.389080564214039,20,1013,0.0,8
2020-06-03 01:00:00+02:00,82,9,73,20.17926359643092,75,9,66,16.06577410864815,20,1013,0.0,8
2020-06-03 02:00:00+02:00,82,10,72,20.17926359643092,75,9,66,16.06577410864815,20,1013,0.0,8
2020-06-03 03:00:00+02:00,124,15,109,21.01321111404538,121,13,108,14.174023637152917,20,1013,0.0,8
2020-06-03 04:00:00+02:00,207,28,179,19.46313193794564,200,19,181,20.806596333484702,20,1013,0.0,8
2020-06-03 05:00:00+02:00,378,49,329,19.72856450330425,345,36,309,20.188429732979824,20,1013,0.0,8
2020-06-03 06:00:00+02:00,460,54,406,18.80828405121806,447,47,400,19.00138648619854,20,1013,0.0,8
2020-06-03 07:00:00+02:00,703,82,621,22.01266771154431,634,73,561,19.862366475510488,20,1013,0.0,8
2020-06-03 08:00:00+02:00,739,83,656,23.653511913278738,756,92,664,20.036134735517457,20,1013,0.0,8
2020-06-03 09:00:00+02:00,506,63,443,19.419273749095993,467,55,412,23.392169574456698,20,1013,0.0,8
2020-06-03 10:00:00+02:00,417,50,367,19.5232508211744,378,47,331,19.72856450330425,20,1013,0.0,8
2020-06-03 11:00:00+02:00,496,59,437,16.493355873141443,486,52,434,24.1380791971267,20,1013,0.0,8
2020-06-03 12:00:00+02:00,420,56,364,17.615164094757546,414,48,366,19.17568950621098,20,1013,0.0,8
2020-06-03 13:00:00+02:00,411,56,355,23.42311543355913,388,46,342,18.513167788987648,20,1013,0.0,8
2020-06-03 14:00:00+02:00,420,57,363,17.615164094757546,414,48,366,19.17568950621098,20,1013,0.0,8
2020-06-03 15:00:00+02:00,453,61,392,17.122821548587037,417,46,371,19.5232508211744,20,1013,0.0,8
2020-06-03 16:00:00+02:00,493,67,426,19.413114642597456,486,49,437,24.1380791971267,20,1013,0.0,8
2020-06-03 17:00:00+02:00,716,96,620,18.522071113856125,638,65,573,22.609760679757738,20,1013,0.0,8
2020-06-03 18:00:00+02:00,739,83,656,23.653511913278738,756,92,664,20.036134735517457,20,1013,0.0,8
2020-06-03 19:00:00+02:00,549,68,481,23.281224347241054,542,52,490,23.1978257202002,20,1013,0.0,8
2020-06-03 20:00:00+02:00,545,65,480,24.889232080242863,522,52,470,18.0567977332051,20,1013,0.0,8
2020-06-03 21:00:00+02:00,420,49,371,17.615164094757546,414,48,366,19.17568950621098,20,1013,0.0,8
2020-06-03 22:00:00+02:00,286,39,247,22.799042804335677,276,34,242,17.34974806433115,20,1013,0.0,8
2020-06-03 23:00:00+02:00,207,24,183,19.46313193794564,200,19,181,20.806596333484702,20,1013,0.0,8
2020-06-04 00:00:00+02:00,62,5,57,14.48690450543278,61,8,53,12.362973378192347,14,1002,0.3,14
2020-06-04 01:00:00+02:00,36,2,34,3.0873599992209124,43,5,38,8.573704494863009,14,1002,0.3,14
2020-06-04 02:00:00+02:00,40,3,37,5.275608835029151,43,5,38,8.573704494863009,14,1002,0.3,14
2020-06-04 03:00:00+02:00,61,5,56,12.362973378192347,61,8,53,12.362973378192347,14,1002,0.3,14
2020-06-04 04:00:00+02:00,94,7,87,13.172779715339633,103,16,87,12.113442962320551,14,1002,0.3,14
2020-06-04 05:00:00+02:00,183,16,167,16.4856647978058,185,23,162,20.160625004949942,14,1002,0.3,14
2020-06-04 06:00:00+02:00,214,16,198,18.560318290748608,246,35,211,17.57126233227549,14,1002,0.3,14
2020-06-04 07:00:00+02:00,337,29,308,21.494538760895587,380,50,330,15.070197513038655,14,1002,0.3,14
2020-06-04 08:00:00+02:00,396,30,366,20.199948477295223,368,52,316,19.722641588533307,14,1002,0.3,14
2020-06-04 09:00:00+02:00,234,19,215,19.754580108435302,248,34,214,17.312704307039937,14,1002,0.3,14
2020-06-04 10:00:00+02:00,199,17,182,21.764655927821806,221,28,193,20.34114880306217,14,1002,0.3,14
2020-06-04 11:00:00+02:00,263,21,242,18.706444640225143,267,42,225,13.385499595100717,14,1002,0.3,14
2020-06-04 12:00:00+02:00,213,17,196,20.488166305452438,223,32,191,21.320656431140716,14,1002,0.3,14
2020-06-04 13:00:00+02:00,192,15,177,21.295822766447603,216,29,187,21.273439412003903,14,1002,0.3,14
2020-06-04 14:00:00+02:00,206,18,188,22.241507594869486,204,28,176,12.517560993101368,14,1002,0.3,14
2020-06-04 15:00:00+02:00,239,18,221,13.74553452780325,246,39,207,17.57126233227549,14,1002,0.3,14
2020-06-04 16:00:00+02:00,237,20,217,15.922060682410839,267,42,225,13.385499595100717,14,1002,0.3,14
2020-06-04 17:00:00+02:00,363,29,334,20.037936765942277,363,59,304,20.037936765942277,14,1002,0.3,14
2020-06-04 18:00:00+02:00,358,32,326,18.044939279580262,380,57,323,15.070197513038655,14,1002,0.3,14
2020-06-04 19:00:00+02:00,286,22,264,20.398524223626136,291,45,246,17.50237418524224,14,1002,0.3,14
2020-06-04 20:00:00+02:00,256,20,236,20.451990100158973,286,36,250,20.398524223626136,14,1002,0.3,14
2020-06-04 21:00:00+02:00,209,18,191,22.16757043059366,214,27,187,18.560318290748608,14,1002,0.3,14
2020-06-04 22:00:00+02:00,146,12,134,20.98788244482569,155,19,136,19.469409355748308,14,1002,0.3,14
2020-06-04 23:00:00+02:00,96,8,88,11.83328593996439,103,16,87,12.113442962320551,14,1002,0.3,14
2020-06-05 00:00:00+02:00,60,6,54,10.583722413773145,57,5,52,10.480552878481939,14,1003,0.7,11
2020-06-05 01:00:00+02:00,41,3,38,8.457036189746331,41,3,38,8.457036189746331,14,1003,0.7,11
2020-06-05 02:00:00+02:00,41,4,37,8.457036189746331,41,3,38,8.457036189746331,14,1003,0.7,11
2020-06-05 03:00:00+02:00,62,6,56,14.48690450543278,57,5,52,10.480552878481939,14,1003,0.7,11
2020-06-05 04:00:00+02:00,103,9,94,12.113442962320551,102,11,91,13.093305626972347,14,1003,0.7,11
2020-06-05 05:00:00+02:00,186,17,169,22.772295906033783,172,15,157,19.644113972447897,14,1003,0.7,11
2020-06-05 06:00:00+02:00,224,24,200,16.30248157536985,222,18,204,18.77573498601868,14,1003,0.7,11
2020-06-05 07:00:00+02:00,337,34,303,21.494538760895587,359,33,326,21.41163694321985,14,1003,0.7,11
2020-06-05 08:00:00+02:00,364,37,327,19.12804198058144,362,41,321,18.208767664177746,14,1003,0.7,11
2020-06-05 09:00:00+02:00,253,27,226,24.084070139549794,242,25,217,20.990360069331732,14,1003,0.7,11
2020-06-05 10:00:00+02:00,202,20,182,22.500350864850866,192,18,174,21.295822766447603,14,1003,0.7,11
2020-06-05 11:00:00+02:00,245,23,222,18.942213831390788,242,25,217,20.990360069331732,14,1003,0.7,11
2020-06-05 12:00:00+02:00,202,20,182,22.500350864850866,192,18,174,21.295822766447603,14,1003,0.7,11
2020-06-05 13:00:00+02:00,204,19,185,12.517560993101368,196,21,175,20.04912381427717,14,1003,0.7,11
2020-06-05 14:00:00+02:00,209,22,187,22.16757043059366,202,17,185,22.500350864850866,14,1003,0.7,11
2020-06-05 15:00:00+02:00,219,21,198,21.009686825041197,222,18,204,18.77573498601868,14,1003,0.7,11
2020-06-05 16:00:00+02:00,238,24,214,16.13336525085207,242,24,218,20.990360069331732,14,1003,0.7,11
2020-06-05 17:00:00+02:00,345,34,311,18.48984602659702,350,40,310,21.39774246689966,14,1003,0.7,11
2020-06-05 18:00:00+02:00,370,37,333,20.548579550699223,357,33,324,21.912097396672888,14,1003,0.7,11
2020-06-05 19:00:00+02:00,275,25,250,24.67224255888931,266,30,236,24.416240816629376,14,1003,0.7,11
2020-06-05 20:00:00+02:00,263,25,238,18.706444640225143,273,30,243,23.61851837889036,14,1003,0.7,11
2020-06-05 21:00:00+02:00,205,18,187,13.47116079711613,202,17,185,22.500350864850866,14,1003,0.7,11
2020-06-05 22:00:00+02:00,138,13,125,20.21600799483387,135,13,122,21.280002906629502,14,1003,0.7,11
2020-06-05 23:00:00+02:00,105,9,96,15.778065052313549,103,11,92,12.113442962320551,14,1003,0.7,11
2020-06-06 00:00:00+02:00,75,4,71,11.283880560685672,79,4,75,13.473204105951462,14,1003,0.0,14
2020-06-06 01:00:00+02:00,49,3,46,12.126419816698254,53,2,51,12.671576687621188,14,1003,0.0,14
2020-06-06 02:00:00+02:00,51,2,49,13.024781207847502,53,3,50,12.671576687621188,14,1003,0.0,14
2020-06-06 03:00:00+02:00,77,4,73,11.693765322784895,79,5,74,13.473204105951462,14,1003,0.0,14
2020-06-06 04:00:00+02:00,98,6,92,9.366341704429512,106,7,99,19.560878716092326,14,1003,0.0,14
2020-06-06 05:00:00+02:00,131,8,123,17.703689985975256,131,7,124,17.703689985975256,14,1003,0.0,14
2020-06-06 06:00:00+02:00,196,12,184,22.483124652822625,210,11,199,17.488096079787415,14,1003,0.0,14
2020-06-06 07:00:00+02:00,303,17,286,21.350092399480108,321,17,304,17.9619971253537,14,1003,0.0,14
2020-06-06 08:00:00+02:00,419,24,395,17.376963499336668,423,25,398,16.440651492044253,14,1003,0.0,14
2020-06-06 09:00:00+02:00,423,26,397,16.440651492044253,450,25,425,15.953303206406003,14,1003,0.0,14
2020-06-06 10:00:00+02:00,389,26,363,18.813833392506616,401,22,379,23.451917712170843,14,1003,0.0,14
2020-06-06 11:00:00+02:00,298,20,278,19.413448672737985,317,20,297,17.791113543708203,14,1003,0.0,14
2020-06-06 12:00:00+02:00,311,20,291,18.777054340822975,317,18,299,17.791113543708203,14,1003,0.0,14
2020-06-06 13:00:00+02:00,335,22,313,21.63506552863301,350,20,330,19.39294883514927,14,1003,0.0,14
2020-06-06 14:00:00+02:00,303,18,285,21.350092399480108,321,17,304,17.9619971253537,14,1003,0.0,14
2020-06-06 15:00:00+02:00,366,21,345,16.269939741661524,376,21,355,20.486350839145686,14,1003,0.0,14
2020-06-06 16:00:00+02:00,368,22,346,19.848434815045938,374,19,355,18.684901759797462,14,1003,0.0,14
2020-06-06 17:00:00+02:00,419,26,393,17.376963499336668,423,25,398,16.440651492044253,14,1003,0.0,14
2020-06-06 18:00:00+02:00,374,23,351,18.684901759797462,407,23,384,18.86836233630375,14,1003,0.0,14
2020-06-06 19:00:00+02:00,313,20,293,12.040192542056978,317,20,297,17.791113543708203,14,1003,0.0,14
2020-06-06 20:00:00+02:00,284,18,266,16.935782048371557,292,15,277,17.87884891495493,14,1003,0.0,14
2020-06-06 21:00:00+02:00,249,14,235,14.961614479066911,268,13,255,20.190442141402777,14,1003,0.0,14
2020-06-06 22:00:00+02:00,208,12,196,18.807092053665322,214,14,200,18.026924150727908,14,1003,0.0,14
2020-06-06 23:00:00+02:00,100,5,95,12.129363492765288,106,7,99,19.560878716092326,14,1003,0.0,14
2020-06-07 00:00:00+02:00,45,1,44,8.150223537761923,57,2,55,11.247345675463038,17,1007,0.0,17
2020-06-07 01:00:00+02:00,28,1,27,0.9732919408254891,39,1,38,6.913338666308079,17,1007,0.0,17
2020-06-07 02:00:00+02:00,26,1,25,0.13434729751860394,39,1,38,6.913338666308079,17,1007,0.0,17
2020-06-07 03:00:00+02:00,41,1,40,7.51149883575918,55,1,54,10.027044718132117,17,1007,0.0,17
2020-06-07 04:00:00+02:00,53,2,51,12.671576687621188,57,2,55,11.247345675463038,17,1007,0.0,17
2020-06-07 05:00:00+02:00,76,3,73,13.279950485691732,99,4,95,10.313624634117142,17,1007,0.0,17
2020-06-07 06:00:00+02:00,117,5,112,13.539944397802945,138,5,133,15.03091255444847,17,1007,0.0,17
2020-06-07 07:00:00+02:00,179,7,172,21.74229179161351,196,7,189,22.483124652822625,17,1007,0.0,17
2020-06-07 08:00:00+02:00,223,8,215,18.802339292525456,287,12,275,13.917461050382924,17,1007,0.0,17
2020-06-07 09:00:00+02:00,252,10,242,19.00138202247206,281,11,270,18.053311879599764,17,1007,0.0,17
2020-06-07 10:00:00+02:00,206,8,198,20.90053052788098,248,9,239,17.022549227170337,17,1007,0.0,17
2020-06-07 11:00:00+02:00,175,6,169,18.893708159250245,225,9,216,16.518156382279376,17,1007,0.0,17
2020-06-07 12:00:00+02:00,183,7,176,15.872019474492381,202,7,195,21.075229783177793,17,1007,0.0,17
2020-06-07 13:00:00+02:00,188,6,182,19.664617237016223,223,7,216,18.802339292525456,17,1007,0.0,17
2020-06-07 14:00:00+02:00,173,7,166,18.22292561400028,198,6,192,20.173795644408123,17,1007,0.0,17
2020-06-07 15:00:00+02:00,208,8,200,18.807092053665322,260,11,249,14.992506001947714,17,1007,0.0,17
2020-06-07 16:00:00+02:00,208,8,200,18.807092053665322,260,11,249,14.992506001947714,17,1007,0.0,17
2020-06-07 17:00:00+02:00,237,10,227,17.058494417352218,248,8,240,17.022549227170337,17,1007,0.0,17
2020-06-07 18:00:00+02:00,221,8,213,21.310706623471727,223,7,216,18.802339292525456,17,1007,0.0,17
2020-06-07 19:00:00+02:00,173,7,166,18.22292561400028,198,6,192,20.173795644408123,17,1007,0.0,17
2020-06-07 20:00:00+02:00,163,6,157,16.305265165047643,173,6,167,18.22292561400028,17,1007,0.0,17
2020-06-07 21:00:00+02:00,142,5,137,19.57947604189084,200,7,193,21.668114478408352,17,1007,0.0,17
2020-06-07 22:00:00+02:00,115,4,111,14.522258078721798,161,6,155,19.39413115763897,17,1007,0.0,17
2020-06-07 23:00:00+02:00,57,2,55,11.247345675463038,76,3,73,13.279950485691732,17,1007,0.0,17
2020-06-08 00:00:00+02:00,97,9,88,11.610310166035164,97,10,87,11.610310166035164,17,1012,0.4,8
2020-06-08 01:00:00+02:00,64,6,58,14.414592943793718,66,7,59,13.86002207659952,17,1012,0.4,8
2020-06-08 02:00:00+02:00,66,7,59,13.86002207659952,66,8,58,13.86002207659952,17,1012,0.4,8
2020-06-08 03:00:00+02:00,100,10,90,11.502705756568044,97,11,86,11.610310166035164,17,1012,0.4,8
2020-06-08 04:00:00+02:00,164,15,149,22.827361263214527,169,16,153,18.567569965901342,17,1012,0.4,8
2020-06-08 05:00:00+02:00,298,32,266,18.335119688608,290,28,262,18.088844908617002,17,1012,0.4,8
2020-06-08 06:00:00+02:00,357,37,320,21.912097396672888,375,38,337,22.64494297948435,17,1012,0.4,8
2020-06-08 07:00:00+02:00,555,53,502,17.57269749774077,568,66,502,20.442364330592024,17,1012,0.4,8
2020-06-08 08:00:00+02:00,591,61,530,20.224560355926805,612,60,552,17.61133363115532,17,1012,0.4,8
2020-06-08 09:00:00+02:00,401,38,363,26.708807440790352,393,45,348,19.01393712330975,17,1012,0.4,8
2020-06-08 10:00:00+02:00,318,32,286,21.634505447676812,324,36,288,20.507764200909268,17,1012,0.4,8
2020-06-08 11:00:00+02:00,408,43,365,21.369431512154076,388,49,339,23.106523601706122,17,1012,0.4,8
2020-06-08 12:00:00+02:00,342,33,309,17.147818156889407,321,38,283,23.480156167605287,17,1012,0.4,8
2020-06-08 13:00:00+02:00,339,36,303,21.378284288972047,331,31,300,18.08059708638437,17,1012,0.4,8
2020-06-08 14:00:00+02:00,318,30,288,21.634505447676812,324,36,288,20.507764200909268,17,1012,0.4,8
2020-06-08 15:00:00+02:00,372,39,333,17.388398109436665,362,37,325,18.208767664177746,17,1012,0.4,8
2020-06-08 16:00:00+02:00,390,42,348,23.204029211730827,390,49,341,23.204029211730827,17,1012,0.4,8
2020-06-08 17:00:00+02:00,547,59,488,20.747394942344446,576,56,520,19.54878368039628,17,1012,0.4,8
2020-06-08 18:00:00+02:00,596,57,539,17.72863338968537,588,57,531,15.545784204606317,17,1012,0.4,8
2020-06-08 19:00:00+02:00,414,42,372,21.211929621647883,439,51,388,18.965638166337634,17,1012,0.4,8
2020-06-08 20:00:00+02:00,403,36,367,24.744299394136338,439,42,397,18.965638166337634,17,1012,0.4,8
2020-06-08 21:00:00+02:00,311,28,283,16.325599187415413,329,34,295,19.339935066365534,17,1012,0.4,8
2020-06-08 22:00:00+02:00,234,23,211,19.754580108435302,226,24,202,20.308697708911414,17,1012,0.4,8
2020-06-08 23:00:00+02:00,156,15,141,23.175119746499636,162,20,142,19.08849102929865,17,1012,0.4,8
2020-06-09 00:00:00+02:00,65,5,60,15.361527134905547,74,8,66,19.513800836509724,15,1017,0.0,17
2020-06-09 01:00:00+02:00,44,4,40,6.744796902616623,50,4,46,13.688855833793909,15,1017,0.0,17
2020-06-09 02:00:00+02:00,44,3,41,6.744796902616623,50,4,46,13.688855833793909,15,1017,0.0,17
2020-06-09 03:00:00+02:00,69,5,64,19.29595730158091,70,7,63,13.53852946044019,15,1017,0.0,17
2020-06-09 04:00:00+02:00,115,9,106,27.52702584121565,119,13,106,22.46945513312648,15,1017,0.0,17
2020-06-09 05:00:00+02:00,195,17,178,23.83440770251287,225,20,205,17.07968654570721,15,1017,0.0,17
2020-06-09 06:00:00+02:00,248,21,227,17.312704307039937,268,28,240,16.114987230113258,15,1017,0.0,17
2020-06-09 07:00:00+02:00,373,31,342,20.02368697341565,416,39,377,17.117872401421668,15,1017,0.0,17
2020-06-09 08:00:00+02:00,427,35,392,18.502781357559265,431,48,383,17.591114272986506,15,1017,0.0,17
2020-06-09 09:00:00+02:00,270,26,244,23.920073269237992,300,26,274,19.621479548992166,15,1017,0.0,17
2020-06-09 10:00:00+02:00,212,19,193,18.597605283865732,255,25,230,21.41944964647189,15,1017,0.0,17
2020-06-09 11:00:00+02:00,272,22,250,23.2664106640069,294,33,261,18.98421464015195,15,1017,0.0,17
2020-06-09 12:00:00+02:00,223,20,203,21.320656431140716,235,22,213,20.674840106170866,15,1017,0.0,17
2020-06-09 13:00:00+02:00,223,21,202,21.320656431140716,235,22,213,20.674840106170866,15,1017,0.0,17
2020-06-09 14:00:00+02:00,223,21,202,21.320656431140716,235,22,213,20.674840106170866,15,1017,0.0,17
2020-06-09 15:00:00+02:00,246,23,223,17.57126233227549,266,28,238,24.416240816629376,15,1017,0.0,17
2020-06-09 16:00:00+02:00,263,23,240,18.706444640225143,304,33,271,22.339067945756394,15,1017,0.0,17
2020-06-09 17:00:00+02:00,408,34,374,21.369431512154076,404,46,358,21.094548442403457,15,1017,0.0,17
2020-06-09 18:00:00+02:00,421,35,386,22.41212221732918,449,43,406,18.601165629732545,15,1017,0.0,17
2020-06-09 19:00:00+02:00,279,25,254,23.809963875172556,322,36,286,22.976009334024873,15,1017,0.0,17
2020-06-09 20:00:00+02:00,306,30,276,17.3472177808044,309,33,276,17.68578168988432,15,1017,0.0,17
2020-06-09 21:00:00+02:00,222,19,203,18.77573498601868,233,24,209,20.426009043155588,15,1017,0.0,17
2020-06-09 22:00:00+02:00,158,13,145,21.67102174389251,169,16,153,18.567569965901342,15,1017,0.0,17
2020-06-09 23:00:00+02:00,111,10,101,12.909820125967427,115,10,105,27.52702584121565,15,1017,0.0,17
2020-06-10 00:00:00+02:00,95,13,82,17.590478556460255,90,8,82,18.392649197374546,18,1019,0.0,13
2020-06-10 01:00:00+02:00,64,8,56,14.026099803141571,59,6,53,11.41076069350512,18,1019,0.0,13
2020-06-10 02:00:00+02:00,64,8,56,14.026099803141571,59,6,53,11.41076069350512,18,1019,0.0,13
2020-06-10 03:00:00+02:00,98,13,85,18.03644044567539,98,9,89,18.03644044567539,18,1019,0.0,13
2020-06-10 04:00:00+02:00,165,18,147,18.791507267735128,152,16,136,20.701024990887795,18,1019,0.0,13
2020-06-10 05:00:00+02:00,291,38,253,15.818920682290248,276,28,248,17.34974806433115,18,1019,0.0,13
2020-06-10 06:00:00+02:00,359,42,317,15.903895825886657,333,36,297,20.360845500171493,18,1019,0.0,13
2020-06-10 07:00:00+02:00,565,77,488,19.535939348866478,509,53,456,17.061130068212915,18,1019,0.0,13
2020-06-10 08:00:00+02:00,589,74,515,16.22308117067377,537,66,471,15.183293437990013,18,1019,0.0,13
2020-06-10 09:00:00+02:00,392,53,339,15.3731079641605,387,48,339,17.47876613578263,18,1019,0.0,13
2020-06-10 10:00:00+02:00,323,43,280,20.660649403872643,304,29,275,23.926436101503658,18,1019,0.0,13
2020-06-10 11:00:00+02:00,387,44,343,17.47876613578263,356,44,312,15.115185640587857,18,1019,0.0,13
2020-06-10 12:00:00+02:00,325,44,281,19.158838106551173,297,33,264,19.43137253304159,18,1019,0.0,13
2020-06-10 13:00:00+02:00,325,38,287,19.158838106551173,297,33,264,19.43137253304159,18,1019,0.0,13
2020-06-10 14:00:00+02:00,325,38,287,19.158838106551173,297,33,264,19.43137253304159,18,1019,0.0,13
2020-06-10 15:00:00+02:00,356,42,314,15.115185640587857,333,42,291,20.360845500171493,18,1019,0.0,13
2020-06-10 16:00:00+02:00,397,54,343,17.68183590028467,351,38,313,21.009303371553763,18,1019,0.0,13
2020-06-10 17:00:00+02:00,558,62,496,21.241662475833486,516,49,467,19.477342984372644,18,1019,0.0,13
2020-06-10 18:00:00+02:00,599,71,528,19.57962192189104,594,59,535,13.816615009045282,18,1019,0.0,13
2020-06-10 19:00:00+02:00,426,54,372,15.976172437190886,403,50,353,13.914029524281172,18,1019,0.0,13
2020-06-10 20:00:00+02:00,423,51,372,17.430043307900036,403,50,353,13.914029524281172,18,1019,0.0,13
2020-06-10 21:00:00+02:00,325,39,286,19.158838106551173,297,33,264,19.43137253304159,18,1019,0.0,13
2020-06-10 22:00:00+02:00,227,26,201,21.978956980369183,219,27,192,24.028704787177322,18,1019,0.0,13
2020-06-10 23:00:00+02:00,165,20,145,18.791507267735128,152,16,136,20.701024990887795,18,1019,0.0,13
2020-06-11 00:00:00+02:00,98,8,90,10.878679660088993,107,14,93,12.156196464705383,19,1012,0.1,9
2020-06-11 01:00:00+02:00,65,5,60,15.361527134905547,74,11,63,19.513800836509724,19,1012,0.1,9
2020-06-11 02:00:00+02:00,71,5,66,15.50461576454985,74,11,63,19.513800836509724,19,1012,0.1,9
2020-06-11 03:00:00+02:00,107,9,98,12.156196464705383,107,17,90,12.156196464705383,19,1012,0.1,9
2020-06-11 04:00:00+02:00,167,15,152,21.39117903937357,181,25,156,20.051163259817507,19,1012,0.1,9
2020-06-11 05:00:00+02:00,304,23,281,22.339067945756394,319,52,267,20.382766877627866,19,1012,0.1,9
2020-06-11 06:00:00+02:00,411,35,376,21.89950881174465,390,63,327,23.204029211730827,19,1012,0.1,9
2020-06-11 07:00:00+02:00,572,51,521,22.464428218647974,617,97,520,19.739247366719148,19,1012,0.1,9
2020-06-11 08:00:00+02:00,590,46,544,24.741329330337763,641,94,547,15.726028078936805,19,1012,0.1,9
2020-06-11 09:00:00+02:00,396,34,362,20.199948477295223,420,60,360,20.41205404512006,19,1012,0.1,9
2020-06-11 10:00:00+02:00,345,31,314,18.48984602659702,372,60,312,17.388398109436665,19,1012,0.1,9
2020-06-11 11:00:00+02:00,408,32,376,21.369431512154076,426,69,357,20.8097346735364,19,1012,0.1,9
2020-06-11 12:00:00+02:00,331,28,303,18.08059708638437,357,47,310,21.912097396672888,19,1012,0.1,9
2020-06-11 13:00:00+02:00,366,28,338,21.40807985369936,363,59,304,20.037936765942277,19,1012,0.1,9
2020-06-11 14:00:00+02:00,340,31,309,18.92958933704513,375,45,330,22.64494297948435,19,1012,0.1,9
2020-06-11 15:00:00+02:00,375,29,346,22.64494297948435,402,53,349,17.230856788696144,19,1012,0.1,9
2020-06-11 16:00:00+02:00,405,35,370,18.172278090342537,423,68,355,23.290663678046883,19,1012,0.1,9
2020-06-11 17:00:00+02:00,587,53,534,20.028899672241884,638,93,545,19.261703644868717,19,1012,0.1,9
2020-06-11 18:00:00+02:00,626,48,578,19.126469181365696,635,78,557,19.585358081724554,19,1012,0.1,9
2020-06-11 19:00:00+02:00,444,39,405,14.679521920211366,465,67,398,19.650501243200726,19,1012,0.1,9
2020-06-11 20:00:00+02:00,480,41,439,21.905802263169644,483,66,417,21.366599546374843,19,1012,0.1,9
2020-06-11 21:00:00+02:00,334,28,306,23.256671102053218,372,53,319,17.388398109436665,19,1012,0.1,9
2020-06-11 22:00:00+02:00,238,19,219,16.13336525085207,256,37,219,20.451990100158973,19,1012,0.1,9
2020-06-11 23:00:00+02:00,190,15,175,20.51689583562818,181,24,157,20.051163259817507,19,1012,0.1,9
2020-06-12 00:00:00+02:00,37,3,34,2.066086063070793,38,4,34,11.101073107969722,17,1004,3.7,10
2020-06-12 01:00:00+02:00,25,2,23,1.1875344360364632,25,2,23,1.1875344360364632,17,1004,3.7,10
2020-06-12 02:00:00+02:00,25,2,23,1.1875344360364632,25,2,23,1.1875344360364632,17,1004,3.7,10
2020-06-12 03:00:00+02:00,37,3,34,2.066086063070793,38,4,34,11.101073107969722,17,1004,3.7,10
2020-06-12 04:00:00+02:00,63,6,57,14.929801273937542,58,5,53,10.505136369992313,17,1004,3.7,10
2020-06-12 05:00:00+02:00,113,12,101,20.093188266697116,113,11,102,20.093188266697116,17,1004,3.7,10
2020-06-12 06:00:00+02:00,140,13,127,15.331768592489755,129,13,116,17.995114557081255,17,1004,3.7,10
2020-06-12 07:00:00+02:00,210,19,191,16.3212742992447,212,18,194,18.597605283865732,17,1004,3.7,10
2020-06-12 08:00:00+02:00,228,23,205,15.818609956751573,211,19,192,18.759232281731908,17,1004,3.7,10
2020-06-12 09:00:00+02:00,147,14,133,20.208056467665056,153,13,140,14.915022999208679,17,1004,3.7,10
2020-06-12 10:00:00+02:00,124,11,113,17.53992981591413,117,12,105,21.891304075969387,17,1004,3.7,10
2020-06-12 11:00:00+02:00,153,15,138,14.915022999208679,148,13,135,18.058884943386857,17,1004,3.7,10
2020-06-12 12:00:00+02:00,129,13,116,17.995114557081255,123,10,113,19.074654696202938,17,1004,3.7,10
2020-06-12 13:00:00+02:00,124,12,112,17.53992981591413,117,12,105,21.891304075969387,17,1004,3.7,10
2020-06-12 14:00:00+02:00,128,12,116,19.601953989978306,123,10,113,19.074654696202938,17,1004,3.7,10
2020-06-12 15:00:00+02:00,136,14,122,16.594078125250377,138,14,124,20.21600799483387,17,1004,3.7,10
2020-06-12 16:00:00+02:00,145,14,131,18.85528596371164,154,15,139,23.457384968254527,17,1004,3.7,10
2020-06-12 17:00:00+02:00,207,22,185,21.877297854955202,202,19,183,22.500350864850866,17,1004,3.7,10
2020-06-12 18:00:00+02:00,218,21,197,22.57742359713229,227,25,202,19.269071808142694,17,1004,3.7,10
2020-06-12 19:00:00+02:00,158,15,143,21.67102174389251,159,15,144,17.78748005044877,17,1004,3.7,10
2020-06-12 20:00:00+02:00,160,14,146,19.89239402952506,159,13,146,17.78748005044877,17,1004,3.7,10
2020-06-12 21:00:00+02:00,123,11,112,19.074654696202938,123,12,111,19.074654696202938,17,1004,3.7,10
2020-06-12 22:00:00+02:00,86,8,78,21.204994436842384,85,7,78,19.289671453475872,17,1004,3.7,10
2020-06-12 23:00:00+02:00,61,6,55,12.362973378192347,58,5,53,10.505136369992313,17,1004,3.7,10
2020-06-13 00:00:00+02:00,106,7,99,19.560878716092326,112,6,106,19.016823421759323,20,1007,0.0,12
2020-06-13 01:00:00+02:00,72,4,68,10.765287360581397,74,4,70,9.886934519670994,20,1007,0.0,12
2020-06-13 02:00:00+02:00,72,4,68,10.765287360581397,74,4,70,9.886934519670994,20,1007,0.0,12
2020-06-13 03:00:00+02:00,109,7,102,18.214376818550008,112,6,106,19.016823421759323,20,1007,0.0,12
2020-06-13 04:00:00+02:00,144,8,136,20.078554087092446,149,7,142,17.937448228249327,20,1007,0.0,12
2020-06-13 05:00:00+02:00,175,10,165,18.893708159250245,187,11,176,15.611538170802525,20,1007,0.0,12
2020-06-13 06:00:00+02:00,291,19,272,14.14711867692869,302,19,283,20.352052927472357,20,1007,0.0,12
2020-06-13 07:00:00+02:00,429,25,404,19.67571066122959,455,24,431,20.707907447169188,20,1007,0.0,12
2020-06-13 08:00:00+02:00,593,38,555,14.08800146097759,596,39,557,15.148785058807846,20,1007,0.0,12
2020-06-13 09:00:00+02:00,596,35,561,15.148785058807846,634,34,600,20.850521117555463,20,1007,0.0,12
2020-06-13 10:00:00+02:00,556,35,521,19.844491850776702,562,31,531,20.69762036490505,20,1007,0.0,12
2020-06-13 11:00:00+02:00,443,26,417,17.374921079246555,455,25,430,20.707907447169188,20,1007,0.0,12
2020-06-13 12:00:00+02:00,443,28,415,17.374921079246555,455,25,430,20.707907447169188,20,1007,0.0,12
2020-06-13 13:00:00+02:00,481,31,450,24.07638671243709,492,29,463,23.51531207195642,20,1007,0.0,12
2020-06-13 14:00:00+02:00,435,25,410,17.70683292278672,461,30,431,21.59648486572868,20,1007,0.0,12
2020-06-13 15:00:00+02:00,507,30,477,15.907120776028474,533,35,498,18.204577838335723,20,1007,0.0,12
2020-06-13 16:00:00+02:00,518,32,486,17.06195195164026,524,33,491,18.41315419537223,20,1007,0.0,12
2020-06-13 17:00:00+02:00,593,37,556,14.08800146097759,596,39,557,15.148785058807846,20,1007,0.0,12
2020-06-13 18:00:00+02:00,524,30,494,18.41315419537223,573,34,539,20.236010926878542,20,1007,0.0,12
2020-06-13 19:00:00+02:00,446,26,420,16.392503795900122,458,24,434,23.935839893982745,20,1007,0.0,12
2020-06-13 20:00:00+02:00,386,22,364,22.495942580430874,415,23,392,20.29207139621444,20,1007,0.0,12
2020-06-13 21:00:00+02:00,357,24,333,16.579219218063535,380,20,360,20.736920018387448,20,1007,0.0,12
2020-06-13 22:00:00+02:00,291,18,273,14.14711867692869,302,19,283,20.352052927472357,20,1007,0.0,12
2020-06-13 23:00:00+02:00,141,8,133,17.007652233540448,152,9,143,18.686880121910534,20,1007,0.0,12
2020-06-14 00:00:00+02:00,51,1,50,13.024781207847502,69,2,67,11.382640456570568,20,1014,0.0,15
2020-06-14 01:00:00+02:00,36,1,35,2.727177547566476,49,1,48,12.126419816698254,20,1014,0.0,15
2020-06-14 02:00:00+02:00,36,1,35,2.727177547566476,49,1,48,12.126419816698254,20,1014,0.0,15
2020-06-14 03:00:00+02:00,54,2,52,11.483713237443984,62,2,60,14.019247608895405,20,1014,0.0,15
2020-06-14 04:00:00+02:00,72,3,69,10.765287360581397,93,3,90,7.996959659096201,20,1014,0.0,15
2020-06-14 05:00:00+02:00,90,3,87,10.477669283936715,95,3,92,10.506818941407664,20,1014,0.0,15
2020-06-14 06:00:00+02:00,137,5,132,15.965917364236809,196,7,189,22.483124652822625,20,1014,0.0,15
2020-06-14 07:00:00+02:00,209,8,201,16.60419034744366,292,11,281,17.87884891495493,20,1014,0.0,15
2020-06-14 08:00:00+02:00,282,10,272,20.995138580232226,336,11,325,15.374523455613796,20,1014,0.0,15
2020-06-14 09:00:00+02:00,318,11,307,22.522150292755875,414,17,397,20.92110305719904,20,1014,0.0,15
2020-06-14 10:00:00+02:00,274,11,263,20.52791870989968,323,11,312,19.446887597808452,20,1014,0.0,15
2020-06-14 11:00:00+02:00,220,8,212,20.77869221062603,225,7,218,16.518156382279376,20,1014,0.0,15
2020-06-14 12:00:00+02:00,230,9,221,16.58682627515864,258,10,248,20.847323082118503,20,1014,0.0,15
2020-06-14 13:00:00+02:00,243,10,233,15.58217691478424,279,11,268,20.757341864573803,20,1014,0.0,15
2020-06-14 14:00:00+02:00,214,8,206,18.026924150727908,258,8,250,20.847323082118503,20,1014,0.0,15
2020-06-14 15:00:00+02:00,261,11,250,17.831444140197515,357,13,344,16.579219218063535,20,1014,0.0,15
2020-06-14 16:00:00+02:00,266,10,256,15.200054248100818,357,14,343,16.579219218063535,20,1014,0.0,15
2020-06-14 17:00:00+02:00,302,11,291,20.352052927472357,349,12,337,19.114918279434413,20,1014,0.0,15
2020-06-14 18:00:00+02:00,287,10,277,13.917461050382924,354,13,341,22.475031570210557,20,1014,0.0,15
2020-06-14 19:00:00+02:00,227,8,219,13.349035543905368,269,11,258,22.758175655823944,20,1014,0.0,15
2020-06-14 20:00:00+02:00,201,7,194,21.060930109433922,246,8,238,21.917745613565252,20,1014,0.0,15
2020-06-14 21:00:00+02:00,173,6,167,18.22292561400028,207,6,201,18.76558942906742,20,1014,0.0,15
2020-06-14 22:00:00+02:00,150,6,144,19.93003466929675,170,5,165,18.89757152881458,20,1014,0.0,15
2020-06-14 23:00:00+02:00,72,3,69,10.765287360581397,93,3,90,7.996959659096201,20,1014,0.0,15
2020-06-15 00:00:00+02:00,104,10,94,11.935148455597123,104,13,91,11.935148455597123,20,1016,0.3,11
2020-06-15 01:00:00+02:00,69,7,62,19.29595730158091,67,7,60,12.5039951599288,20,1016,0.3,11
2020-06-15 02:00:00+02:00,69,7,62,19.29595730158091,67,7,60,12.5039951599288,20,1016,0.3,11
2020-06-15 03:00:00+02:00,104,11,93,11.935148455597123,104,13,91,11.935148455597123,20,1016,0.3,11
2020-06-15 04:00:00+02:00,174,19,155,14.257286675630954,172,21,151,19.644113972447897,20,1016,0.3,11
2020-06-15 05:00:00+02:00,309,33,276,17.68578168988432,309,32,277,17.68578168988432,20,1016,0.3,11
2020-06-15 06:00:00+02:00,376,36,340,15.920759199358614,379,37,342,18.713391269845218,20,1016,0.3,11
2020-06-15 07:00:00+02:00,597,60,537,20.96302352029361,586,56,530,18.247067316767854,20,1016,0.3,11
2020-06-15 08:00:00+02:00,600,61,539,21.27832637503799,640,74,566,16.53063246999195,20,1016,0.3,11
2020-06-15 09:00:00+02:00,398,42,356,15.798181076462747,403,45,358,24.744299394136338,20,1016,0.3,11
2020-06-15 10:00:00+02:00,328,31,297,17.860857228116767,355,45,310,23.18890281037911,20,1016,0.3,11
2020-06-15 11:00:00+02:00,403,38,365,24.744299394136338,422,41,381,20.257299015157166,20,1016,0.3,11
2020-06-15 12:00:00+02:00,333,36,297,26.7685298712925,341,41,300,14.480776847696712,20,1016,0.3,11
2020-06-15 13:00:00+02:00,349,31,318,16.300891984453436,347,34,313,19.399384547744187,20,1016,0.3,11
2020-06-15 14:00:00+02:00,347,35,312,19.399384547744187,347,39,308,19.399384547744187,20,1016,0.3,11
2020-06-15 15:00:00+02:00,382,38,344,19.255057171585772,371,46,325,20.767700865402965,20,1016,0.3,11
2020-06-15 16:00:00+02:00,403,38,365,24.744299394136338,422,41,381,20.257299015157166,20,1016,0.3,11
2020-06-15 17:00:00+02:00,567,61,506,18.997866913295,600,63,537,21.27832637503799,20,1016,0.3,11
2020-06-15 18:00:00+02:00,616,56,560,22.224127738373518,613,77,536,18.08041903389946,20,1016,0.3,11
2020-06-15 19:00:00+02:00,454,43,411,21.947231747967304,446,54,392,22.957333740469338,20,1016,0.3,11
2020-06-15 20:00:00+02:00,433,43,390,15.756615810687446,441,47,394,21.65218956350676,20,1016,0.3,11
2020-06-15 21:00:00+02:00,336,31,305,23.28683107716768,347,39,308,19.399384547744187,20,1016,0.3,11
2020-06-15 22:00:00+02:00,242,24,218,20.990360069331732,239,26,213,13.74553452780325,20,1016,0.3,11
2020-06-15 23:00:00+02:00,177,19,158,20.028957588616944,177,19,158,20.028957588616944,20,1016,0.3,11
2020-06-16 00:00:00+02:00,106,9,97,12.94750706735717,111,12,99,12.909820125967427,20,1017,0.1,12
2020-06-16 01:00:00+02:00,61,5,56,12.362973378192347,69,6,63,19.29595730158091,20,1017,0.1,12
2020-06-16 02:00:00+02:00,64,5,59,14.414592943793718,75,8,67,14.734681497037354,20,1017,0.1,12
2020-06-16 03:00:00+02:00,103,9,94,12.113442962320551,111,12,99,12.909820125967427,20,1017,0.1,12
2020-06-16 04:00:00+02:00,156,13,143,23.175119746499636,175,19,156,17.666202741429842,20,1017,0.1,12
2020-06-16 05:00:00+02:00,318,29,289,21.634505447676812,321,32,289,23.480156167605287,20,1017,0.1,12
2020-06-16 06:00:00+02:00,388,38,350,23.106523601706122,418,40,378,19.740254716385955,20,1017,0.1,12
2020-06-16 07:00:00+02:00,572,56,516,22.464428218647974,617,68,549,19.739247366719148,20,1017,0.1,12
2020-06-16 08:00:00+02:00,575,49,526,21.211821520021783,631,69,562,19.637448203371804,20,1017,0.1,12
2020-06-16 09:00:00+02:00,379,31,348,18.713391269845218,449,46,403,18.601165629732545,20,1017,0.1,12
2020-06-16 10:00:00+02:00,323,29,294,19.17862862818099,379,41,338,18.713391269845218,20,1017,0.1,12
2020-06-16 11:00:00+02:00,424,40,384,20.771564063368263,449,43,406,18.601165629732545,20,1017,0.1,12
2020-06-16 12:00:00+02:00,323,29,294,19.17862862818099,379,41,338,18.713391269845218,20,1017,0.1,12
2020-06-16 13:00:00+02:00,354,33,321,21.22371738501729,360,33,327,23.455775768432638,20,1017,0.1,12
2020-06-16 14:00:00+02:00,357,35,322,21.912097396672888,360,33,327,23.455775768432638,20,1017,0.1,12
2020-06-16 15:00:00+02:00,390,38,352,23.204029211730827,396,44,352,20.199948477295223,20,1017,0.1,12
2020-06-16 16:00:00+02:00,379,34,345,18.713391269845218,449,46,403,18.601165629732545,20,1017,0.1,12
2020-06-16 17:00:00+02:00,550,50,500,18.784836702474678,619,53,566,21.130188595205187,20,1017,0.1,12
2020-06-16 18:00:00+02:00,614,56,558,16.05349448397906,639,66,573,21.888977134041827,20,1017,0.1,12
2020-06-16 19:00:00+02:00,421,37,384,22.41212221732918,485,47,438,22.091670962118773,20,1017,0.1,12
2020-06-16 20:00:00+02:00,463,42,421,21.06469305151698,463,40,423,21.06469305151698,20,1017,0.1,12
2020-06-16 21:00:00+02:00,357,33,324,21.912097396672888,360,33,327,23.455775768432638,20,1017,0.1,12
2020-06-16 22:00:00+02:00,248,24,224,17.312704307039937,254,27,227,21.33413531955627,20,1017,0.1,12
2020-06-16 23:00:00+02:00,164,16,148,22.827361263214527,175,16,159,17.666202741429842,20,1017,0.1,12
2020-06-17 00:00:00+02:00,117,14,103,12.235552510813584,104,11,93,10.445484927716526,19,1013,0.1,8
2020-06-17 01:00:00+02:00,77,9,68,18.339246781129614,74,7,67,17.73542510561878,19,1013,0.1,8
2020-06-17 02:00:00+02:00,77,9,68,18.339246781129614,74,7,67,17.73542510561878,19,1013,0.1,8
2020-06-17 03:00:00+02:00,117,14,103,12.235552510813584,104,11,93,10.445484927716526,19,1013,0.1,8
2020-06-17 04:00:00+02:00,194,23,171,14.773880726137394,178,18,160,13.537284957794041,19,1013,0.1,8
2020-06-17 05:00:00+02:00,351,47,304,21.009303371553763,336,31,305,21.23683051193233,19,1013,0.1,8
2020-06-17 06:00:00+02:00,434,59,375,20.9227488499813,394,38,356,22.05126282448999,19,1013,0.1,8
2020-06-17 07:00:00+02:00,659,76,583,23.08655989056449,592,66,526,18.751408237727833,19,1013,0.1,8
2020-06-17 08:00:00+02:00,706,89,617,20.9344607659246,666,65,601,21.837239142201785,19,1013,0.1,8
2020-06-17 09:00:00+02:00,468,56,412,20.750300610230987,456,47,409,19.537688174154802,19,1013,0.1,8
2020-06-17 10:00:00+02:00,391,47,344,19.080298090167734,385,48,337,22.594345401183464,19,1013,0.1,8
2020-06-17 11:00:00+02:00,468,54,414,20.750300610230987,456,47,409,19.537688174154802,19,1013,0.1,8
2020-06-17 12:00:00+02:00,391,47,344,19.080298090167734,385,48,337,22.594345401183464,19,1013,0.1,8
2020-06-17 13:00:00+02:00,388,45,343,18.513167788987648,385,48,337,22.594345401183464,19,1013,0.1,8
2020-06-17 14:00:00+02:00,388,45,343,18.513167788987648,385,48,337,22.594345401183464,19,1013,0.1,8
2020-06-17 15:00:00+02:00,428,49,379,23.45979362673577,391,48,343,19.080298090167734,19,1013,0.1,8
2020-06-17 16:00:00+02:00,471,64,407,19.847986208788534,465,46,419,22.071436322838696,19,1013,0.1,8
2020-06-17 17:00:00+02:00,656,88,568,24.305206798251668,588,56,532,22.390563440455406,19,1013,0.1,8
2020-06-17 18:00:00+02:00,715,85,630,24.35756970720332,632,66,566,17.72359535613472,19,1013,0.1,8
2020-06-17 19:00:00+02:00,505,63,442,19.315231425508955,474,55,419,19.4414848715995,19,1013,0.1,8
2020-06-17 20:00:00+02:00,502,57,445,17.102378314033963,511,60,451,23.46483660517307,19,1013,0.1,8
2020-06-17 21:00:00+02:00,394,53,341,22.05126282448999,357,35,322,24.97252919374565,19,1013,0.1,8
2020-06-17 22:00:00+02:00,271,34,237,21.366756148139427,274,30,244,27.25802623834161,19,1013,0.1,8
2020-06-17 23:00:00+02:00,194,22,172,14.773880726137394,178,18,160,13.537284957794041,19,1013,0.1,8
2020-06-18 00:00:00+02:00,102,8,94,13.093305626972347,105,13,92,15.778065052313549,19,1011,0.2,10
2020-06-18 01:00:00+02:00,63,5,58,14.929801273937542,63,8,55,14.929801273937542,19,1011,0.2,10
2020-06-18 02:00:00+02:00,58,4,54,10.505136369992313,69,11,58,19.29595730158091,19,1011,0.2,10
2020-06-18 03:00:00+02:00,102,7,95,13.093305626972347,105,13,92,15.778065052313549,19,1011,0.2,10
2020-06-18 04:00:00+02:00,164,14,150,22.827361263214527,164,22,142,22.827361263214527,19,1011,0.2,10
2020-06-18 05:00:00+02:00,311,24,287,16.325599187415413,308,41,267,20.24805474367896,19,1011,0.2,10
2020-06-18 06:00:00+02:00,389,33,356,21.37920911023894,367,47,320,20.047055443111752,19,1011,0.2,10
2020-06-18 07:00:00+02:00,514,46,468,17.018673574730677,578,85,493,21.67658958953823,19,1011,0.2,10
2020-06-18 08:00:00+02:00,575,52,523,21.211821520021783,586,92,494,18.247067316767854,19,1011,0.2,10
2020-06-18 09:00:00+02:00,411,31,380,21.89950881174465,397,64,333,20.240119954252663,19,1011,0.2,10
2020-06-18 10:00:00+02:00,347,27,320,19.399384547744187,347,50,297,19.399384547744187,19,1011,0.2,10
2020-06-18 11:00:00+02:00,389,32,357,21.37920911023894,400,51,349,22.17455177589486,19,1011,0.2,10
2020-06-18 12:00:00+02:00,336,25,311,23.28683107716768,347,50,297,19.399384547744187,19,1011,0.2,10
2020-06-18 13:00:00+02:00,322,27,295,22.976009334024873,356,56,300,20.092398613710877,19,1011,0.2,10
2020-06-18 14:00:00+02:00,314,25,289,19.381500590217087,339,42,297,21.378284288972047,19,1011,0.2,10
2020-06-18 15:00:00+02:00,358,26,332,18.044939279580262,369,56,313,22.180217499440115,19,1011,0.2,10
2020-06-18 16:00:00+02:00,372,31,341,17.388398109436665,408,54,354,21.369431512154076,19,1011,0.2,10
2020-06-18 17:00:00+02:00,606,55,551,24.38243055199842,595,80,515,20.68405691160685,19,1011,0.2,10
2020-06-18 18:00:00+02:00,567,43,524,18.997866913295,617,93,524,19.739247366719148,19,1011,0.2,10
2020-06-18 19:00:00+02:00,397,31,366,20.240119954252663,439,65,374,18.965638166337634,19,1011,0.2,10
2020-06-18 20:00:00+02:00,392,29,363,15.515848376438075,447,61,386,16.685974257079213,19,1011,0.2,10
2020-06-18 21:00:00+02:00,347,30,317,19.399384547744187,347,50,297,19.399384547744187,19,1011,0.2,10
2020-06-18 22:00:00+02:00,225,18,207,17.07968654570721,241,30,211,21.076687701702674,19,1011,0.2,10
2020-06-18 23:00:00+02:00,175,15,160,17.666202741429842,178,25,153,19.804789777436813,19,1011,0.2,10
2020-06-19 00:00:00+02:00,69,6,63,19.29595730158091,65,6,59,15.361527134905547,19,1015,0.9,12
2020-06-19 01:00:00+02:00,47,4,43,10.718407092962304,45,4,41,8.16653528554085,19,1015,0.9,12
2020-06-19 02:00:00+02:00,47,4,43,10.718407092962304,45,4,41,8.16653528554085,19,1015,0.9,12
2020-06-19 03:00:00+02:00,69,7,62,19.29595730158091,65,6,59,15.361527134905547,19,1015,0.9,12
2020-06-19 04:00:00+02:00,120,12,108,16.69246741071004,118,11,107,23.272574380346793,19,1015,0.9,12
2020-06-19 05:00:00+02:00,216,21,195,21.273439412003903,213,23,190,20.488166305452438,19,1015,0.9,12
2020-06-19 06:00:00+02:00,262,26,236,18.255168653975332,265,29,236,24.143057918667047,19,1015,0.9,12
2020-06-19 07:00:00+02:00,394,38,356,21.238013248853637,395,38,357,19.65690968439359,19,1015,0.9,12
2020-06-19 08:00:00+02:00,422,41,381,20.257299015157166,407,45,362,19.32368199778255,19,1015,0.9,12
2020-06-19 09:00:00+02:00,275,30,245,24.67224255888931,280,31,249,25.91177046818179,19,1015,0.9,12
2020-06-19 10:00:00+02:00,233,24,209,20.426009043155588,235,21,214,20.674840106170866,19,1015,0.9,12
2020-06-19 11:00:00+02:00,280,29,251,25.91177046818179,279,30,249,23.809963875172556,19,1015,0.9,12
2020-06-19 12:00:00+02:00,233,25,208,20.426009043155588,235,21,214,20.674840106170866,19,1015,0.9,12
2020-06-19 13:00:00+02:00,233,24,209,20.426009043155588,235,21,214,20.674840106170866,19,1015,0.9,12
2020-06-19 14:00:00+02:00,233,24,209,20.426009043155588,235,21,214,20.674840106170866,19,1015,0.9,12
2020-06-19 15:00:00+02:00,258,27,231,21.93153719781745,245,22,223,18.942213831390788,19,1015,0.9,12
2020-06-19 16:00:00+02:00,279,29,250,23.809963875172556,280,31,249,25.91177046818179,19,1015,0.9,12
2020-06-19 17:00:00+02:00,397,42,355,20.240119954252663,390,40,350,23.204029211730827,19,1015,0.9,12
2020-06-19 18:00:00+02:00,416,45,371,17.117872401421668,401,39,362,26.708807440790352,19,1015,0.9,12
2020-06-19 19:00:00+02:00,301,30,271,16.897732473063776,294,26,268,18.98421464015195,19,1015,0.9,12
2020-06-19 20:00:00+02:00,305,30,275,19.342371998402466,294,26,268,18.98421464015195,19,1015,0.9,12
2020-06-19 21:00:00+02:00,233,23,210,20.426009043155588,235,21,214,20.674840106170866,19,1015,0.9,12
2020-06-19 22:00:00+02:00,164,17,147,22.827361263214527,156,14,142,23.175119746499636,19,1015,0.9,12
2020-06-19 23:00:00+02:00,113,12,101,20.093188266697116,116,11,105,23.67872830820291,19,1015,0.9,12
2020-06-20 00:00:00+02:00,133,8,125,15.567856067550506,136,7,129,17.36617287321582,21,1021,0.1,6
2020-06-20 01:00:00+02:00,84,5,79,7.6306798135980785,91,4,87,8.844154374326946,21,1021,0.1,6
2020-06-20 02:00:00+02:00,84,5,79,7.6306798135980785,91,4,87,8.844154374326946,21,1021,0.1,6
2020-06-20 03:00:00+02:00,129,7,122,12.81298343964759,136,8,128,17.36617287321582,21,1021,0.1,6
2020-06-20 04:00:00+02:00,171,11,160,17.45819407743446,185,10,175,20.88033942284811,21,1021,0.1,6
2020-06-20 05:00:00+02:00,213,12,201,20.238518600536185,227,14,213,13.349035543905368,21,1021,0.1,6
2020-06-20 06:00:00+02:00,346,22,324,17.93974987663749,371,22,349,18.297011572558848,21,1021,0.1,6
2020-06-20 07:00:00+02:00,532,32,500,21.99526994910307,542,28,514,13.442306097339795,21,1021,0.1,6
2020-06-20 08:00:00+02:00,700,44,656,15.894154355642218,724,40,684,20.771863113333545,21,1021,0.1,6
2020-06-20 09:00:00+02:00,763,50,713,23.69479180203274,784,50,734,16.474066989785005,21,1021,0.1,6
2020-06-20 10:00:00+02:00,654,44,610,17.672629386873176,696,40,656,17.027923031619004,21,1021,0.1,6
2020-06-20 11:00:00+02:00,507,29,478,15.907120776028474,556,37,519,19.844491850776702,21,1021,0.1,6
2020-06-20 12:00:00+02:00,518,31,487,17.06195195164026,546,34,512,22.692406056572345,21,1021,0.1,6
2020-06-20 13:00:00+02:00,560,31,529,17.86463346985913,602,33,569,17.424831150133677,21,1021,0.1,6
2020-06-20 14:00:00+02:00,532,32,500,21.99526994910307,542,28,514,13.442306097339795,21,1021,0.1,6
2020-06-20 15:00:00+02:00,612,39,573,14.880406360759972,644,37,607,19.984917943294853,21,1021,0.1,6
2020-06-20 16:00:00+02:00,598,34,564,18.730887083184363,651,35,616,18.496340932670986,21,1021,0.1,6
2020-06-20 17:00:00+02:00,696,42,654,17.027923031619004,724,37,687,20.771863113333545,21,1021,0.1,6
2020-06-20 18:00:00+02:00,672,44,628,17.965544150858715,696,42,654,17.027923031619004,21,1021,0.1,6
2020-06-20 19:00:00+02:00,507,29,478,15.907120776028474,556,37,519,19.844491850776702,21,1021,0.1,6
2020-06-20 20:00:00+02:00,476,28,448,20.090041264055532,504,28,476,18.186363959256344,21,1021,0.1,6
2020-06-20 21:00:00+02:00,448,25,423,19.19628206057244,465,24,441,21.293065375383044,21,1021,0.1,6
2020-06-20 22:00:00+02:00,336,19,317,15.374523455613796,367,18,349,16.178745311566107,21,1021,0.1,6
2020-06-20 23:00:00+02:00,171,10,161,17.45819407743446,185,10,175,20.88033942284811,21,1021,0.1,6
2020-06-21 00:00:00+02:00,65,2,63,10.13470849860639,92,3,89,9.485995969760566,19,1020,0.0,7
2020-06-21 01:00:00+02:00,46,1,45,9.91060285131841,52,1,51,14.472017643602554,19,1020,0.0,7
2020-06-21 02:00:00+02:00,46,1,45,9.91060285131841,52,1,51,14.472017643602554,19,1020,0.0,7
2020-06-21 03:00:00+02:00,69,2,67,11.382640456570568,92,3,89,9.485995969760566,19,1020,0.0,7
2020-06-21 04:00:00+02:00,92,3,89,9.485995969760566,111,4,107,16.60196152330297,19,1020,0.0,7
2020-06-21 05:00:00+02:00,118,4,114,16.65435568776215,157,5,152,19.700921436065542,19,1020,0.0,7
2020-06-21 06:00:00+02:00,197,7,190,19.118279085736297,200,7,193,21.668114478408352,19,1020,0.0,7
2020-06-21 07:00:00+02:00,276,10,266,15.542213852127956,332,11,321,20.862138293674573,19,1020,0.0,7
2020-06-21 08:00:00+02:00,378,14,364,21.49376685031853,486,19,467,25.256807440063877,19,1020,0.0,7
2020-06-21 09:00:00+02:00,414,17,397,20.92110305719904,486,21,465,25.256807440063877,19,1020,0.0,7
2020-06-21 10:00:00+02:00,365,15,350,16.041850092706873,391,14,377,20.537782610304173,19,1020,0.0,7
2020-06-21 11:00:00+02:00,263,10,253,18.06193495748254,322,11,311,18.644637808692327,19,1020,0.0,7
2020-06-21 12:00:00+02:00,269,10,259,22.758175655823944,352,11,341,18.547693732895546,19,1020,0.0,7
2020-06-21 13:00:00+02:00,292,12,280,17.87884891495493,329,11,318,20.177718732958198,19,1020,0.0,7
2020-06-21 14:00:00+02:00,286,10,276,20.747694740560487,361,13,348,18.385612781936853,19,1020,0.0,7
2020-06-21 15:00:00+02:00,322,12,310,18.644637808692327,358,12,346,16.774588466913123,19,1020,0.0,7
2020-06-21 16:00:00+02:00,319,13,306,23.232042011552885,358,12,346,16.774588466913123,19,1020,0.0,7
2020-06-21 17:00:00+02:00,365,15,350,16.041850092706873,417,15,402,22.354466756658574,19,1020,0.0,7
2020-06-21 18:00:00+02:00,348,13,335,18.741511759901247,483,19,464,16.739079897917865,19,1020,0.0,7
2020-06-21 19:00:00+02:00,279,11,268,20.757341864573803,329,11,318,20.177718732958198,19,1020,0.0,7
2020-06-21 20:00:00+02:00,259,9,250,22.975221531884507,355,13,342,19.867707600873487,19,1020,0.0,7
2020-06-21 21:00:00+02:00,236,9,227,18.261863976847756,273,10,263,23.139691796211615,19,1020,0.0,7
2020-06-21 22:00:00+02:00,184,8,176,19.759138180971462,223,7,216,18.802339292525456,19,1020,0.0,7
2020-06-21 23:00:00+02:00,92,3,89,9.485995969760566,111,4,107,16.60196152330297,19,1020,0.0,7
2020-06-22 00:00:00+02:00,133,13,120,22.07413438879217,133,13,120,22.07413438879217,23,1025,0.1,9
2020-06-22 01:00:00+02:00,81,7,74,16.076626545182606,88,9,79,17.756927742208592,23,1025,0.1,9
2020-06-22 02:00:00+02:00,88,9,79,17.756927742208592,88,10,78,17.756927742208592,23,1025,0.1,9
2020-06-22 03:00:00+02:00,133,14,119,22.07413438879217,133,13,120,22.07413438879217,23,1025,0.1,9
2020-06-22 04:00:00+02:00,211,20,191,18.759232281731908,215,24,191,23.830284677030114,23,1025,0.1,9
2020-06-22 05:00:00+02:00,399,43,356,20.89817652151005,389,44,345,21.37920911023894,23,1025,0.1,9
2020-06-22 06:00:00+02:00,468,43,425,19.71650853762924,474,45,429,24.663345069259766,23,1025,0.1,9
2020-06-22 07:00:00+02:00,737,72,665,20.79130098472039,768,85,683,19.17235077337456,23,1025,0.1,9
2020-06-22 08:00:00+02:00,751,81,670,28.8851110430651,799,75,724,24.543008417981625,23,1025,0.1,9
2020-06-22 09:00:00+02:00,512,51,461,24.456321505157344,543,52,491,23.469937738067248,23,1025,0.1,9
2020-06-22 10:00:00+02:00,413,38,375,24.398754434847095,450,52,398,19.966269019650863,23,1025,0.1,9
2020-06-22 11:00:00+02:00,539,52,487,14.75171382469777,529,58,471,16.445273293132438,23,1025,0.1,9
2020-06-22 12:00:00+02:00,413,40,373,24.398754434847095,450,52,398,19.966269019650863,23,1025,0.1,9
2020-06-22 13:00:00+02:00,450,43,407,19.966269019650863,444,47,397,14.679521920211366,23,1025,0.1,9
2020-06-22 14:00:00+02:00,423,42,381,23.290663678046883,440,55,385,19.57754243382943,23,1025,0.1,9
2020-06-22 15:00:00+02:00,471,50,421,24.71489709392721,474,45,429,24.663345069259766,23,1025,0.1,9
2020-06-22 16:00:00+02:00,519,51,468,18.136209473828288,529,62,467,16.445273293132438,23,1025,0.1,9
2020-06-22 17:00:00+02:00,700,67,633,20.872865652778124,727,71,656,16.475797179385555,23,1025,0.1,9
2020-06-22 18:00:00+02:00,816,81,735,16.718501990725535,813,98,715,22.527079347661243,23,1025,0.1,9
2020-06-22 19:00:00+02:00,580,60,520,24.24750544028644,591,60,531,20.224560355926805,23,1025,0.1,9
2020-06-22 20:00:00+02:00,550,56,494,18.784836702474678,567,54,513,18.997866913295,23,1025,0.1,9
2020-06-22 21:00:00+02:00,433,45,388,15.756615810687446,430,46,384,19.32256414396262,23,1025,0.1,9
2020-06-22 22:00:00+02:00,297,27,270,18.348417493587977,300,29,271,19.621479548992166,23,1025,0.1,9
2020-06-22 23:00:00+02:00,208,20,188,17.851758798784658,218,21,197,22.57742359713229,23,1025,0.1,9
2020-06-23 00:00:00+02:00,137,13,124,18.928795118329443,141,14,127,21.00935462418931,23,1026,0.0,6
2020-06-23 01:00:00+02:00,91,8,83,13.154481673544206,99,8,91,10.779955578794215,23,1026,0.0,6
2020-06-23 02:00:00+02:00,87,8,79,17.896548892855574,99,8,91,10.779955578794215,23,1026,0.0,6
2020-06-23 03:00:00+02:00,133,12,121,22.07413438879217,145,14,131,18.85528596371164,23,1026,0.0,6
2020-06-23 04:00:00+02:00,236,21,215,19.106111918840778,251,27,224,19.570183352800104,23,1026,0.0,6
2020-06-23 05:00:00+02:00,404,38,366,21.094548442403457,435,40,395,21.80027200191571,23,1026,0.0,6
2020-06-23 06:00:00+02:00,488,44,444,14.865596092809506,564,58,506,17.15459670775402,23,1026,0.0,6
2020-06-23 07:00:00+02:00,759,65,694,23.764447281483374,874,86,788,22.731615929515666,23,1026,0.0,6
2020-06-23 08:00:00+02:00,793,68,725,18.854684672937857,916,86,830,17.25745951707594,23,1026,0.0,6
2020-06-23 09:00:00+02:00,538,53,485,22.05606214078663,576,53,523,19.54878368039628,23,1026,0.0,6
2020-06-23 10:00:00+02:00,477,42,435,19.637502490728593,522,52,470,19.599053099291446,23,1026,0.0,6
2020-06-23 11:00:00+02:00,587,50,537,20.028899672241884,614,62,552,16.05349448397906,23,1026,0.0,6
2020-06-23 12:00:00+02:00,438,40,398,22.221490993016946,477,40,437,19.637502490728593,23,1026,0.0,6
2020-06-23 13:00:00+02:00,484,44,440,17.863314460235074,515,46,469,22.56064635427968,23,1026,0.0,6
2020-06-23 14:00:00+02:00,480,47,433,21.905802263169644,507,48,459,20.732028813124888,23,1026,0.0,6
2020-06-23 15:00:00+02:00,538,44,494,22.05606214078663,526,48,478,21.343558174072673,23,1026,0.0,6
2020-06-23 16:00:00+02:00,530,50,480,19.57875562009149,603,67,536,20.350290442155355,23,1026,0.0,6
2020-06-23 17:00:00+02:00,744,63,681,24.83230914488915,832,75,757,21.837109952376025,23,1026,0.0,6
2020-06-23 18:00:00+02:00,839,79,760,17.019213832838712,893,86,807,23.549492661662494,23,1026,0.0,6
2020-06-23 19:00:00+02:00,637,59,578,20.615078570692955,652,72,580,17.26202686087534,23,1026,0.0,6
2020-06-23 20:00:00+02:00,557,45,512,19.98095345665478,656,64,592,18.67676415580104,23,1026,0.0,6
2020-06-23 21:00:00+02:00,480,43,437,21.905802263169644,507,48,459,20.732028813124888,23,1026,0.0,6
2020-06-23 22:00:00+02:00,339,28,311,21.378284288972047,358,30,328,18.044939279580262,23,1026,0.0,6
2020-06-23 23:00:00+02:00,221,20,201,20.34114880306217,248,21,227,17.312704307039937,23,1026,0.0,6
2020-06-24 00:00:00+02:00,130,16,114,18.726979359073987,130,14,116,18.726979359073987,26,1021,0.0,12
2020-06-24 01:00:00+02:00,88,10,78,14.606173107577572,81,9,72,20.92938881342839,26,1021,0.0,12
2020-06-24 02:00:00+02:00,88,10,78,14.606173107577572,81,9,72,20.92938881342839,26,1021,0.0,12
2020-06-24 03:00:00+02:00,130,16,114,18.726979359073987,130,14,116,18.726979359073987,26,1021,0.0,12
2020-06-24 04:00:00+02:00,225,27,198,24.523176463388204,215,26,189,19.111985716553264,26,1021,0.0,12
2020-06-24 05:00:00+02:00,398,50,348,17.528461730035602,405,48,357,14.76615081927329,26,1021,0.0,12
2020-06-24 06:00:00+02:00,497,68,429,17.263066617754735,472,54,418,16.716083148489194,26,1021,0.0,12
2020-06-24 07:00:00+02:00,772,100,672,31.400191784114593,684,85,599,23.45519831438158,26,1021,0.0,12
2020-06-24 08:00:00+02:00,807,109,698,19.482572079647852,733,69,664,22.35483800869767,26,1021,0.0,12
2020-06-24 09:00:00+02:00,539,67,472,10.791173026607634,522,54,468,18.0567977332051,26,1021,0.0,12
2020-06-24 10:00:00+02:00,451,53,398,15.27543247912955,409,46,363,24.581033645594804,26,1021,0.0,12
2020-06-24 11:00:00+02:00,529,72,457,15.236255847579951,543,56,487,10.77336456884601,26,1021,0.0,12
2020-06-24 12:00:00+02:00,448,52,396,20.768496400108308,412,50,362,18.26785157491369,26,1021,0.0,12
2020-06-24 13:00:00+02:00,451,51,400,15.27543247912955,409,46,363,24.581033645594804,26,1021,0.0,12
2020-06-24 14:00:00+02:00,441,60,381,19.941245755270646,426,53,373,15.976172437190886,26,1021,0.0,12
2020-06-24 15:00:00+02:00,490,66,424,19.351577140686242,483,57,426,21.086662647611625,26,1021,0.0,12
2020-06-24 16:00:00+02:00,543,71,472,10.77336456884601,518,51,467,19.12914003399451,26,1021,0.0,12
2020-06-24 17:00:00+02:00,772,91,681,31.400191784114593,684,85,599,23.45519831438158,26,1021,0.0,12
2020-06-24 18:00:00+02:00,807,109,698,19.482572079647852,733,69,664,22.35483800869767,26,1021,0.0,12
2020-06-24 19:00:00+02:00,585,72,513,19.751804156270225,546,68,478,23.163613366507786,26,1021,0.0,12
2020-06-24 20:00:00+02:00,582,66,516,20.910415358843235,518,63,455,19.12914003399451,26,1021,0.0,12
2020-06-24 21:00:00+02:00,451,53,398,15.27543247912955,409,46,363,24.581033645594804,26,1021,0.0,12
2020-06-24 22:00:00+02:00,306,41,265,26.454632237997544,303,36,267,23.70503562215664,26,1021,0.0,12
2020-06-24 23:00:00+02:00,218,25,193,22.73300845004657,201,25,176,22.061472810845842,26,1021,0.0,12
2020-06-25 00:00:00+02:00,127,11,116,19.116953333289125,123,16,107,19.074654696202938,27,1018,0.0,13
2020-06-25 01:00:00+02:00,81,6,75,16.076626545182606,84,11,73,14.398269762880606,27,1018,0.0,13
2020-06-25 02:00:00+02:00,88,7,81,17.756927742208592,88,13,75,17.756927742208592,27,1018,0.0,13
2020-06-25 03:00:00+02:00,130,10,120,15.65660051079879,127,15,112,19.116953333289125,27,1018,0.0,13
2020-06-25 04:00:00+02:00,222,16,206,18.77573498601868,204,30,174,12.517560993101368,27,1018,0.0,13
2020-06-25 05:00:00+02:00,395,30,365,19.65690968439359,391,53,338,20.019115852021912,27,1018,0.0,13
2020-06-25 06:00:00+02:00,434,33,401,17.25970681294468,497,60,437,23.514377363791095,27,1018,0.0,13
2020-06-25 07:00:00+02:00,688,59,629,21.73100367401043,716,88,628,23.791426922742517,27,1018,0.0,13
2020-06-25 08:00:00+02:00,801,69,732,23.10339814621197,744,116,628,24.83230914488915,27,1018,0.0,13
2020-06-25 09:00:00+02:00,473,37,436,22.543653481241357,518,72,446,22.68283075592232,27,1018,0.0,13
2020-06-25 10:00:00+02:00,413,35,378,24.398754434847095,416,58,358,17.117872401421668,27,1018,0.0,13
2020-06-25 11:00:00+02:00,518,39,479,22.68283075592232,529,80,449,16.445273293132438,27,1018,0.0,13
2020-06-25 12:00:00+02:00,427,32,395,18.502781357559265,423,67,356,23.290663678046883,27,1018,0.0,13
2020-06-25 13:00:00+02:00,409,37,372,21.723119645649348,420,68,352,20.41205404512006,27,1018,0.0,13
2020-06-25 14:00:00+02:00,409,37,372,21.723119645649348,420,68,352,20.41205404512006,27,1018,0.0,13
2020-06-25 15:00:00+02:00,451,40,411,20.489203978314702,497,67,430,23.514377363791095,27,1018,0.0,13
2020-06-25 16:00:00+02:00,483,41,442,21.366599546374843,511,74,437,22.27774281923901,27,1018,0.0,13
2020-06-25 17:00:00+02:00,744,56,688,24.83230914488915,720,93,627,19.944056890178263,27,1018,0.0,13
2020-06-25 18:00:00+02:00,744,66,678,24.83230914488915,762,99,663,22.895858199698157,27,1018,0.0,13
2020-06-25 19:00:00+02:00,586,51,535,18.247067316767854,547,80,467,20.747394942344446,27,1018,0.0,13
2020-06-25 20:00:00+02:00,561,42,519,19.266161028294455,589,78,511,24.4118965594369,27,1018,0.0,13
2020-06-25 21:00:00+02:00,448,40,408,23.047509824765182,423,61,362,23.290663678046883,27,1018,0.0,13
2020-06-25 22:00:00+02:00,285,25,260,23.62629721954127,317,49,268,23.692514426518255,27,1018,0.0,13
2020-06-25 23:00:00+02:00,194,16,178,21.593451125557873,222,28,194,18.77573498601868,27,1018,0.0,13
2020-06-26 00:00:00+02:00,111,11,100,12.909820125967427,108,9,99,14.813734676069407,23,1012,0.4,9
2020-06-26 01:00:00+02:00,74,6,68,19.513800836509724,77,7,70,16.632320143368542,23,1012,0.4,9
2020-06-26 02:00:00+02:00,77,8,69,16.632320143368542,77,8,69,16.632320143368542,23,1012,0.4,9
2020-06-26 03:00:00+02:00,114,12,102,18.09348958441383,111,12,99,12.909820125967427,23,1012,0.4,9
2020-06-26 04:00:00+02:00,186,17,169,22.772295906033783,180,15,165,20.970253971133605,23,1012,0.4,9
2020-06-26 05:00:00+02:00,350,36,314,21.39774246689966,347,35,312,19.399384547744187,23,1012,0.4,9
2020-06-26 06:00:00+02:00,425,43,382,20.977086023346995,418,41,377,19.740254716385955,23,1012,0.4,9
2020-06-26 07:00:00+02:00,657,71,586,15.746859620588204,636,66,570,21.66562740120439,23,1012,0.4,9
2020-06-26 08:00:00+02:00,692,74,618,27.354046214615703,701,77,624,21.383747865714252,23,1012,0.4,9
2020-06-26 09:00:00+02:00,450,41,409,19.966269019650863,474,45,429,24.663345069259766,23,1012,0.4,9
2020-06-26 10:00:00+02:00,384,37,347,23.18758332904822,394,40,354,21.238013248853637,23,1012,0.4,9
2020-06-26 11:00:00+02:00,462,45,417,18.95008410951899,443,38,405,13.62175880122913,23,1012,0.4,9
2020-06-26 12:00:00+02:00,378,38,340,19.765573549462566,384,34,350,23.18758332904822,23,1012,0.4,9
2020-06-26 13:00:00+02:00,394,43,351,21.238013248853637,384,37,347,23.18758332904822,23,1012,0.4,9
2020-06-26 14:00:00+02:00,394,43,351,21.238013248853637,384,37,347,23.18758332904822,23,1012,0.4,9
2020-06-26 15:00:00+02:00,434,47,387,17.25970681294468,437,37,400,22.67431624563715,23,1012,0.4,9
2020-06-26 16:00:00+02:00,471,44,427,24.71489709392721,443,38,405,13.62175880122913,23,1012,0.4,9
2020-06-26 17:00:00+02:00,645,65,580,16.744777717821215,614,59,555,16.05349448397906,23,1012,0.4,9
2020-06-26 18:00:00+02:00,679,69,610,23.086813289974494,701,78,623,21.383747865714252,23,1012,0.4,9
2020-06-26 19:00:00+02:00,487,45,442,15.627714583030805,508,52,456,22.57591031476529,23,1012,0.4,9
2020-06-26 20:00:00+02:00,518,53,465,22.68283075592232,502,53,449,11.735836537408174,23,1012,0.4,9
2020-06-26 21:00:00+02:00,384,39,345,23.18758332904822,394,40,354,21.238013248853637,23,1012,0.4,9
2020-06-26 22:00:00+02:00,270,26,244,23.920073269237992,273,23,250,23.61851837889036,23,1012,0.4,9
2020-06-26 23:00:00+02:00,192,17,175,21.295822766447603,192,18,174,21.295822766447603,23,1012,0.4,9
2020-06-27 00:00:00+02:00,118,7,111,16.65435568776215,124,7,117,14.467255533674502,21,1011,0.0,10
2020-06-27 01:00:00+02:00,76,4,72,13.279950485691732,82,5,77,8.6962433625344,21,1011,0.0,10
2020-06-27 02:00:00+02:00,76,4,72,13.279950485691732,82,5,77,8.6962433625344,21,1011,0.0,10
2020-06-27 03:00:00+02:00,118,6,112,16.65435568776215,124,7,117,14.467255533674502,21,1011,0.0,10
2020-06-27 04:00:00+02:00,153,9,144,18.67945251137068,162,8,154,18.435104799511247,21,1011,0.0,10
2020-06-27 05:00:00+02:00,197,12,185,19.118279085736297,204,12,192,20.27930898180519,21,1011,0.0,10
2020-06-27 06:00:00+02:00,322,20,302,18.644637808692327,331,18,313,19.942495480727644,21,1011,0.0,10
2020-06-27 07:00:00+02:00,485,28,457,23.26524199136097,497,31,466,21.81643259773707,21,1011,0.0,10
2020-06-27 08:00:00+02:00,644,37,607,19.984917943294853,660,33,627,18.6631029781559,21,1011,0.0,10
2020-06-27 09:00:00+02:00,689,40,649,19.72727483528297,699,35,664,21.213561945433263,21,1011,0.0,10
2020-06-27 10:00:00+02:00,577,37,540,17.038371488313466,622,31,591,12.695140458710284,21,1011,0.0,10
2020-06-27 11:00:00+02:00,462,26,436,22.520787209725228,501,28,473,17.91816636651384,21,1011,0.0,10
2020-06-27 12:00:00+02:00,491,31,460,20.639383164942465,497,31,466,21.81643259773707,21,1011,0.0,10
2020-06-27 13:00:00+02:00,523,30,493,15.86377141768892,545,30,515,20.585179405284507,21,1011,0.0,10
2020-06-27 14:00:00+02:00,472,26,446,15.966412489673269,504,31,473,18.186363959256344,21,1011,0.0,10
2020-06-27 15:00:00+02:00,574,32,542,14.666429953470098,584,38,546,20.69288146543853,21,1011,0.0,10
2020-06-27 16:00:00+02:00,574,33,541,14.666429953470098,584,38,546,20.69288146543853,21,1011,0.0,10
2020-06-27 17:00:00+02:00,654,37,617,17.672629386873176,676,39,637,16.2752163075492,21,1011,0.0,10
2020-06-27 18:00:00+02:00,584,33,551,20.69288146543853,635,33,602,14.00526989171057,21,1011,0.0,10
2020-06-27 19:00:00+02:00,491,31,460,20.639383164942465,497,31,466,21.81643259773707,21,1011,0.0,10
2020-06-27 20:00:00+02:00,443,26,417,17.374921079246555,462,26,436,22.520787209725228,21,1011,0.0,10
2020-06-27 21:00:00+02:00,399,24,375,22.11505355738079,411,27,384,17.61880175865933,21,1011,0.0,10
2020-06-27 22:00:00+02:00,319,21,298,23.232042011552885,331,18,313,19.942495480727644,21,1011,0.0,10
2020-06-27 23:00:00+02:00,159,9,150,19.89258263570152,169,8,161,20.526675282456768,21,1011,0.0,10
2020-06-28 00:00:00+02:00,43,1,42,8.357669380798958,41,1,40,7.51149883575918,19,1014,0.0,20
2020-06-28 01:00:00+02:00,27,1,26,0.2711247026271743,37,1,36,3.5125252112896685,19,1014,0.0,20
2020-06-28 02:00:00+02:00,27,1,26,0.2711247026271743,37,1,36,3.5125252112896685,19,1014,0.0,20
2020-06-28 03:00:00+02:00,41,1,40,7.51149883575918,53,1,52,12.671576687621188,19,1014,0.0,20
2020-06-28 04:00:00+02:00,57,2,55,11.247345675463038,73,3,70,10.015349835153332,19,1014,0.0,20
2020-06-28 05:00:00+02:00,69,2,67,11.382640456570568,93,3,90,7.996959659096201,19,1014,0.0,20
2020-06-28 06:00:00+02:00,113,4,109,20.97275705288615,127,4,123,18.022773693841014,19,1014,0.0,20
2020-06-28 07:00:00+02:00,164,7,157,18.874121315806054,224,8,216,19.039166559272836,19,1014,0.0,20
2020-06-28 08:00:00+02:00,214,8,206,18.026924150727908,263,8,255,18.06193495748254,19,1014,0.0,20
2020-06-28 09:00:00+02:00,234,8,226,18.523045519331724,279,10,269,20.757341864573803,19,1014,0.0,20
2020-06-28 10:00:00+02:00,206,7,199,20.90053052788098,238,9,229,14.411005913654613,19,1014,0.0,20
2020-06-28 11:00:00+02:00,164,6,158,18.874121315806054,224,8,216,19.039166559272836,19,1014,0.0,20
2020-06-28 12:00:00+02:00,160,6,154,18.858823274894117,202,7,195,21.075229783177793,19,1014,0.0,20
2020-06-28 13:00:00+02:00,180,6,174,18.453361889556408,204,7,197,20.27930898180519,19,1014,0.0,20
2020-06-28 14:00:00+02:00,172,6,166,18.863206387348974,172,5,167,18.863206387348974,19,1014,0.0,20
2020-06-28 15:00:00+02:00,206,7,199,20.90053052788098,222,8,214,17.594973015311762,19,1014,0.0,20
2020-06-28 16:00:00+02:00,190,8,182,20.182913119811044,254,8,246,20.69602346457387,19,1014,0.0,20
2020-06-28 17:00:00+02:00,228,9,219,19.28787791304013,275,11,264,20.236154766209,19,1014,0.0,20
2020-06-28 18:00:00+02:00,210,9,201,17.488096079787415,244,8,236,18.556057346091794,19,1014,0.0,20
2020-06-28 19:00:00+02:00,168,6,162,15.312398611458734,222,8,214,17.594973015311762,19,1014,0.0,20
2020-06-28 20:00:00+02:00,150,6,144,19.93003466929675,180,5,175,18.453361889556408,19,1014,0.0,20
2020-06-28 21:00:00+02:00,134,5,129,14.696678321454899,188,7,181,19.664617237016223,19,1014,0.0,20
2020-06-28 22:00:00+02:00,109,4,105,18.214376818550008,146,5,141,19.4340926707284,19,1014,0.0,20
2020-06-28 23:00:00+02:00,55,2,53,10.027044718132117,55,2,53,10.027044718132117,19,1014,0.0,20
2020-06-29 00:00:00+02:00,89,8,81,17.562315027840828,94,8,86,13.172779715339633,18,1016,0.2,12
2020-06-29 01:00:00+02:00,59,6,53,10.572210467564378,64,6,58,14.414592943793718,18,1016,0.2,12
2020-06-29 02:00:00+02:00,64,6,58,14.414592943793718,64,7,57,14.414592943793718,18,1016,0.2,12
2020-06-29 03:00:00+02:00,96,10,86,11.83328593996439,91,11,80,13.154481673544206,18,1016,0.2,12
2020-06-29 04:00:00+02:00,156,14,142,23.175119746499636,156,19,137,23.175119746499636,18,1016,0.2,12
2020-06-29 05:00:00+02:00,272,29,243,23.2664106640069,292,30,262,18.509650933155072,18,1016,0.2,12
2020-06-29 06:00:00+02:00,332,34,298,21.454526645627976,359,36,323,21.41163694321985,18,1016,0.2,12
2020-06-29 07:00:00+02:00,528,55,473,18.074163042875583,540,67,473,16.578820343867154,18,1016,0.2,12
2020-06-29 08:00:00+02:00,578,52,526,21.67658958953823,573,71,502,13.397132275797208,18,1016,0.2,12
2020-06-29 09:00:00+02:00,374,39,335,18.17629135420491,379,39,340,18.713391269845218,18,1016,0.2,12
2020-06-29 10:00:00+02:00,322,32,290,22.976009334024873,327,40,287,17.492932564197055,18,1016,0.2,12
2020-06-29 11:00:00+02:00,372,34,338,17.388398109436665,379,39,340,18.713391269845218,18,1016,0.2,12
2020-06-29 12:00:00+02:00,322,32,290,22.976009334024873,327,40,287,17.492932564197055,18,1016,0.2,12
2020-06-29 13:00:00+02:00,310,29,281,16.921651532922695,317,33,284,23.692514426518255,18,1016,0.2,12
2020-06-29 14:00:00+02:00,305,30,275,19.342371998402466,312,31,281,18.640393178431868,18,1016,0.2,12
2020-06-29 15:00:00+02:00,347,33,314,19.399384547744187,352,39,313,20.33829699034963,18,1016,0.2,12
2020-06-29 16:00:00+02:00,372,37,335,17.388398109436665,379,39,340,18.713391269845218,18,1016,0.2,12
2020-06-29 17:00:00+02:00,550,56,494,18.784836702474678,538,52,486,22.05606214078663,18,1016,0.2,12
2020-06-29 18:00:00+02:00,543,51,492,23.469937738067248,558,55,503,21.887504875695765,18,1016,0.2,12
2020-06-29 19:00:00+02:00,392,36,356,15.515848376438075,414,44,370,21.211929621647883,18,1016,0.2,12
2020-06-29 20:00:00+02:00,394,38,356,21.238013248853637,414,44,370,21.211929621647883,18,1016,0.2,12
2020-06-29 21:00:00+02:00,302,29,273,17.71336274061634,310,34,276,16.921651532922695,18,1016,0.2,12
2020-06-29 22:00:00+02:00,220,21,199,16.758079648934128,220,21,199,16.758079648934128,18,1016,0.2,12
2020-06-29 23:00:00+02:00,156,14,142,23.175119746499636,156,19,137,23.175119746499636,18,1016,0.2,12
2020-06-30 00:00:00+02:00,84,8,76,14.398269762880606,101,11,90,11.280950715811313,18,1016,0.0,14
2020-06-30 01:00:00+02:00,59,5,54,10.572210467564378,62,5,57,14.48690450543278,18,1016,0.0,14
2020-06-30 02:00:00+02:00,54,4,50,10.37826089518735,64,7,57,14.414592943793718,18,1016,0.0,14
2020-06-30 03:00:00+02:00,94,8,86,13.172779715339633,94,10,84,13.172779715339633,18,1016,0.0,14
2020-06-30 04:00:00+02:00,141,13,128,21.00935462418931,168,16,152,20.304807772345505,18,1016,0.0,14
2020-06-30 05:00:00+02:00,265,23,242,24.143057918667047,290,27,263,18.088844908617002,18,1016,0.0,14
2020-06-30 06:00:00+02:00,322,30,292,22.976009334024873,372,41,331,17.388398109436665,18,1016,0.0,14
2020-06-30 07:00:00+02:00,501,43,458,20.940750692732994,558,56,502,21.887504875695765,18,1016,0.0,14
2020-06-30 08:00:00+02:00,570,47,523,25.11924504296083,578,53,525,21.67658958953823,18,1016,0.0,14
2020-06-30 09:00:00+02:00,354,34,320,21.22371738501729,384,35,349,23.18758332904822,18,1016,0.0,14
2020-06-30 10:00:00+02:00,310,30,280,16.921651532922695,325,30,295,19.331050121665143,18,1016,0.0,14
2020-06-30 11:00:00+02:00,369,35,334,22.180217499440115,382,38,344,19.255057171585772,18,1016,0.0,14
2020-06-30 12:00:00+02:00,285,27,258,23.62629721954127,339,37,302,21.378284288972047,18,1016,0.0,14
2020-06-30 13:00:00+02:00,302,24,278,17.71336274061634,312,31,281,18.640393178431868,18,1016,0.0,14
2020-06-30 14:00:00+02:00,295,25,270,20.557446011766526,317,27,290,23.692514426518255,18,1016,0.0,14
2020-06-30 15:00:00+02:00,315,28,287,16.084372336057935,347,35,312,19.399384547744187,18,1016,0.0,14
2020-06-30 16:00:00+02:00,359,33,326,21.41163694321985,384,40,344,23.18758332904822,18,1016,0.0,14
2020-06-30 17:00:00+02:00,528,52,476,18.074163042875583,558,62,496,21.887504875695765,18,1016,0.0,14
2020-06-30 18:00:00+02:00,570,47,523,25.11924504296083,578,53,525,21.67658958953823,18,1016,0.0,14
2020-06-30 19:00:00+02:00,384,37,347,23.18758332904822,436,44,392,21.770703310925605,18,1016,0.0,14
2020-06-30 20:00:00+02:00,362,29,333,18.208767664177746,421,48,373,22.41212221732918,18,1016,0.0,14
2020-06-30 21:00:00+02:00,300,26,274,19.621479548992166,312,31,281,18.640393178431868,18,1016,0.0,14
2020-06-30 22:00:00+02:00,205,17,188,13.47116079711613,228,20,208,15.818609956751573,18,1016,0.0,14
2020-06-30 23:00:00+02:00,138,11,127,20.21600799483387,153,15,138,14.915022999208679,18,1016,0.0,14
2020-07-01 00:00:00+02:00,117,13,104,12.235552510813584,105,11,94,16.064586492970292,21,1011,0.0,11
2020-07-01 01:00:00+02:00,77,9,68,18.339246781129614,74,7,67,17.73542510561878,21,1011,0.0,11
2020-07-01 02:00:00+02:00,77,9,68,18.339246781129614,74,7,67,17.73542510561878,21,1011,0.0,11
2020-07-01 03:00:00+02:00,117,14,103,12.235552510813584,105,11,94,16.064586492970292,21,1011,0.0,11
2020-07-01 04:00:00+02:00,194,24,170,14.773880726137394,179,18,161,9.836620485396171,21,1011,0.0,11
2020-07-01 05:00:00+02:00,352,47,305,22.013609081992854,330,33,297,22.0130860795424,21,1011,0.0,11
2020-07-01 06:00:00+02:00,435,59,376,25.413604199879654,389,42,347,21.07501193814523,21,1011,0.0,11
2020-07-01 07:00:00+02:00,670,76,594,22.82449181130126,664,72,592,22.61074383090897,21,1011,0.0,11
2020-07-01 08:00:00+02:00,698,90,608,14.099832565474687,674,82,592,17.600774932092264,21,1011,0.0,11
2020-07-01 09:00:00+02:00,463,58,405,18.132001100567706,445,45,400,16.661198829462172,21,1011,0.0,11
2020-07-01 10:00:00+02:00,389,45,344,21.07501193814523,386,37,349,23.082433245575533,21,1011,0.0,11
2020-07-01 11:00:00+02:00,469,54,415,22.98744594026073,476,56,420,21.264665184026093,21,1011,0.0,11
2020-07-01 12:00:00+02:00,386,44,342,23.082433245575533,371,37,334,19.26013813327,21,1011,0.0,11
2020-07-01 13:00:00+02:00,389,53,336,21.07501193814523,386,37,349,23.082433245575533,21,1011,0.0,11
2020-07-01 14:00:00+02:00,389,45,344,21.07501193814523,386,37,349,23.082433245575533,21,1011,0.0,11
2020-07-01 15:00:00+02:00,429,50,379,17.80816630829195,411,44,367,23.42311543355913,21,1011,0.0,11
2020-07-01 16:00:00+02:00,466,61,405,19.4378602775798,426,48,378,15.976172437190886,21,1011,0.0,11
2020-07-01 17:00:00+02:00,664,90,574,22.61074383090897,612,71,541,25.039713085529943,21,1011,0.0,11
2020-07-01 18:00:00+02:00,701,90,611,20.522903618154327,630,72,558,18.08859787789587,21,1011,0.0,11
2020-07-01 19:00:00+02:00,507,63,444,15.628100284848658,476,56,420,21.264665184026093,21,1011,0.0,11
2020-07-01 20:00:00+02:00,504,57,447,23.46731722283721,476,56,420,21.264665184026093,21,1011,0.0,11
2020-07-01 21:00:00+02:00,386,44,342,23.082433245575533,371,37,334,19.26013813327,21,1011,0.0,11
2020-07-01 22:00:00+02:00,272,37,235,13.314603904224033,265,32,233,20.34267348407847,21,1011,0.0,11
2020-07-01 23:00:00+02:00,191,22,169,18.737812367944354,179,17,162,9.836620485396171,21,1011,0.0,11
2020-07-02 00:00:00+02:00,84,7,77,14.398269762880606,94,14,80,13.172779715339633,19,1011,0.2,13
2020-07-02 01:00:00+02:00,54,4,50,10.37826089518735,62,9,53,14.48690450543278,19,1011,0.2,13
2020-07-02 02:00:00+02:00,52,4,48,6.894026658963235,59,8,51,10.572210467564378,19,1011,0.2,13
2020-07-02 03:00:00+02:00,94,8,86,13.172779715339633,86,13,73,21.204994436842384,19,1011,0.2,13
2020-07-02 04:00:00+02:00,153,13,140,14.915022999208679,153,19,134,14.915022999208679,19,1011,0.2,13
2020-07-02 05:00:00+02:00,258,19,239,21.93153719781745,265,35,230,24.143057918667047,19,1011,0.2,13
2020-07-02 06:00:00+02:00,307,24,283,19.62844127124222,325,50,275,19.331050121665143,19,1011,0.2,13
2020-07-02 07:00:00+02:00,538,45,493,22.05606214078663,493,65,428,23.14736404920122,19,1011,0.2,13
2020-07-02 08:00:00+02:00,521,47,474,19.221358989967857,558,86,472,21.887504875695765,19,1011,0.2,13
2020-07-02 09:00:00+02:00,367,27,340,20.047055443111752,349,56,293,16.300891984453436,19,1011,0.2,13
2020-07-02 10:00:00+02:00,287,22,265,21.927304089805975,305,40,265,19.342371998402466,19,1011,0.2,13
2020-07-02 11:00:00+02:00,332,25,307,21.454526645627976,362,47,315,18.208767664177746,19,1011,0.2,13
2020-07-02 12:00:00+02:00,315,27,288,16.084372336057935,295,42,253,20.557446011766526,19,1011,0.2,13
2020-07-02 13:00:00+02:00,275,21,254,24.67224255888931,307,49,258,19.62844127124222,19,1011,0.2,13
2020-07-02 14:00:00+02:00,275,24,251,24.67224255888931,307,49,258,19.62844127124222,19,1011,0.2,13
2020-07-02 15:00:00+02:00,302,26,276,17.71336274061634,322,46,276,22.976009334024873,19,1011,0.2,13
2020-07-02 16:00:00+02:00,372,32,340,17.388398109436665,364,48,316,19.12804198058144,19,1011,0.2,13
2020-07-02 17:00:00+02:00,481,43,438,25.78446993067148,536,69,467,19.543488507279786,19,1011,0.2,13
2020-07-02 18:00:00+02:00,526,43,483,21.343558174072673,536,82,454,19.543488507279786,19,1011,0.2,13
2020-07-02 19:00:00+02:00,379,31,348,18.713391269845218,406,59,347,17.471736216533994,19,1011,0.2,13
2020-07-02 20:00:00+02:00,392,30,362,15.515848376438075,399,55,344,20.89817652151005,19,1011,0.2,13
2020-07-02 21:00:00+02:00,310,24,286,16.921651532922695,305,41,264,19.342371998402466,19,1011,0.2,13
2020-07-02 22:00:00+02:00,193,15,178,21.558071117560736,215,29,186,23.830284677030114,19,1011,0.2,13
2020-07-02 23:00:00+02:00,146,13,133,20.98788244482569,156,19,137,23.175119746499636,19,1011,0.2,13
2020-07-03 00:00:00+02:00,114,12,102,18.09348958441383,114,13,101,18.09348958441383,20,1018,0.0,9
2020-07-03 01:00:00+02:00,76,8,68,16.686685835236233,76,8,68,16.686685835236233,20,1018,0.0,9
2020-07-03 02:00:00+02:00,76,8,68,16.686685835236233,76,8,68,16.686685835236233,20,1018,0.0,9
2020-07-03 03:00:00+02:00,114,12,102,18.09348958441383,114,13,101,18.09348958441383,20,1018,0.0,9
2020-07-03 04:00:00+02:00,194,21,173,21.593451125557873,201,17,184,22.51450761920508,20,1018,0.0,9
2020-07-03 05:00:00+02:00,351,35,316,16.04918751558848,348,34,314,20.566317862558048,20,1018,0.0,9
2020-07-03 06:00:00+02:00,431,42,389,17.591114272986506,437,49,388,22.67431624563715,20,1018,0.0,9
2020-07-03 07:00:00+02:00,689,65,624,23.980963452069407,648,56,592,21.117444098521716,20,1018,0.0,9
2020-07-03 08:00:00+02:00,696,70,626,26.69245726125086,677,70,607,20.739584517025623,20,1018,0.0,9
2020-07-03 09:00:00+02:00,479,51,428,24.037051458292083,463,47,416,21.06469305151698,20,1018,0.0,9
2020-07-03 10:00:00+02:00,408,42,366,21.369431512154076,380,43,337,15.070197513038655,20,1018,0.0,9
2020-07-03 11:00:00+02:00,466,50,416,20.265872741633896,456,39,417,14.42236972784694,20,1018,0.0,9
2020-07-03 12:00:00+02:00,411,38,373,21.89950881174465,380,43,337,15.070197513038655,20,1018,0.0,9
2020-07-03 13:00:00+02:00,389,41,348,21.37920911023894,383,34,349,23.132924781238575,20,1018,0.0,9
2020-07-03 14:00:00+02:00,405,44,361,18.172278090342537,376,42,334,15.920759199358614,20,1018,0.0,9
2020-07-03 15:00:00+02:00,437,40,397,22.67431624563715,427,46,381,18.502781357559265,20,1018,0.0,9
2020-07-03 16:00:00+02:00,469,50,419,24.504404421652193,485,46,439,22.091670962118773,20,1018,0.0,9
2020-07-03 17:00:00+02:00,696,69,627,26.69245726125086,638,66,572,19.261703644868717,20,1018,0.0,9
2020-07-03 18:00:00+02:00,718,66,652,20.275643080512808,705,61,644,27.972959296472958,20,1018,0.0,9
2020-07-03 19:00:00+02:00,520,47,473,21.447261472760864,507,55,452,20.732028813124888,20,1018,0.0,9
2020-07-03 20:00:00+02:00,533,48,485,22.139738081927035,530,49,481,19.57875562009149,20,1018,0.0,9
2020-07-03 21:00:00+02:00,396,42,354,20.199948477295223,373,37,336,20.02368697341565,20,1018,0.0,9
2020-07-03 22:00:00+02:00,274,26,248,20.56786912693606,277,31,246,24.920160895876304,20,1018,0.0,9
2020-07-03 23:00:00+02:00,201,20,181,22.51450761920508,188,19,169,22.908938245974742,20,1018,0.0,9
2020-07-04 00:00:00+02:00,113,7,106,20.97275705288615,116,6,110,11.000262455867666,20,1021,0.0,11
2020-07-04 01:00:00+02:00,71,4,67,11.584371388309396,77,5,72,11.693765322784895,20,1021,0.0,11
2020-07-04 02:00:00+02:00,74,4,70,9.886934519670994,77,4,73,11.693765322784895,20,1021,0.0,11
2020-07-04 03:00:00+02:00,113,7,106,20.97275705288615,116,6,110,11.000262455867666,20,1021,0.0,11
2020-07-04 04:00:00+02:00,146,9,137,19.4340926707284,155,8,147,18.708796369633056,20,1021,0.0,11
2020-07-04 05:00:00+02:00,179,10,169,21.74229179161351,194,10,184,19.241214114048436,20,1021,0.0,11
2020-07-04 06:00:00+02:00,299,17,282,16.471342376610473,308,19,289,19.852115147138527,20,1021,0.0,11
2020-07-04 07:00:00+02:00,437,27,410,20.40675859398746,473,25,448,14.300214591159298,20,1021,0.0,11
2020-07-04 08:00:00+02:00,596,36,560,15.148785058807846,620,33,587,15.579919444904501,20,1021,0.0,11
2020-07-04 09:00:00+02:00,617,35,582,19.544255715952797,671,34,637,19.7199914355923,20,1021,0.0,11
2020-07-04 10:00:00+02:00,575,34,541,15.295280006044948,596,32,564,15.148785058807846,20,1021,0.0,11
2020-07-04 11:00:00+02:00,437,25,412,20.40675859398746,473,25,448,14.300214591159298,20,1021,0.0,11
2020-07-04 12:00:00+02:00,446,27,419,16.392503795900122,476,25,451,20.090041264055532,20,1021,0.0,11
2020-07-04 13:00:00+02:00,485,29,456,23.26524199136097,509,31,478,20.085378936033393,20,1021,0.0,11
2020-07-04 14:00:00+02:00,449,29,420,17.9741178967318,470,25,445,16.224212326735135,20,1021,0.0,11
2020-07-04 15:00:00+02:00,536,33,503,13.147585514482932,548,28,520,19.206613944955244,20,1021,0.0,11
2020-07-04 16:00:00+02:00,527,33,494,19.476857580866454,551,30,521,17.61916856629276,20,1021,0.0,11
2020-07-04 17:00:00+02:00,587,35,552,17.903545492966053,632,33,599,21.20851016574696,20,1021,0.0,11
2020-07-04 18:00:00+02:00,551,33,518,17.61916856629276,584,32,552,20.69288146543853,20,1021,0.0,11
2020-07-04 19:00:00+02:00,461,26,435,21.59648486572868,473,26,447,14.300214591159298,20,1021,0.0,11
2020-07-04 20:00:00+02:00,410,25,385,17.249472070304,434,26,408,21.64946895511234,20,1021,0.0,11
2020-07-04 21:00:00+02:00,368,21,347,19.848434815045938,392,20,372,22.18304148250548,20,1021,0.0,11
2020-07-04 22:00:00+02:00,293,18,275,17.329297501722674,311,16,295,18.777054340822975,20,1021,0.0,11
2020-07-04 23:00:00+02:00,143,9,134,15.49985590484046,158,9,149,19.40470350916573,20,1021,0.0,11
2020-07-05 00:00:00+02:00,54,2,52,11.483713237443984,59,2,57,11.512224289105106,21,1018,0.0,17
2020-07-05 01:00:00+02:00,34,1,33,4.1719622498891535,44,1,43,9.212556088945261,21,1018,0.0,17
2020-07-05 02:00:00+02:00,34,1,33,4.1719622498891535,44,1,43,9.212556088945261,21,1018,0.0,17
2020-07-05 03:00:00+02:00,52,2,50,14.472017643602554,67,2,65,10.762428640062312,21,1018,0.0,17
2020-07-05 04:00:00+02:00,72,2,70,10.765287360581397,89,3,86,10.527801976587284,21,1018,0.0,17
2020-07-05 05:00:00+02:00,82,3,79,8.6962433625344,99,3,96,10.313624634117142,21,1018,0.0,17
2020-07-05 06:00:00+02:00,142,6,136,19.57947604189084,192,7,185,17.31696395349906,21,1018,0.0,17
2020-07-05 07:00:00+02:00,217,9,208,18.791759657796693,217,7,210,18.791759657796693,21,1018,0.0,17
2020-07-05 08:00:00+02:00,267,10,257,24.84759596655304,357,12,345,16.579219218063535,21,1018,0.0,17
2020-07-05 09:00:00+02:00,312,11,301,17.101813661047903,422,18,404,15.562162592523094,21,1018,0.0,17
2020-07-05 10:00:00+02:00,257,9,248,18.99808160477331,339,13,326,18.9351903306688,21,1018,0.0,17
2020-07-05 11:00:00+02:00,212,9,203,14.709005856097448,269,11,258,22.758175655823944,21,1018,0.0,17
2020-07-05 12:00:00+02:00,212,7,205,14.709005856097448,269,11,258,22.758175655823944,21,1018,0.0,17
2020-07-05 13:00:00+02:00,229,8,221,20.858973540615885,282,11,271,20.995138580232226,21,1018,0.0,17
2020-07-05 14:00:00+02:00,207,7,200,18.76558942906742,282,10,272,20.995138580232226,21,1018,0.0,17
2020-07-05 15:00:00+02:00,239,9,230,18.056937917326703,247,10,237,19.091366395871336,21,1018,0.0,17
2020-07-05 16:00:00+02:00,249,9,240,14.961614479066911,314,10,304,19.77016372636934,21,1018,0.0,17
2020-07-05 17:00:00+02:00,294,12,282,17.632695676481745,312,10,302,17.101813661047903,21,1018,0.0,17
2020-07-05 18:00:00+02:00,274,11,263,20.52791870989968,312,11,301,17.101813661047903,21,1018,0.0,17
2020-07-05 19:00:00+02:00,219,9,210,18.74397758884313,212,8,204,14.709005856097448,21,1018,0.0,17
2020-07-05 20:00:00+02:00,194,8,186,19.241214114048436,249,8,241,14.961614479066911,21,1018,0.0,17
2020-07-05 21:00:00+02:00,177,6,171,13.959346220493531,197,7,190,19.118279085736297,21,1018,0.0,17
2020-07-05 22:00:00+02:00,134,5,129,14.696678321454899,189,7,182,20.00253163985096,21,1018,0.0,17
2020-07-05 23:00:00+02:00,72,3,69,10.765287360581397,89,3,86,10.527801976587284,21,1018,0.0,17
2020-07-06 00:00:00+02:00,67,7,60,12.5039951599288,73,8,65,16.592478063282112,18,1018,0.2,18
2020-07-06 01:00:00+02:00,48,4,44,12.297077384196717,48,4,44,12.297077384196717,18,1018,0.2,18
2020-07-06 02:00:00+02:00,48,4,44,12.297077384196717,48,4,44,12.297077384196717,18,1018,0.2,18
2020-07-06 03:00:00+02:00,73,6,67,16.592478063282112,73,8,65,16.592478063282112,18,1018,0.2,18
2020-07-06 04:00:00+02:00,124,12,112,17.53992981591413,116,13,103,23.67872830820291,18,1018,0.2,18
2020-07-06 05:00:00+02:00,222,21,201,18.77573498601868,210,24,186,16.3212742992447,18,1018,0.2,18
2020-07-06 06:00:00+02:00,265,24,241,24.143057918667047,263,27,236,18.706444640225143,18,1018,0.2,18
2020-07-06 07:00:00+02:00,423,45,378,23.290663678046883,412,51,361,21.450154879298072,18,1018,0.2,18
2020-07-06 08:00:00+02:00,414,40,374,21.211929621647883,446,52,394,22.957333740469338,18,1018,0.2,18
2020-07-06 09:00:00+02:00,280,28,252,25.91177046818179,289,34,255,20.14984129628082,18,1018,0.2,18
2020-07-06 10:00:00+02:00,229,21,208,19.950856030294574,242,24,218,20.990360069331732,18,1018,0.2,18
2020-07-06 11:00:00+02:00,286,28,258,20.398524223626136,295,35,260,20.557446011766526,18,1018,0.2,18
2020-07-06 12:00:00+02:00,233,21,212,20.426009043155588,242,24,218,20.990360069331732,18,1018,0.2,18
2020-07-06 13:00:00+02:00,239,24,215,13.74553452780325,244,30,214,17.108671526861457,18,1018,0.2,18
2020-07-06 14:00:00+02:00,239,24,215,13.74553452780325,244,30,214,17.108671526861457,18,1018,0.2,18
2020-07-06 15:00:00+02:00,261,26,235,21.270868579361668,263,31,232,18.706444640225143,18,1018,0.2,18
2020-07-06 16:00:00+02:00,297,31,266,18.348417493587977,284,27,257,21.60666647068217,18,1018,0.2,18
2020-07-06 17:00:00+02:00,406,36,370,17.471736216533994,419,40,379,22.446709242047174,18,1018,0.2,18
2020-07-06 18:00:00+02:00,436,47,389,21.770703310925605,423,40,383,23.290663678046883,18,1018,0.2,18
2020-07-06 19:00:00+02:00,314,34,280,19.381500590217087,312,30,282,18.640393178431868,18,1018,0.2,18
2020-07-06 20:00:00+02:00,310,29,281,16.921651532922695,312,32,280,18.640393178431868,18,1018,0.2,18
2020-07-06 21:00:00+02:00,239,22,217,13.74553452780325,244,30,214,17.108671526861457,18,1018,0.2,18
2020-07-06 22:00:00+02:00,165,16,149,20.56038540292619,167,20,147,21.39117903937357,18,1018,0.2,18
2020-07-06 23:00:00+02:00,120,11,109,16.69246741071004,122,13,109,20.245567873519157,18,1018,0.2,18
2020-07-07 00:00:00+02:00,347,19,328,21.10654626064635,386,26,360,16.144755675484674,22,1024,0.0,8
2020-07-07 01:00:00+02:00,214,11,203,15.924572551583156,252,14,238,16.53923049831929,22,1024,0.0,8
2020-07-07 02:00:00+02:00,231,11,220,23.040251819935676,238,13,225,17.10199423111376,22,1024,0.0,8
2020-07-07 03:00:00+02:00,358,19,339,17.266463146446004,361,20,341,12.998769947964982,22,1024,0.0,8
2020-07-07 04:00:00+02:00,586,29,557,15.95701591247249,645,40,605,17.15592081049932,22,1024,0.0,8
2020-07-07 05:00:00+02:00,1010,56,954,22.28283154038431,1109,60,1049,19.331354068660346,22,1024,0.0,8
2020-07-07 06:00:00+02:00,1172,64,1108,20.356414887777287,1305,77,1228,26.67454229130446,22,1024,0.0,8
2020-07-07 07:00:00+02:00,1993,114,1879,16.658001010011095,2120,141,1979,20.91048284678424,22,1024,0.0,8
2020-07-07 08:00:00+02:00,1976,115,1861,21.023826889738036,2176,143,2033,20.775247558630568,22,1024,0.0,8
2020-07-07 09:00:00+02:00,1425,73,1352,21.18976615424649,1495,84,1411,21.700452874331596,22,1024,0.0,8
2020-07-07 10:00:00+02:00,1088,59,1029,22.36454575352966,1186,73,1113,19.81643896012672,22,1024,0.0,8
2020-07-07 11:00:00+02:00,1365,78,1287,23.77196991776294,1442,78,1364,22.41868610299076,22,1024,0.0,8
2020-07-07 12:00:00+02:00,1070,59,1011,24.712950845100785,1277,72,1205,22.72581097644772,22,1024,0.0,8
2020-07-07 13:00:00+02:00,1200,71,1129,22.159067323379073,1239,72,1167,19.476229736277922,22,1024,0.0,8
2020-07-07 14:00:00+02:00,1193,61,1132,20.553824525939433,1291,87,1204,24.8760400766849,22,1024,0.0,8
2020-07-07 15:00:00+02:00,1217,67,1150,21.239272027240727,1337,81,1256,22.211564411020564,22,1024,0.0,8
2020-07-07 16:00:00+02:00,1354,78,1276,23.110006283023314,1533,82,1451,23.45988571095097,22,1024,0.0,8
2020-07-07 17:00:00+02:00,1828,93,1735,21.4435952764888,2018,110,1908,17.175205515562748,22,1024,0.0,8
2020-07-07 18:00:00+02:00,2183,129,2054,19.571013231318997,2270,131,2139,21.868919252087508,22,1024,0.0,8
2020-07-07 19:00:00+02:00,1579,86,1493,18.74951710030999,1639,92,1547,22.91647648420566,22,1024,0.0,8
2020-07-07 20:00:00+02:00,1523,74,1449,16.51612150159071,1579,106,1473,18.74951710030999,22,1024,0.0,8
2020-07-07 21:00:00+02:00,1221,63,1158,20.289255545925798,1291,84,1207,24.8760400766849,22,1024,0.0,8
2020-07-07 22:00:00+02:00,772,42,730,23.839034387240726,895,51,844,18.068676456960343,22,1024,0.0,8
2020-07-07 23:00:00+02:00,603,34,569,15.550814969653425,600,37,563,14.259859955891715,22,1024,0.0,8
2020-07-08 00:00:00+02:00,367,25,342,20.047055443111752,331,24,307,18.08059708638437,21,1020,0.0,6
2020-07-08 01:00:00+02:00,244,17,227,17.108671526861457,234,15,219,19.754580108435302,21,1020,0.0,6
2020-07-08 02:00:00+02:00,241,17,224,21.076687701702674,234,15,219,19.754580108435302,21,1020,0.0,6
2020-07-08 03:00:00+02:00,363,26,337,20.037936765942277,352,26,326,20.33829699034963,21,1020,0.0,6
2020-07-08 04:00:00+02:00,615,45,570,21.061338820559666,558,34,524,21.887504875695765,21,1020,0.0,6
2020-07-08 05:00:00+02:00,1094,76,1018,16.473609342864854,1123,79,1044,20.44165932039543,21,1020,0.0,6
2020-07-08 06:00:00+02:00,1335,100,1235,13.975230883109901,1289,88,1201,22.512683907558927,21,1020,0.0,6
2020-07-08 07:00:00+02:00,2120,174,1946,25.399352100964908,1958,139,1819,27.086839720820283,21,1020,0.0,6
2020-07-08 08:00:00+02:00,2214,158,2056,26.935441544952493,1987,139,1848,20.349279031757163,21,1020,0.0,6
2020-07-08 09:00:00+02:00,1472,117,1355,24.031930059108,1350,87,1263,22.846585334327333,21,1020,0.0,6
2020-07-08 10:00:00+02:00,1224,99,1125,23.97644203374751,1123,84,1039,20.44165932039543,21,1020,0.0,6
2020-07-08 11:00:00+02:00,1458,110,1348,14.710429598241719,1433,107,1326,29.277910400984016,21,1020,0.0,6
2020-07-08 12:00:00+02:00,1249,102,1147,24.22980832737812,1145,73,1072,17.297926480759553,21,1020,0.0,6
2020-07-08 13:00:00+02:00,1224,92,1132,23.97644203374751,1123,84,1039,20.44165932039543,21,1020,0.0,6
2020-07-08 14:00:00+02:00,1213,91,1122,18.348727324994908,1130,67,1063,25.613349649848075,21,1020,0.0,6
2020-07-08 15:00:00+02:00,1375,93,1282,21.17314511769654,1343,86,1257,17.35770677744749,21,1020,0.0,6
2020-07-08 16:00:00+02:00,1465,101,1364,23.756986414238742,1447,98,1349,16.469650202286182,21,1020,0.0,6
2020-07-08 17:00:00+02:00,2099,143,1956,22.14979210895739,1966,119,1847,16.353059118062454,21,1020,0.0,6
2020-07-08 18:00:00+02:00,2257,177,2080,13.557016006859248,1987,130,1857,20.349279031757163,21,1020,0.0,6
2020-07-08 19:00:00+02:00,1595,127,1468,20.236092541246173,1523,94,1429,18.128128314284485,21,1020,0.0,6
2020-07-08 20:00:00+02:00,1631,120,1511,25.229762927896562,1494,107,1387,19.11370651682832,21,1020,0.0,6
2020-07-08 21:00:00+02:00,1220,83,1137,21.61107219660081,1123,84,1039,20.44165932039543,21,1020,0.0,6
2020-07-08 22:00:00+02:00,849,64,785,23.73991393289528,856,49,807,22.873350706035236,21,1020,0.0,6
2020-07-08 23:00:00+02:00,604,45,559,19.81092723265477,579,40,539,20.213676817558014,21,1020,0.0,6
2020-07-09 00:00:00+02:00,414,20,394,16.127377995898037,386,32,354,16.144755675484674,25,1019,0.0,6
2020-07-09 01:00:00+02:00,237,11,226,19.639472056784783,261,21,240,17.415614153312035,25,1019,0.0,6
2020-07-09 02:00:00+02:00,265,12,253,21.659352492207965,265,25,240,21.659352492207965,25,1019,0.0,6
2020-07-09 03:00:00+02:00,390,21,369,17.116705354131824,410,30,380,20.181667077415888,25,1019,0.0,6
2020-07-09 04:00:00+02:00,623,28,595,19.813545238499966,667,51,616,18.282919138077595,25,1019,0.0,6
2020-07-09 05:00:00+02:00,1085,50,1035,15.965240708136657,1242,94,1148,19.023373723702164,25,1019,0.0,6
2020-07-09 06:00:00+02:00,1487,77,1410,19.90431454935102,1531,131,1400,18.576384733342593,25,1019,0.0,6
2020-07-09 07:00:00+02:00,2002,90,1912,20.748562841003455,2215,211,2004,26.22886108013433,25,1019,0.0,6
2020-07-09 08:00:00+02:00,2227,107,2120,27.644434226517863,2472,194,2278,19.243653172813197,25,1019,0.0,6
2020-07-09 09:00:00+02:00,1411,71,1340,23.862956521429666,1624,153,1471,20.69487692110375,25,1019,0.0,6
2020-07-09 10:00:00+02:00,1198,65,1133,16.931003304322644,1294,109,1185,23.792766810185167,25,1019,0.0,6
2020-07-09 11:00:00+02:00,1636,81,1555,20.944890404436187,1600,132,1468,17.84709494981123,25,1019,0.0,6
2020-07-09 12:00:00+02:00,1190,56,1134,20.216728355151893,1342,123,1219,22.16874667940653,25,1019,0.0,6
2020-07-09 13:00:00+02:00,1262,65,1197,26.274321185915127,1359,123,1236,22.022972298449307,25,1019,0.0,6
2020-07-09 14:00:00+02:00,1318,64,1254,19.32568094844101,1298,118,1180,21.22257151829723,25,1019,0.0,6
2020-07-09 15:00:00+02:00,1435,70,1365,18.809141646312835,1467,121,1346,19.59112087663365,25,1019,0.0,6
2020-07-09 16:00:00+02:00,1515,77,1438,19.905086767285763,1560,122,1438,20.5208007633018,25,1019,0.0,6
2020-07-09 17:00:00+02:00,2199,106,2093,17.978258665966436,2279,178,2101,23.376410331872865,25,1019,0.0,6
2020-07-09 18:00:00+02:00,2476,133,2343,18.410106620781548,2336,171,2165,25.154158253074996,25,1019,0.0,6
2020-07-09 19:00:00+02:00,1801,81,1720,22.037965906737753,1676,129,1547,20.064745922155097,25,1019,0.0,6
2020-07-09 20:00:00+02:00,1535,70,1465,21.035343936845862,1652,127,1525,20.08199465749911,25,1019,0.0,6
2020-07-09 21:00:00+02:00,1274,67,1207,20.559111744560646,1334,116,1218,21.955746267894583,25,1019,0.0,6
2020-07-09 22:00:00+02:00,912,47,865,18.725325172560677,912,83,829,18.725325172560677,25,1019,0.0,6
2020-07-09 23:00:00+02:00,627,32,595,20.222313255597733,695,62,633,22.550154478681854,25,1019,0.0,6
2020-07-10 00:00:00+02:00,296,16,280,17.712986272610788,293,16,277,16.31782341352916,20,1015,0.0,11
2020-07-10 01:00:00+02:00,200,11,189,18.990759817446737,188,12,176,14.461891157735705,20,1015,0.0,11
2020-07-10 02:00:00+02:00,206,11,195,16.841693952319364,197,13,184,14.378838223751064,20,1015,0.0,11
2020-07-10 03:00:00+02:00,299,18,281,17.916061047290665,287,17,270,15.556707060677866,20,1015,0.0,11
2020-07-10 04:00:00+02:00,496,27,469,17.338309517669067,517,32,485,17.882929892919986,20,1015,0.0,11
2020-07-10 05:00:00+02:00,912,50,862,18.725325172560677,873,55,818,19.610658464903693,20,1015,0.0,11
2020-07-10 06:00:00+02:00,1076,62,1014,18.035647421696137,1070,64,1006,24.712950845100785,20,1015,0.0,11
2020-07-10 07:00:00+02:00,1722,104,1618,23.32689023912994,1731,108,1623,22.061002781929634,20,1015,0.0,11
2020-07-10 08:00:00+02:00,1818,109,1709,22.20057311824074,1743,91,1652,18.72848541656234,20,1015,0.0,11
2020-07-10 09:00:00+02:00,1193,66,1127,20.553824525939433,1238,84,1154,21.59972439582209,20,1015,0.0,11
2020-07-10 10:00:00+02:00,1040,58,982,19.386470270605383,957,50,907,18.89783844765616,20,1015,0.0,11
2020-07-10 11:00:00+02:00,1214,75,1139,17.175141770222666,1130,67,1063,21.5185605860936,20,1015,0.0,11
2020-07-10 12:00:00+02:00,977,60,917,19.606703088087894,1010,68,942,22.28283154038431,20,1015,0.0,11
2020-07-10 13:00:00+02:00,1016,57,959,18.268621485072682,1007,54,953,18.980038691217896,20,1015,0.0,11
2020-07-10 14:00:00+02:00,1037,57,980,22.308402872589316,945,54,891,17.157144994893883,20,1015,0.0,11
2020-07-10 15:00:00+02:00,1085,68,1017,15.965240708136657,1130,60,1070,21.5185605860936,20,1015,0.0,11
2020-07-10 16:00:00+02:00,1175,72,1103,20.47830513173749,1217,62,1155,21.239272027240727,20,1015,0.0,11
2020-07-10 17:00:00+02:00,1707,103,1604,19.566221981961515,1623,85,1538,21.397432374401077,20,1015,0.0,11
2020-07-10 18:00:00+02:00,1839,105,1734,23.883816177813905,1833,103,1730,21.26330822826061,20,1015,0.0,11
2020-07-10 19:00:00+02:00,1318,80,1238,19.32568094844101,1259,80,1179,22.449581143024034,20,1015,0.0,11
2020-07-10 20:00:00+02:00,1318,78,1240,19.32568094844101,1259,80,1179,22.449581143024034,20,1015,0.0,11
2020-07-10 21:00:00+02:00,1013,60,953,18.155753042274473,1028,60,968,22.446317894676316,20,1015,0.0,11
2020-07-10 22:00:00+02:00,708,41,667,21.39118552809281,708,42,666,21.39118552809281,20,1015,0.0,11
2020-07-10 23:00:00+02:00,517,28,489,17.882929892919986,505,28,477,14.746046079018628,20,1015,0.0,11
2020-07-11 00:00:00+02:00,298,11,287,20.492105699574804,301,11,290,18.362525035232956,20,1021,0.0,12
2020-07-11 01:00:00+02:00,194,6,188,19.7210598961507,202,7,195,12.370131654196136,20,1021,0.0,12
2020-07-11 02:00:00+02:00,188,6,182,17.60594907802627,202,6,196,12.370131654196136,20,1021,0.0,12
2020-07-11 03:00:00+02:00,283,9,274,15.118512145389843,307,10,297,21.794901971244688,20,1021,0.0,12
2020-07-11 04:00:00+02:00,388,13,375,21.335919297359776,405,14,391,18.637637389520453,20,1021,0.0,12
2020-07-11 05:00:00+02:00,498,18,480,18.48397287248944,515,19,496,17.142930136512636,20,1021,0.0,12
2020-07-11 06:00:00+02:00,784,27,757,23.154801842450805,808,31,777,21.727224018102078,20,1021,0.0,12
2020-07-11 07:00:00+02:00,1161,46,1115,21.995711241944427,1248,39,1209,18.827416018626465,20,1021,0.0,12
2020-07-11 08:00:00+02:00,1572,58,1514,22.940992075165788,1639,53,1586,22.15528678041632,20,1021,0.0,12
2020-07-11 09:00:00+02:00,1636,55,1581,23.78726105078162,1717,69,1648,19.748777798699674,20,1021,0.0,12
2020-07-11 10:00:00+02:00,1448,55,1393,20.892405359623577,1520,59,1461,16.808120670873752,20,1021,0.0,12
2020-07-11 11:00:00+02:00,1132,38,1094,22.014894626190895,1228,48,1180,16.235092182143056,20,1021,0.0,12
2020-07-11 12:00:00+02:00,1207,42,1165,15.636371938837716,1231,37,1194,22.366703847910575,20,1021,0.0,12
2020-07-11 13:00:00+02:00,1294,45,1249,21.58815720556643,1315,39,1276,20.695106683231426,20,1021,0.0,12
2020-07-11 14:00:00+02:00,1178,41,1137,19.088146413038924,1228,38,1190,16.235092182143056,20,1021,0.0,12
2020-07-11 15:00:00+02:00,1410,49,1361,20.235756030307446,1416,50,1366,24.11645074168776,20,1021,0.0,12
2020-07-11 16:00:00+02:00,1404,47,1357,18.723657065609444,1456,56,1400,25.35882572688604,20,1021,0.0,12
2020-07-11 17:00:00+02:00,1552,54,1498,17.806189211708023,1662,66,1596,19.293174765897604,20,1021,0.0,12
2020-07-11 18:00:00+02:00,1485,58,1427,20.33081779564304,1520,54,1466,16.808120670873752,20,1021,0.0,12
2020-07-11 19:00:00+02:00,1132,38,1094,22.014894626190895,1228,48,1180,16.235092182143056,20,1021,0.0,12
2020-07-11 20:00:00+02:00,1106,39,1067,18.591958908839434,1118,38,1080,22.083758732522256,20,1021,0.0,12
2020-07-11 21:00:00+02:00,996,35,961,17.021106937088867,1010,35,975,12.906652165536082,20,1021,0.0,12
2020-07-11 22:00:00+02:00,776,28,748,17.069481419083928,822,29,793,17.294133752554114,20,1021,0.0,12
2020-07-11 23:00:00+02:00,388,14,374,21.335919297359776,405,14,391,18.637637389520453,20,1021,0.0,12
2020-07-12 00:00:00+02:00,159,3,156,12.4605873158537,199,4,195,15.912981598907018,20,1027,0.0,14
2020-07-12 01:00:00+02:00,105,2,103,12.90034298013122,116,2,114,16.096925814300793,20,1027,0.0,14
2020-07-12 02:00:00+02:00,102,2,100,16.872085686095776,113,2,111,16.395506482914122,20,1027,0.0,14
2020-07-12 03:00:00+02:00,154,4,150,16.66932336881329,199,4,195,15.912981598907018,20,1027,0.0,14
2020-07-12 04:00:00+02:00,213,5,208,16.73811242704621,216,4,212,18.982366806375833,20,1027,0.0,14
2020-07-12 05:00:00+02:00,264,6,258,17.4082584202371,294,7,287,17.108847506387324,20,1027,0.0,14
2020-07-12 06:00:00+02:00,399,9,390,18.821974163707836,570,12,558,21.123025347766156,20,1027,0.0,14
2020-07-12 07:00:00+02:00,602,14,588,22.27358164052891,783,15,768,17.599976365237946,20,1027,0.0,14
2020-07-12 08:00:00+02:00,786,20,766,21.92962351908799,1062,26,1036,21.584150731479806,20,1027,0.0,14
2020-07-12 09:00:00+02:00,929,22,907,15.388703289036863,1091,23,1068,21.90252181648089,20,1027,0.0,14
2020-07-12 10:00:00+02:00,786,18,768,21.92962351908799,997,25,972,16.242020528589048,20,1027,0.0,14
2020-07-12 11:00:00+02:00,599,13,586,19.77443602895921,710,16,694,22.15354781773007,20,1027,0.0,14
2020-07-12 12:00:00+02:00,653,15,638,17.99731889949028,716,16,700,20.75199574616778,20,1027,0.0,14
2020-07-12 13:00:00+02:00,675,16,659,24.122133756141604,913,21,892,19.404867434002146,20,1027,0.0,14
2020-07-12 14:00:00+02:00,594,13,581,17.941579995260316,645,13,632,18.80695192967264,20,1027,0.0,14
2020-07-12 15:00:00+02:00,718,16,702,24.05588713714659,816,20,796,16.925732844250618,20,1027,0.0,14
2020-07-12 16:00:00+02:00,721,16,705,21.502824140299133,772,16,756,23.438286359230418,20,1027,0.0,14
2020-07-12 17:00:00+02:00,840,20,820,23.203569459234682,1099,23,1076,14.563650054783048,20,1027,0.0,14
2020-07-12 18:00:00+02:00,748,19,729,20.052587888002837,1056,27,1029,23.218145984506062,20,1027,0.0,14
2020-07-12 19:00:00+02:00,599,14,585,19.77443602895921,710,16,694,22.15354781773007,20,1027,0.0,14
2020-07-12 20:00:00+02:00,599,14,585,19.77443602895921,651,15,636,20.948542647384652,20,1027,0.0,14
2020-07-12 21:00:00+02:00,491,12,479,21.30893575803906,689,13,676,21.65226431706797,20,1027,0.0,14
2020-07-12 22:00:00+02:00,410,9,401,19.263485804042553,435,9,426,20.183878117421074,20,1027,0.0,14
2020-07-12 23:00:00+02:00,202,4,198,12.370131654196136,208,4,204,15.500466492892206,20,1027,0.0,14
2020-07-13 00:00:00+02:00,310,17,293,21.07594915875671,310,18,292,21.07594915875671,22,1025,0.0,13
2020-07-13 01:00:00+02:00,210,13,197,16.242964247092598,204,13,191,16.808951167115225,22,1025,0.0,13
2020-07-13 02:00:00+02:00,207,13,194,15.748956490487041,210,11,199,16.242964247092598,22,1025,0.0,13
2020-07-13 03:00:00+02:00,298,17,281,18.260459021124706,304,21,283,17.388899925714064,22,1025,0.0,13
2020-07-13 04:00:00+02:00,490,31,459,17.126352456192755,511,33,478,15.883624688197655,22,1025,0.0,13
2020-07-13 05:00:00+02:00,972,53,919,23.461710620190935,945,69,876,17.157144994893883,22,1025,0.0,13
2020-07-13 06:00:00+02:00,1092,68,1024,20.339087343479303,1135,79,1056,18.68517050723528,22,1025,0.0,13
2020-07-13 07:00:00+02:00,1812,105,1707,17.358237080333375,1836,121,1715,23.372460309696933,22,1025,0.0,13
2020-07-13 08:00:00+02:00,1797,107,1690,20.59167885676239,1827,110,1717,19.21493414051392,22,1025,0.0,13
2020-07-13 09:00:00+02:00,1180,66,1114,20.393737689339545,1243,80,1163,21.87806169964562,22,1025,0.0,13
2020-07-13 10:00:00+02:00,1047,65,982,20.567628948038863,1047,70,977,20.567628948038863,22,1025,0.0,13
2020-07-13 11:00:00+02:00,1219,73,1146,23.748683945082753,1219,82,1137,23.748683945082753,22,1025,0.0,13
2020-07-13 12:00:00+02:00,981,59,922,21.628318172900137,1059,79,980,17.243708720097658,22,1025,0.0,13
2020-07-13 13:00:00+02:00,1059,68,991,17.243708720097658,1050,68,982,17.97112861532448,22,1025,0.0,13
2020-07-13 14:00:00+02:00,1062,66,996,22.261915679411075,1029,70,959,17.50858882428106,22,1025,0.0,13
2020-07-13 15:00:00+02:00,1111,67,1044,18.89640564251691,1135,72,1063,18.68517050723528,22,1025,0.0,13
2020-07-13 16:00:00+02:00,1279,74,1205,21.931933870604148,1273,95,1178,17.95778121782124,22,1025,0.0,13
2020-07-13 17:00:00+02:00,1704,106,1598,22.550218824714694,1752,101,1651,22.142796307392917,22,1025,0.0,13
2020-07-13 18:00:00+02:00,1839,101,1738,23.883816177813905,1899,141,1758,20.91384253891215,22,1025,0.0,13
2020-07-13 19:00:00+02:00,1348,76,1272,18.91804497978965,1403,86,1317,18.66658991898567,22,1025,0.0,13
2020-07-13 20:00:00+02:00,1342,85,1257,22.16874667940653,1360,96,1264,18.351496456445616,22,1025,0.0,13
2020-07-13 21:00:00+02:00,996,56,940,21.80745007104885,1047,60,987,20.567628948038863,22,1025,0.0,13
2020-07-13 22:00:00+02:00,710,42,668,21.02370409420371,752,44,708,21.703127064344788,22,1025,0.0,13
2020-07-13 23:00:00+02:00,514,32,482,21.0963529036627,505,32,473,14.746046079018628,22,1025,0.0,13
2020-07-14 00:00:00+02:00,302,17,285,15.388460750733547,302,19,283,15.388460750733547,20,1021,0.0,11
2020-07-14 01:00:00+02:00,182,10,172,14.086496078100373,215,13,202,16.45499867399212,20,1021,0.0,11
2020-07-14 02:00:00+02:00,182,9,173,14.086496078100373,215,13,202,16.45499867399212,20,1021,0.0,11
2020-07-14 03:00:00+02:00,275,14,261,15.101857250184825,305,19,286,17.950849983805522,20,1021,0.0,11
2020-07-14 04:00:00+02:00,458,26,432,16.012859161215747,524,30,494,14.51787935492523,20,1021,0.0,11
2020-07-14 05:00:00+02:00,925,50,875,19.331503308605726,964,62,902,21.54885981421529,20,1021,0.0,11
2020-07-14 06:00:00+02:00,1057,53,1004,11.291374471431947,1156,78,1078,20.135955646809062,20,1021,0.0,11
2020-07-14 07:00:00+02:00,1570,87,1483,21.07349397341393,1815,112,1703,17.294455298499617,20,1021,0.0,11
2020-07-14 08:00:00+02:00,1836,106,1730,23.372460309696933,1848,110,1738,21.657434288489114,20,1021,0.0,11
2020-07-14 09:00:00+02:00,1237,65,1172,22.006377879515043,1237,66,1171,22.006377879515043,20,1021,0.0,11
2020-07-14 10:00:00+02:00,949,48,901,17.097387724780006,1063,70,993,22.181423515075643,20,1021,0.0,11
2020-07-14 11:00:00+02:00,1174,62,1112,24.145898543854848,1321,70,1251,22.621003247214354,20,1021,0.0,11
2020-07-14 12:00:00+02:00,982,56,926,13.387310810863443,1093,62,1031,18.61117378974381,20,1021,0.0,11
2020-07-14 13:00:00+02:00,964,52,912,21.54885981421529,1099,60,1039,15.119487672548313,20,1021,0.0,11
2020-07-14 14:00:00+02:00,949,48,901,17.097387724780006,1063,70,993,22.181423515075643,20,1021,0.0,11
2020-07-14 15:00:00+02:00,1075,57,1018,20.104075718450684,1189,63,1126,19.397661781701373,20,1021,0.0,11
2020-07-14 16:00:00+02:00,1231,70,1161,18.2141069510702,1330,80,1250,23.98683426810495,20,1021,0.0,11
2020-07-14 17:00:00+02:00,1591,80,1511,21.797889307514822,1800,119,1681,18.70378284776037,20,1021,0.0,11
2020-07-14 18:00:00+02:00,1836,107,1729,23.372460309696933,1848,110,1738,21.657434288489114,20,1021,0.0,11
2020-07-14 19:00:00+02:00,1342,70,1272,22.16874667940653,1354,86,1268,23.110006283023314,20,1021,0.0,11
2020-07-14 20:00:00+02:00,1237,69,1168,22.006377879515043,1339,72,1267,20.57829585835178,20,1021,0.0,11
2020-07-14 21:00:00+02:00,961,55,906,18.33675311368413,1024,63,961,19.558156371320653,20,1021,0.0,11
2020-07-14 22:00:00+02:00,695,35,660,22.550154478681854,713,39,674,21.194268455583238,20,1021,0.0,11
2020-07-14 23:00:00+02:00,521,28,493,17.378202058765993,539,30,509,15.29145500036743,20,1021,0.0,11
2020-07-15 00:00:00+02:00,102,6,96,13.093305626972347,103,6,97,12.113442962320551,19,1016,2.6,10
2020-07-15 01:00:00+02:00,69,5,64,19.29595730158091,62,4,58,14.48690450543278,19,1016,2.6,10
2020-07-15 02:00:00+02:00,67,4,63,12.5039951599288,69,5,64,19.29595730158091,19,1016,2.6,10
2020-07-15 03:00:00+02:00,102,7,95,13.093305626972347,103,6,97,12.113442962320551,19,1016,2.6,10
2020-07-15 04:00:00+02:00,173,13,160,20.37647841384157,168,12,156,20.304807772345505,19,1016,2.6,10
2020-07-15 05:00:00+02:00,310,22,288,16.921651532922695,297,18,279,18.348417493587977,19,1016,2.6,10
2020-07-15 06:00:00+02:00,374,25,349,18.17629135420491,363,22,341,20.037936765942277,19,1016,2.6,10
2020-07-15 07:00:00+02:00,583,47,536,17.990582160320795,580,39,541,24.24750544028644,19,1016,2.6,10
2020-07-15 08:00:00+02:00,617,48,569,19.739247366719148,561,34,527,19.266161028294455,19,1016,2.6,10
2020-07-15 09:00:00+02:00,411,29,382,21.89950881174465,378,28,350,19.765573549462566,19,1016,2.6,10
2020-07-15 10:00:00+02:00,345,24,321,18.48984602659702,339,25,314,21.378284288972047,19,1016,2.6,10
2020-07-15 11:00:00+02:00,416,28,388,17.117872401421668,372,24,348,17.388398109436665,19,1016,2.6,10
2020-07-15 12:00:00+02:00,344,24,320,17.416933285982235,339,25,314,21.378284288972047,19,1016,2.6,10
2020-07-15 13:00:00+02:00,347,23,324,19.399384547744187,337,22,315,21.494538760895587,19,1016,2.6,10
2020-07-15 14:00:00+02:00,342,25,317,17.147818156889407,305,22,283,19.342371998402466,19,1016,2.6,10
2020-07-15 15:00:00+02:00,375,26,349,22.64494297948435,363,22,341,20.037936765942277,19,1016,2.6,10
2020-07-15 16:00:00+02:00,411,33,378,21.89950881174465,378,28,350,19.765573549462566,19,1016,2.6,10
2020-07-15 17:00:00+02:00,587,41,546,20.028899672241884,580,39,541,24.24750544028644,19,1016,2.6,10
2020-07-15 18:00:00+02:00,617,48,569,19.739247366719148,561,34,527,19.266161028294455,19,1016,2.6,10
2020-07-15 19:00:00+02:00,446,32,414,22.957333740469338,413,27,386,24.398754434847095,19,1016,2.6,10
2020-07-15 20:00:00+02:00,440,32,408,19.57754243382943,422,30,392,20.257299015157166,19,1016,2.6,10
2020-07-15 21:00:00+02:00,341,27,314,14.480776847696712,342,19,323,17.147818156889407,19,1016,2.6,10
2020-07-15 22:00:00+02:00,236,18,218,19.106111918840778,235,17,218,20.674840106170866,19,1016,2.6,10
2020-07-15 23:00:00+02:00,172,13,159,19.644113972447897,166,12,154,18.57114730689396,19,1016,2.6,10
2020-07-16 00:00:00+02:00,315,16,299,16.570611602173244,296,23,273,17.712986272610788,19,1019,0.0,9
2020-07-16 01:00:00+02:00,194,9,185,16.34874002060651,213,16,197,14.733316442006998,19,1019,0.0,9
2020-07-16 02:00:00+02:00,200,9,191,18.990759817446737,194,18,176,16.34874002060651,19,1019,0.0,9
2020-07-16 03:00:00+02:00,281,14,267,13.335471171698996,308,26,282,16.757978343930233,19,1019,0.0,9
2020-07-16 04:00:00+02:00,522,27,495,15.738301696479466,515,39,476,19.944746258569634,19,1019,0.0,9
2020-07-16 05:00:00+02:00,895,48,847,18.068676456960343,929,86,843,13.885339320671468,19,1019,0.0,9
2020-07-16 06:00:00+02:00,1109,57,1052,19.331354068660346,1155,112,1043,20.115592320265414,19,1019,0.0,9
2020-07-16 07:00:00+02:00,1689,80,1609,23.63203586852005,1822,141,1681,21.99997707726524,19,1019,0.0,9
2020-07-16 08:00:00+02:00,1717,87,1630,22.778236703814812,1850,179,1671,19.74889576793901,19,1019,0.0,9
2020-07-16 09:00:00+02:00,1161,62,1099,22.76349118424605,1173,104,1069,17.312671623656808,19,1019,0.0,9
2020-07-16 10:00:00+02:00,908,45,863,19.950580213872602,1028,83,945,22.446317894676316,19,1019,0.0,9
2020-07-16 11:00:00+02:00,1180,58,1122,20.393737689339545,1192,99,1093,22.92103550829049,19,1019,0.0,9
2020-07-16 12:00:00+02:00,1031,53,978,23.10228465320526,1028,83,945,22.446317894676316,19,1019,0.0,9
2020-07-16 13:00:00+02:00,982,48,934,13.387310810863443,1059,86,973,17.243708720097658,19,1019,0.0,9
2020-07-16 14:00:00+02:00,1062,57,1005,22.261915679411075,988,87,901,20.538322750287296,19,1019,0.0,9
2020-07-16 15:00:00+02:00,1068,48,1020,20.025043104554733,1146,97,1049,22.47510936508871,19,1019,0.0,9
2020-07-16 16:00:00+02:00,1195,64,1131,20.567834340685646,1195,100,1095,20.567834340685646,19,1019,0.0,9
2020-07-16 17:00:00+02:00,1621,79,1542,16.461861685000905,1810,163,1647,22.213167934394413,19,1019,0.0,9
2020-07-16 18:00:00+02:00,1899,95,1804,20.91384253891215,1853,146,1707,17.4461550861798,19,1019,0.0,9
2020-07-16 19:00:00+02:00,1177,56,1121,23.818447638075348,1328,118,1210,24.175628663883305,19,1019,0.0,9
2020-07-16 20:00:00+02:00,1390,73,1317,19.910559975296454,1275,104,1171,21.474560179522392,19,1019,0.0,9
2020-07-16 21:00:00+02:00,1004,53,951,16.68540068085009,1041,98,943,19.265740720120768,19,1019,0.0,9
2020-07-16 22:00:00+02:00,695,33,662,22.550154478681854,688,54,634,23.77030631492574,19,1019,0.0,9
2020-07-16 23:00:00+02:00,454,21,433,17.366685623737915,494,36,458,17.61759352479403,19,1019,0.0,9
2020-07-17 00:00:00+02:00,343,20,323,17.146295462927593,350,23,327,18.120899273422324,21,1021,0.0,7
2020-07-17 01:00:00+02:00,231,13,218,23.040251819935676,220,12,208,19.525285937159467,21,1021,0.0,7
2020-07-17 02:00:00+02:00,231,14,217,23.040251819935676,220,12,208,19.525285937159467,21,1021,0.0,7
2020-07-17 03:00:00+02:00,350,21,329,18.120899273422324,336,20,316,15.958874822620459,21,1021,0.0,7
2020-07-17 04:00:00+02:00,602,39,563,14.48243267179175,577,37,540,15.736297898697767,21,1021,0.0,7
2020-07-17 05:00:00+02:00,1047,64,983,20.567628948038863,1026,62,964,17.167716199051373,21,1021,0.0,7
2020-07-17 06:00:00+02:00,1306,80,1226,20.97061610451069,1239,68,1171,19.476229736277922,21,1021,0.0,7
2020-07-17 07:00:00+02:00,2048,116,1932,21.18252561311289,2052,118,1934,18.603137946285425,21,1021,0.0,7
2020-07-17 08:00:00+02:00,2150,131,2019,21.629665933277437,2192,125,2067,18.508528501869467,21,1021,0.0,7
2020-07-17 09:00:00+02:00,1383,74,1309,23.429034579740062,1456,94,1362,20.28539988939373,21,1021,0.0,7
2020-07-17 10:00:00+02:00,1208,70,1138,20.536356751139678,1117,76,1041,19.439459562898037,21,1021,0.0,7
2020-07-17 11:00:00+02:00,1386,82,1304,21.825882781968403,1460,100,1360,20.359054944699004,21,1021,0.0,7
2020-07-17 12:00:00+02:00,1141,74,1067,19.44825045711918,1173,77,1096,17.312671623656808,21,1021,0.0,7
2020-07-17 13:00:00+02:00,1145,68,1077,17.95979940677764,1148,67,1081,20.567706312454405,21,1021,0.0,7
2020-07-17 14:00:00+02:00,1187,70,1117,20.411660977176673,1173,67,1106,17.312671623656808,21,1021,0.0,7
2020-07-17 15:00:00+02:00,1257,75,1182,22.508900202748666,1250,81,1169,17.894818489236755,21,1021,0.0,7
2020-07-17 16:00:00+02:00,1383,78,1305,23.429034579740062,1456,94,1362,20.28539988939373,21,1021,0.0,7
2020-07-17 17:00:00+02:00,2052,119,1933,18.603137946285425,1961,121,1840,20.256610217198645,21,1021,0.0,7
2020-07-17 18:00:00+02:00,2174,127,2047,21.89206502744633,2101,110,1991,21.09498768509034,21,1021,0.0,7
2020-07-17 19:00:00+02:00,1502,83,1419,21.068505145990816,1533,81,1452,23.45988571095097,21,1021,0.0,7
2020-07-17 20:00:00+02:00,1488,83,1405,17.64655247576578,1575,94,1481,17.847591088117024,21,1021,0.0,7
2020-07-17 21:00:00+02:00,1218,70,1148,19.134388365817088,1180,74,1106,20.393737689339545,21,1021,0.0,7
2020-07-17 22:00:00+02:00,815,47,768,19.630699001495458,819,52,767,26.026888211200276,21,1021,0.0,7
2020-07-17 23:00:00+02:00,588,34,554,17.168643017717805,588,39,549,17.168643017717805,21,1021,0.0,7
2020-07-18 00:00:00+02:00,397,16,381,18.899886787636014,408,16,392,18.77391768790148,24,1021,0.1,6
2020-07-18 01:00:00+02:00,251,9,242,17.648672578539976,271,10,261,18.08566039699105,24,1021,0.1,6
2020-07-18 02:00:00+02:00,248,9,239,16.778260223297178,271,10,261,18.08566039699105,24,1021,0.1,6
2020-07-18 03:00:00+02:00,374,14,360,20.00094508774412,404,13,391,20.000883581345207,24,1021,0.1,6
2020-07-18 04:00:00+02:00,511,17,494,14.185645159910662,542,21,521,19.12028226708546,24,1021,0.1,6
2020-07-18 05:00:00+02:00,641,23,618,18.26387895250176,683,23,660,22.576899920700036,24,1021,0.1,6
2020-07-18 06:00:00+02:00,1053,35,1018,20.481857133613264,1072,39,1033,21.773036645568293,24,1021,0.1,6
2020-07-18 07:00:00+02:00,1584,54,1530,21.082220808655002,1611,54,1557,21.637686695811205,24,1021,0.1,6
2020-07-18 08:00:00+02:00,2038,80,1958,19.56756735750654,2164,85,2079,23.566858899326597,24,1021,0.1,6
2020-07-18 09:00:00+02:00,2252,77,2175,18.858933620120098,2290,87,2203,21.604691592604684,24,1021,0.1,6
2020-07-18 10:00:00+02:00,1870,69,1801,21.419237602447108,2023,61,1962,16.31981101531936,24,1021,0.1,6
2020-07-18 11:00:00+02:00,1553,62,1491,19.922186954933533,1645,64,1581,19.677791437300968,24,1021,0.1,6
2020-07-18 12:00:00+02:00,1549,61,1488,19.237866481839514,1637,63,1574,20.97661513694164,24,1021,0.1,6
2020-07-18 13:00:00+02:00,1695,57,1638,26.136623031347078,1736,60,1676,22.882525078948397,24,1021,0.1,6
2020-07-18 14:00:00+02:00,1523,53,1470,18.81977002011241,1599,50,1549,19.747754799667213,24,1021,0.1,6
2020-07-18 15:00:00+02:00,1771,70,1701,14.68870539008775,1920,70,1850,18.994238827712138,24,1021,0.1,6
2020-07-18 16:00:00+02:00,1817,63,1754,16.174692815961542,1862,60,1802,18.78576165719149,24,1021,0.1,6
2020-07-18 17:00:00+02:00,2053,69,1984,23.61747941564339,2137,82,2055,21.889943212847857,24,1021,0.1,6
2020-07-18 18:00:00+02:00,1866,63,1803,21.7481102102821,2019,69,1950,17.35195175651945,24,1021,0.1,6
2020-07-18 19:00:00+02:00,1553,58,1495,19.922186954933533,1645,64,1581,19.677791437300968,24,1021,0.1,6
2020-07-18 20:00:00+02:00,1420,56,1364,23.53071079859258,1488,45,1443,19.290190702204615,24,1021,0.1,6
2020-07-18 21:00:00+02:00,1255,47,1208,22.334656199702454,1351,50,1301,18.846468637426604,24,1021,0.1,6
2020-07-18 22:00:00+02:00,1061,37,1024,20.568345759301252,1099,38,1061,14.563650054783048,24,1021,0.1,6
2020-07-18 23:00:00+02:00,503,20,483,14.977719066049488,538,20,518,19.95573886895121,24,1021,0.1,6
2020-07-19 00:00:00+02:00,214,4,210,17.85177396544463,241,4,237,19.22571527977998,26,1019,0.0,9
2020-07-19 01:00:00+02:00,153,3,150,15.924797186195313,168,4,164,15.841993625402548,26,1019,0.0,9
2020-07-19 02:00:00+02:00,153,3,150,15.924797186195313,168,4,164,15.841993625402548,26,1019,0.0,9
2020-07-19 03:00:00+02:00,229,5,224,16.73127952934685,244,6,238,17.342351354429947,26,1019,0.0,9
2020-07-19 04:00:00+02:00,306,7,299,21.27863543526117,348,8,340,17.23030902909826,26,1019,0.0,9
2020-07-19 05:00:00+02:00,348,9,339,17.23030902909826,371,9,362,20.424262678233227,26,1019,0.0,9
2020-07-19 06:00:00+02:00,577,15,562,20.34897262323771,646,13,633,21.64713407350609,26,1019,0.0,9
2020-07-19 07:00:00+02:00,872,19,853,23.825998140988762,1228,30,1198,16.235092182143056,26,1019,0.0,9
2020-07-19 08:00:00+02:00,1235,27,1208,19.560384603945064,1584,31,1553,21.082220808655002,26,1019,0.0,9
2020-07-19 09:00:00+02:00,1209,28,1181,19.688236882271987,1251,28,1223,23.99794069214974,26,1019,0.0,9
2020-07-19 10:00:00+02:00,1090,27,1063,19.099248716676332,1511,37,1474,18.211844769456263,26,1019,0.0,9
2020-07-19 11:00:00+02:00,864,19,845,21.10382654819081,1098,21,1077,17.923935265195755,26,1019,0.0,9
2020-07-19 12:00:00+02:00,826,19,807,14.161030527798657,1067,21,1046,17.958034646793397,26,1019,0.0,9
2020-07-19 13:00:00+02:00,902,22,880,16.98120612871573,1132,24,1108,22.014894626190895,26,1019,0.0,9
2020-07-19 14:00:00+02:00,872,22,850,23.825998140988762,1228,30,1198,16.235092182143056,26,1019,0.0,9
2020-07-19 15:00:00+02:00,1078,24,1054,17.46915929472312,1335,31,1304,20.195786312558386,26,1019,0.0,9
2020-07-19 16:00:00+02:00,990,25,965,23.289171160834865,1408,28,1380,20.38766721883506,26,1019,0.0,9
2020-07-19 17:00:00+02:00,1201,27,1174,20.696652060812927,1377,34,1343,17.403144467446193,26,1019,0.0,9
2020-07-19 18:00:00+02:00,1048,24,1024,19.57551925751125,1151,25,1126,22.485107940190495,26,1019,0.0,9
2020-07-19 19:00:00+02:00,834,20,814,26.288553047000292,1166,25,1141,19.288698689420873,26,1019,0.0,9
2020-07-19 20:00:00+02:00,761,18,743,22.757407199923254,1082,23,1059,19.33722732071081,26,1019,0.0,9
2020-07-19 21:00:00+02:00,692,17,675,21.751525000033375,830,20,810,23.681986709353712,26,1019,0.0,9
2020-07-19 22:00:00+02:00,554,12,542,16.0644128951775,803,19,784,20.273058429920354,26,1019,0.0,9
2020-07-19 23:00:00+02:00,290,6,284,18.746354489628775,409,8,401,15.464491050485762,26,1019,0.0,9
2020-07-20 00:00:00+02:00,296,17,279,17.712986272610788,314,19,295,16.3416576903422,21,1017,0.0,12
2020-07-20 01:00:00+02:00,212,11,201,18.34660431423262,203,14,189,14.15515549868705,21,1017,0.0,12
2020-07-20 02:00:00+02:00,197,11,186,14.378838223751064,206,14,192,16.841693952319364,21,1017,0.0,12
2020-07-20 03:00:00+02:00,308,19,289,16.757978343930233,308,18,290,16.757978343930233,21,1017,0.0,12
2020-07-20 04:00:00+02:00,521,33,488,17.378202058765993,524,31,493,14.51787935492523,21,1017,0.0,12
2020-07-20 05:00:00+02:00,932,56,876,19.003262654741658,914,61,853,21.466160200765025,21,1017,0.0,12
2020-07-20 06:00:00+02:00,1142,64,1078,21.49780200272057,1145,86,1059,17.95979940677764,21,1017,0.0,12
2020-07-20 07:00:00+02:00,1729,102,1627,25.671264635036508,1783,133,1650,22.618876095609274,21,1017,0.0,12
2020-07-20 08:00:00+02:00,1807,98,1709,20.611581846375724,1918,141,1777,19.931363289245006,21,1017,0.0,12
2020-07-20 09:00:00+02:00,1181,70,1111,16.41109994350771,1265,96,1169,17.508583765189222,21,1017,0.0,12
2020-07-20 10:00:00+02:00,1067,68,999,21.0880359747088,1064,71,993,18.91635548375545,21,1017,0.0,12
2020-07-20 11:00:00+02:00,1265,82,1183,17.508583765189222,1262,90,1172,26.274321185915127,21,1017,0.0,12
2020-07-20 12:00:00+02:00,1049,65,984,19.831613475093246,1040,60,980,19.386470270605383,21,1017,0.0,12
2020-07-20 13:00:00+02:00,995,55,940,19.507404415870408,1067,66,1001,21.0880359747088,21,1017,0.0,12
2020-07-20 14:00:00+02:00,1049,61,988,19.831613475093246,1040,60,980,19.386470270605383,21,1017,0.0,12
2020-07-20 15:00:00+02:00,1094,60,1034,20.011129216891092,1130,79,1051,21.5185605860936,21,1017,0.0,12
2020-07-20 16:00:00+02:00,1178,72,1106,21.916335969631398,1217,80,1137,21.239272027240727,21,1017,0.0,12
2020-07-20 17:00:00+02:00,1711,103,1608,23.78846361744334,1816,130,1686,24.440955376995156,21,1017,0.0,12
2020-07-20 18:00:00+02:00,1771,112,1659,18.027913608098327,1936,133,1803,22.01576773313643,21,1017,0.0,12
2020-07-20 19:00:00+02:00,1322,75,1247,18.99625847930313,1331,91,1240,22.989342805472152,21,1017,0.0,12
2020-07-20 20:00:00+02:00,1376,87,1289,25.41155746862012,1400,89,1311,16.346339097752868,21,1017,0.0,12
2020-07-20 21:00:00+02:00,1049,61,988,19.831613475093246,1040,60,980,19.386470270605383,21,1017,0.0,12
2020-07-20 22:00:00+02:00,695,38,657,22.550154478681854,713,43,670,21.194268455583238,21,1017,0.0,12
2020-07-20 23:00:00+02:00,533,34,499,18.186873348292107,530,36,494,18.581852334839628,21,1017,0.0,12
2020-07-21 00:00:00+02:00,232,12,220,16.947746563903323,262,16,246,15.758252944344887,21,1023,0.0,17
2020-07-21 01:00:00+02:00,165,9,156,14.577535715178616,182,11,171,14.086496078100373,21,1023,0.0,17
2020-07-21 02:00:00+02:00,172,8,164,17.29590397289294,170,9,161,17.360183949342197,21,1023,0.0,17
2020-07-21 03:00:00+02:00,242,12,230,20.177962707598695,255,14,241,13.121454987381162,21,1023,0.0,17
2020-07-21 04:00:00+02:00,405,21,384,22.019042003290508,440,29,411,17.06680304775143,21,1023,0.0,17
2020-07-21 05:00:00+02:00,756,38,718,22.725123824053686,813,53,760,19.274944408821757,21,1023,0.0,17
2020-07-21 06:00:00+02:00,936,50,886,18.90266812520222,993,54,939,18.821564537278963,21,1023,0.0,17
2020-07-21 07:00:00+02:00,1389,69,1320,21.569721327654584,1577,108,1469,23.419545465764962,21,1023,0.0,17
2020-07-21 08:00:00+02:00,1519,84,1435,17.075896030241843,1659,95,1564,20.949820077995867,21,1023,0.0,17
2020-07-21 09:00:00+02:00,978,52,926,18.67599001512184,1096,62,1034,17.373128454029146,21,1023,0.0,17
2020-07-21 10:00:00+02:00,831,44,787,17.811779303498707,926,53,873,16.510828796358968,21,1023,0.0,17
2020-07-21 11:00:00+02:00,918,46,872,17.064437777994613,1041,66,975,19.265740720120768,21,1023,0.0,17
2020-07-21 12:00:00+02:00,831,43,788,17.811779303498707,926,53,873,16.510828796358968,21,1023,0.0,17
2020-07-21 13:00:00+02:00,763,38,725,19.5009781438825,858,44,814,20.31135900139536,21,1023,0.0,17
2020-07-21 14:00:00+02:00,846,47,799,20.133840773131507,926,56,870,16.510828796358968,21,1023,0.0,17
2020-07-21 15:00:00+02:00,841,42,799,20.323854825954786,1016,57,959,18.268621485072682,21,1023,0.0,17
2020-07-21 16:00:00+02:00,948,47,901,18.88060392335512,1104,73,1031,20.516157019658902,21,1023,0.0,17
2020-07-21 17:00:00+02:00,1429,83,1346,18.415264175687295,1484,77,1407,23.712632715847217,21,1023,0.0,17
2020-07-21 18:00:00+02:00,1469,78,1391,25.909930145460613,1569,97,1472,16.674161259411306,21,1023,0.0,17
2020-07-21 19:00:00+02:00,1126,65,1061,23.51378294074205,1104,58,1046,20.516157019658902,21,1023,0.0,17
2020-07-21 20:00:00+02:00,1094,63,1031,20.011129216891092,1116,70,1046,16.293044690950076,21,1023,0.0,17
2020-07-21 21:00:00+02:00,788,41,747,21.09491205845541,856,46,810,21.420291050373567,21,1023,0.0,17
2020-07-21 22:00:00+02:00,593,33,560,19.306228131941428,593,35,558,19.306228131941428,21,1023,0.0,17
2020-07-21 23:00:00+02:00,383,20,363,16.374944526750998,423,25,398,16.203516397748324,21,1023,0.0,17
2020-07-22 00:00:00+02:00,273,22,251,23.61851837889036,275,16,259,24.67224255888931,21,1024,0.0,15
2020-07-22 01:00:00+02:00,186,15,171,22.772295906033783,164,9,155,22.827361263214527,21,1024,0.0,15
2020-07-22 02:00:00+02:00,183,13,170,16.4856647978058,167,9,158,21.39117903937357,21,1024,0.0,15
2020-07-22 03:00:00+02:00,278,20,258,17.988889489265482,259,16,243,22.988395045636892,21,1024,0.0,15
2020-07-22 04:00:00+02:00,457,32,425,24.393218626777333,454,27,427,21.947231747967304,21,1024,0.0,15
2020-07-22 05:00:00+02:00,835,66,769,20.372323083489245,792,51,741,24.002822951179763,21,1024,0.0,15
2020-07-22 06:00:00+02:00,1033,78,955,23.683715762651595,981,67,914,18.82177212426144,21,1024,0.0,15
2020-07-22 07:00:00+02:00,1571,124,1447,17.40989567746171,1595,116,1479,20.236092541246173,21,1024,0.0,15
2020-07-22 08:00:00+02:00,1668,118,1550,20.478353163620643,1598,116,1482,26.724520802850307,21,1024,0.0,15
2020-07-22 09:00:00+02:00,1108,83,1025,18.527702459693625,1076,68,1008,16.922134255211034,21,1024,0.0,15
2020-07-22 10:00:00+02:00,941,70,871,14.09335980286241,911,63,848,22.33450443745382,21,1024,0.0,15
2020-07-22 11:00:00+02:00,1114,91,1023,22.01023498641022,1027,61,966,20.34199108005984,21,1024,0.0,15
2020-07-22 12:00:00+02:00,922,72,850,20.207847827712897,884,57,827,23.001507776389584,21,1024,0.0,15
2020-07-22 13:00:00+02:00,914,66,848,23.408863617509148,887,67,820,23.901301197804095,21,1024,0.0,15
2020-07-22 14:00:00+02:00,914,66,848,23.408863617509148,887,67,820,23.901301197804095,21,1024,0.0,15
2020-07-22 15:00:00+02:00,1006,73,933,23.468796006407466,970,56,914,14.492847442502034,21,1024,0.0,15
2020-07-22 16:00:00+02:00,1122,77,1045,23.398248929149734,987,66,921,17.729507247457875,21,1024,0.0,15
2020-07-22 17:00:00+02:00,1579,127,1452,24.005962427689305,1593,117,1476,24.789564256348125,21,1024,0.0,15
2020-07-22 18:00:00+02:00,1682,128,1554,23.190804916806506,1574,90,1484,16.015226422965746,21,1024,0.0,15
2020-07-22 19:00:00+02:00,1222,98,1124,17.48882951627376,1098,83,1015,16.46700368502056,21,1024,0.0,15
2020-07-22 20:00:00+02:00,1211,91,1120,26.420821746988196,1125,73,1052,22.975956229894695,21,1024,0.0,15
2020-07-22 21:00:00+02:00,919,67,852,23.683478011893353,879,66,813,21.53394312884008,21,1024,0.0,15
2020-07-22 22:00:00+02:00,643,45,598,17.945088215014433,597,43,554,20.96302352029361,21,1024,0.0,15
2020-07-22 23:00:00+02:00,465,31,434,19.650501243200726,424,24,400,20.771564063368263,21,1024,0.0,15
2020-07-23 00:00:00+02:00,324,15,309,16.73552361007021,334,28,306,16.121444874138597,22,1021,0.0,10
2020-07-23 01:00:00+02:00,198,9,189,16.988362462756626,218,16,202,13.323205766743897,22,1021,0.0,10
2020-07-23 02:00:00+02:00,198,9,189,16.988362462756626,218,16,202,13.323205766743897,22,1021,0.0,10
2020-07-23 03:00:00+02:00,297,14,283,17.9875078215099,324,26,298,16.73552361007021,22,1021,0.0,10
2020-07-23 04:00:00+02:00,558,27,531,18.43101556266621,568,44,524,14.65062644971224,22,1021,0.0,10
2020-07-23 05:00:00+02:00,978,53,925,18.67599001512184,1018,83,935,19.479822825157633,22,1021,0.0,10
2020-07-23 06:00:00+02:00,1203,60,1143,16.49493266222382,1160,112,1048,22.97410060244509,22,1021,0.0,10
2020-07-23 07:00:00+02:00,1670,85,1585,20.582850589915612,1785,140,1645,19.268069150915995,22,1021,0.0,10
2020-07-23 08:00:00+02:00,1845,84,1761,17.84948060448887,2017,151,1866,19.531379655049584,22,1021,0.0,10
2020-07-23 09:00:00+02:00,1342,62,1280,22.16874667940653,1289,117,1172,22.340352274507865,22,1021,0.0,10
2020-07-23 10:00:00+02:00,1021,51,970,17.83509098527524,1084,96,988,21.889040166411583,22,1021,0.0,10
2020-07-23 11:00:00+02:00,1329,68,1261,20.765374658474087,1355,127,1228,25.95260838365675,22,1021,0.0,10
2020-07-23 12:00:00+02:00,1107,52,1055,20.03519817978281,1134,102,1032,21.351439587471354,22,1021,0.0,10
2020-07-23 13:00:00+02:00,1150,55,1095,22.011567845215648,1084,90,994,21.889040166411583,22,1021,0.0,10
2020-07-23 14:00:00+02:00,1107,57,1050,20.03519817978281,1134,102,1032,21.351439587471354,22,1021,0.0,10
2020-07-23 15:00:00+02:00,1266,61,1205,22.463287725960775,1207,93,1114,16.1705529971928,22,1021,0.0,10
2020-07-23 16:00:00+02:00,1256,68,1188,18.175892866846603,1329,98,1231,20.765374658474087,22,1021,0.0,10
2020-07-23 17:00:00+02:00,1944,103,1841,21.298022026652927,1911,180,1731,22.732789846752315,22,1021,0.0,10
2020-07-23 18:00:00+02:00,1828,92,1736,21.4435952764888,1878,147,1731,21.134346687332272,22,1021,0.0,10
2020-07-23 19:00:00+02:00,1345,61,1284,17.670555033748876,1375,128,1247,21.992439773971398,22,1021,0.0,10
2020-07-23 20:00:00+02:00,1319,67,1252,21.469992339133157,1461,110,1351,15.85419815283708,22,1021,0.0,10
2020-07-23 21:00:00+02:00,1107,54,1053,20.03519817978281,1134,102,1032,21.351439587471354,22,1021,0.0,10
2020-07-23 22:00:00+02:00,803,38,765,12.897437744361985,796,74,722,18.991561019459866,22,1021,0.0,10
2020-07-23 23:00:00+02:00,505,25,480,14.746046079018628,548,50,498,19.262129324029786,22,1021,0.0,10
2020-07-24 00:00:00+02:00,320,18,302,16.959865599813572,304,19,285,17.388899925714064,22,1017,0.0,11
2020-07-24 01:00:00+02:00,208,13,195,15.634218349387046,208,10,198,15.634218349387046,22,1017,0.0,11
2020-07-24 02:00:00+02:00,214,11,203,15.924572551583156,217,12,205,17.475217936101426,22,1017,0.0,11
2020-07-24 03:00:00+02:00,329,18,311,19.42296356680245,317,20,297,18.35612552883901,22,1017,0.0,11
2020-07-24 04:00:00+02:00,531,30,501,16.059679334719053,512,32,480,19.546255214981013,22,1017,0.0,11
2020-07-24 05:00:00+02:00,960,60,900,18.584415217545775,919,56,863,17.207036923878345,22,1017,0.0,11
2020-07-24 06:00:00+02:00,1181,74,1107,16.41109994350771,1159,79,1080,18.72188189628211,22,1017,0.0,11
2020-07-24 07:00:00+02:00,1787,109,1678,22.30439468949765,1790,109,1681,20.399079424827594,22,1017,0.0,11
2020-07-24 08:00:00+02:00,1960,119,1841,19.411568064396825,1838,111,1727,20.064715605185974,22,1017,0.0,11
2020-07-24 09:00:00+02:00,1303,84,1219,20.542382300053553,1274,73,1201,20.559111744560646,22,1017,0.0,11
2020-07-24 10:00:00+02:00,1101,66,1035,19.10414161222843,1025,70,955,19.210778752540463,22,1017,0.0,11
2020-07-24 11:00:00+02:00,1303,80,1223,20.542382300053553,1274,73,1201,20.559111744560646,22,1017,0.0,11
2020-07-24 12:00:00+02:00,1101,66,1035,19.10414161222843,1025,70,955,19.210778752540463,22,1017,0.0,11
2020-07-24 13:00:00+02:00,1085,66,1019,15.965240708136657,1101,58,1043,19.10414161222843,22,1017,0.0,11
2020-07-24 14:00:00+02:00,1060,69,991,20.585731765578405,1057,71,986,11.291374471431947,22,1017,0.0,11
2020-07-24 15:00:00+02:00,1194,78,1116,19.735405768215895,1137,66,1071,21.89924857528811,22,1017,0.0,11
2020-07-24 16:00:00+02:00,1310,83,1227,18.96116747760953,1268,81,1187,22.55194486065332,22,1017,0.0,11
2020-07-24 17:00:00+02:00,1848,116,1732,21.657434288489114,1825,104,1721,17.452886252224268,22,1017,0.0,11
2020-07-24 18:00:00+02:00,1966,109,1857,20.86855136076598,1925,115,1810,18.123781400875014,22,1017,0.0,11
2020-07-24 19:00:00+02:00,1377,79,1298,29.302290054916483,1415,84,1331,17.77573700735779,22,1017,0.0,11
2020-07-24 20:00:00+02:00,1441,94,1347,23.062043657336567,1412,86,1326,20.797166781391496,22,1017,0.0,11
2020-07-24 21:00:00+02:00,1114,71,1043,19.20189093670057,1095,58,1037,17.46621028728195,22,1017,0.0,11
2020-07-24 22:00:00+02:00,762,44,718,21.546843472820022,711,37,674,23.3630553162607,22,1017,0.0,11
2020-07-24 23:00:00+02:00,554,30,524,20.647004597497897,525,33,492,14.980677686266207,22,1017,0.0,11
2020-07-25 00:00:00+02:00,412,13,399,18.68690829245824,428,16,412,18.508932401616175,23,1015,0.1,3
2020-07-25 01:00:00+02:00,272,10,262,19.769621511195208,280,10,270,18.140570207306258,23,1015,0.1,3
2020-07-25 02:00:00+02:00,272,9,263,19.769621511195208,280,10,270,18.140570207306258,23,1015,0.1,3
2020-07-25 03:00:00+02:00,408,14,394,18.77391768790148,420,14,406,21.477713640454677,23,1015,0.1,3
2020-07-25 04:00:00+02:00,536,21,515,17.397292140581737,568,19,549,20.995703875936886,23,1015,0.1,3
2020-07-25 05:00:00+02:00,689,26,663,21.65226431706797,709,23,686,20.494880632890936,23,1015,0.1,3
2020-07-25 06:00:00+02:00,1113,42,1071,19.371788016021974,1145,34,1111,22.701395199856325,23,1015,0.1,3
2020-07-25 07:00:00+02:00,1638,58,1580,21.40560520386746,1674,62,1612,17.423467290342266,23,1015,0.1,3
2020-07-25 08:00:00+02:00,2179,78,2101,19.87045527395897,2243,72,2171,19.15346759924182,23,1015,0.1,3
2020-07-25 09:00:00+02:00,2231,82,2149,23.008021586959018,2415,75,2340,22.468937389495622,23,1015,0.1,3
2020-07-25 10:00:00+02:00,2003,80,1923,18.592759900977683,2131,78,2053,18.118390456768033,23,1015,0.1,3
2020-07-25 11:00:00+02:00,1570,55,1515,18.344357601824537,1726,57,1669,20.309710332180288,23,1015,0.1,3
2020-07-25 12:00:00+02:00,1630,66,1564,20.146047945245336,1710,51,1659,19.929476409044707,23,1015,0.1,3
2020-07-25 13:00:00+02:00,1782,71,1711,19.720030695673806,1846,61,1785,18.498046973290922,23,1015,0.1,3
2020-07-25 14:00:00+02:00,1630,66,1564,20.146047945245336,1710,51,1659,19.929476409044707,23,1015,0.1,3
2020-07-25 15:00:00+02:00,1919,77,1842,22.01978301120412,1995,62,1933,19.06454293588533,23,1015,0.1,3
2020-07-25 16:00:00+02:00,1883,74,1809,16.229365284358657,1995,69,1926,19.06454293588533,23,1015,0.1,3
2020-07-25 17:00:00+02:00,2151,85,2066,22.343630793408536,2303,77,2226,23.141395983280155,23,1015,0.1,3
2020-07-25 18:00:00+02:00,2003,79,1924,18.592759900977683,2131,78,2053,18.118390456768033,23,1015,0.1,3
2020-07-25 19:00:00+02:00,1570,55,1515,18.344357601824537,1726,57,1669,20.309710332180288,23,1015,0.1,3
2020-07-25 20:00:00+02:00,1494,60,1434,11.401974834836365,1546,46,1500,22.303345842737144,23,1015,0.1,3
2020-07-25 21:00:00+02:00,1378,55,1323,20.012194871703887,1402,47,1355,18.70278064369957,23,1015,0.1,3
2020-07-25 22:00:00+02:00,1113,44,1069,19.371788016021974,1145,34,1111,22.701395199856325,23,1015,0.1,3
2020-07-25 23:00:00+02:00,544,19,525,18.720047080643024,568,21,547,20.995703875936886,23,1015,0.1,3
2020-07-26 00:00:00+02:00,59,1,58,6.65720843859931,70,1,69,8.998611660339348,22,1010,1.9,17
2020-07-26 01:00:00+02:00,38,0,38,0.13310387258565337,46,0,46,4.011318391784301,22,1010,1.9,17
2020-07-26 02:00:00+02:00,40,1,39,0.41455636652786926,47,1,46,4.3277213030581025,22,1010,1.9,17
2020-07-26 03:00:00+02:00,60,1,59,6.2612262646008014,66,1,65,6.848202598840497,22,1010,1.9,17
2020-07-26 04:00:00+02:00,72,1,71,8.364644789856655,105,2,103,12.90034298013122,22,1010,1.9,17
2020-07-26 05:00:00+02:00,96,2,94,10.141111778465794,105,2,103,12.90034298013122,22,1010,1.9,17
2020-07-26 06:00:00+02:00,154,3,151,16.66932336881329,199,4,195,15.912981598907018,22,1010,1.9,17
2020-07-26 07:00:00+02:00,239,6,233,21.954537826783962,251,6,245,17.648672578539976,22,1010,1.9,17
2020-07-26 08:00:00+02:00,311,8,303,21.534266279087344,397,8,389,18.899886787636014,22,1010,1.9,17
2020-07-26 09:00:00+02:00,333,8,325,20.04280816461704,388,10,378,21.335919297359776,22,1010,1.9,17
2020-07-26 10:00:00+02:00,275,6,269,17.667184644222043,397,10,387,18.899886787636014,22,1010,1.9,17
2020-07-26 11:00:00+02:00,235,6,229,17.818698986618266,291,7,284,18.65765369075301,22,1010,1.9,17
2020-07-26 12:00:00+02:00,231,5,226,17.781909711504213,291,7,284,18.65765369075301,22,1010,1.9,17
2020-07-26 13:00:00+02:00,250,5,245,19.87213099739703,298,6,292,20.492105699574804,22,1010,1.9,17
2020-07-26 14:00:00+02:00,217,5,212,18.524303511273022,268,6,262,17.48234396673468,22,1010,1.9,17
2020-07-26 15:00:00+02:00,270,6,264,17.758193366652176,296,6,290,20.22658197049654,22,1010,1.9,17
2020-07-26 16:00:00+02:00,253,6,247,19.52264004070869,321,6,315,14.798236545220965,22,1010,1.9,17
2020-07-26 17:00:00+02:00,292,7,285,20.98379645720198,346,7,339,19.574962836525334,22,1010,1.9,17
2020-07-26 18:00:00+02:00,284,6,278,20.19042731002901,392,10,382,19.81318580010203,22,1010,1.9,17
2020-07-26 19:00:00+02:00,220,5,215,17.165789561846236,259,6,253,19.654896199931585,22,1010,1.9,17
2020-07-26 20:00:00+02:00,216,5,211,18.982366806375833,245,6,239,18.942695865735725,22,1010,1.9,17
2020-07-26 21:00:00+02:00,193,4,189,17.477315732472185,239,5,234,21.954537826783962,22,1010,1.9,17
2020-07-26 22:00:00+02:00,151,3,148,16.104558405426747,190,4,186,15.722923549480257,22,1010,1.9,17
2020-07-26 23:00:00+02:00,78,1,77,11.28019362112849,80,2,78,10.935892759042927,22,1010,1.9,17
2020-07-27 00:00:00+02:00,411,25,386,20.19047191446031,420,29,391,17.41043484577572,25,1017,0.0,5
2020-07-27 01:00:00+02:00,280,18,262,16.749368848648214,280,18,262,16.749368848648214,25,1017,0.0,5
2020-07-27 02:00:00+02:00,267,16,251,19.55401418007802,288,17,271,15.208482117639065,25,1017,0.0,5
2020-07-27 03:00:00+02:00,411,23,388,20.19047191446031,420,29,391,17.41043484577572,25,1017,0.0,5
2020-07-27 04:00:00+02:00,704,45,659,20.21819540478189,729,53,676,18.477854851200163,25,1017,0.0,5
2020-07-27 05:00:00+02:00,1215,69,1146,22.979133389698973,1309,95,1214,20.03625739127993,25,1017,0.0,5
2020-07-27 06:00:00+02:00,1544,97,1447,21.454423575656985,1602,121,1481,22.63940243790885,25,1017,0.0,5
2020-07-27 07:00:00+02:00,2475,135,2340,12.977197258554156,2434,152,2282,19.987854709673904,25,1017,0.0,5
2020-07-27 08:00:00+02:00,2615,165,2450,16.526956878145363,2553,167,2386,19.875117763154552,25,1017,0.0,5
2020-07-27 09:00:00+02:00,1647,107,1540,24.38125577027313,1771,106,1665,18.027913608098327,25,1017,0.0,5
2020-07-27 10:00:00+02:00,1478,88,1390,22.16603284657213,1433,93,1340,12.35509249923399,25,1017,0.0,5
2020-07-27 11:00:00+02:00,1775,112,1663,21.25342020106117,1742,128,1614,19.798626220775674,25,1017,0.0,5
2020-07-27 12:00:00+02:00,1412,92,1320,20.797166781391496,1478,108,1370,22.16603284657213,25,1017,0.0,5
2020-07-27 13:00:00+02:00,1388,81,1307,20.3853165959561,1470,84,1386,21.600225171237636,25,1017,0.0,5
2020-07-27 14:00:00+02:00,1388,85,1303,20.3853165959561,1470,84,1386,21.600225171237636,25,1017,0.0,5
2020-07-27 15:00:00+02:00,1528,93,1435,21.868695632182273,1528,87,1441,21.868695632182273,25,1017,0.0,5
2020-07-27 16:00:00+02:00,1610,87,1523,16.620901851213503,1750,120,1630,18.93041134618874,25,1017,0.0,5
2020-07-27 17:00:00+02:00,2421,139,2282,22.263918818618965,2413,179,2234,26.076943881413616,25,1017,0.0,5
2020-07-27 18:00:00+02:00,2545,155,2390,24.327415447184734,2512,177,2335,19.03356961735714,25,1017,0.0,5
2020-07-27 19:00:00+02:00,1837,110,1727,20.944269580145274,1878,129,1749,21.134346687332272,25,1017,0.0,5
2020-07-27 20:00:00+02:00,1799,98,1701,22.577640611785984,1837,110,1727,20.944269580145274,25,1017,0.0,5
2020-07-27 21:00:00+02:00,1441,89,1352,23.062043657336567,1408,80,1328,19.42114709151158,25,1017,0.0,5
2020-07-27 22:00:00+02:00,988,54,934,20.538322750287296,1005,58,947,17.12267614832163,25,1017,0.0,5
2020-07-27 23:00:00+02:00,691,41,650,25.568586687639538,696,45,651,20.373472852324685,25,1017,0.0,5
2020-07-28 00:00:00+02:00,223,11,212,14.162371988477169,254,16,238,19.538354504790107,22,1013,0.0,19
2020-07-28 01:00:00+02:00,163,8,155,16.657029309986655,175,10,165,17.28891326509282,22,1013,0.0,19
2020-07-28 02:00:00+02:00,158,8,150,15.520682112145103,177,9,168,19.585032284639567,22,1013,0.0,19
2020-07-28 03:00:00+02:00,230,11,219,14.964272020980927,244,13,231,21.645479919989064,22,1013,0.0,19
2020-07-28 04:00:00+02:00,374,19,355,19.74351641083776,431,24,407,17.430621680262487,22,1013,0.0,19
2020-07-28 05:00:00+02:00,700,40,660,21.151656624911123,755,48,707,17.985965335815543,22,1013,0.0,19
2020-07-28 06:00:00+02:00,818,48,770,23.33586269948024,918,53,865,17.064437777994613,22,1013,0.0,19
2020-07-28 07:00:00+02:00,1317,75,1242,21.39138689855215,1456,74,1382,20.28539988939373,22,1013,0.0,19
2020-07-28 08:00:00+02:00,1475,77,1398,23.59385017034556,1557,87,1470,23.36028270663989,22,1013,0.0,19
2020-07-28 09:00:00+02:00,892,50,842,19.50607416454189,1012,58,954,17.299334841862212,22,1013,0.0,19
2020-07-28 10:00:00+02:00,820,45,775,20.46067577474115,882,46,836,18.418001455527968,22,1013,0.0,19
2020-07-28 11:00:00+02:00,894,52,842,14.785741954233089,1029,66,963,17.50858882428106,22,1013,0.0,19
2020-07-28 12:00:00+02:00,774,42,732,20.64221556080295,873,50,823,19.610658464903693,22,1013,0.0,19
2020-07-28 13:00:00+02:00,734,38,696,19.628826107247274,885,53,832,20.481706183389488,22,1013,0.0,19
2020-07-28 14:00:00+02:00,729,38,691,18.477854851200163,813,45,768,19.274944408821757,22,1013,0.0,19
2020-07-28 15:00:00+02:00,897,48,849,18.364381944296557,892,61,831,19.50607416454189,22,1013,0.0,19
2020-07-28 16:00:00+02:00,954,50,904,12.157640189393133,1019,54,965,18.55777247392709,22,1013,0.0,19
2020-07-28 17:00:00+02:00,1290,64,1226,25.489670886154155,1468,91,1377,21.27219106182376,22,1013,0.0,19
2020-07-28 18:00:00+02:00,1405,78,1327,17.793467653359297,1528,80,1448,21.868695632182273,22,1013,0.0,19
2020-07-28 19:00:00+02:00,947,46,901,17.116854142767842,1065,68,997,13.959394586310266,22,1013,0.0,19
2020-07-28 20:00:00+02:00,1053,52,1001,21.013262231396435,1084,57,1027,21.889040166411583,22,1013,0.0,19
2020-07-28 21:00:00+02:00,832,47,785,20.740187636845164,887,51,836,20.706308299665398,22,1013,0.0,19
2020-07-28 22:00:00+02:00,508,27,481,13.358348714718126,611,39,572,19.31683839381675,22,1013,0.0,19
2020-07-28 23:00:00+02:00,395,21,374,22.122661435898713,410,28,382,20.181667077415888,22,1013,0.0,19
2020-07-29 00:00:00+02:00,338,23,315,21.115663704400472,321,21,300,23.480156167605287,24,1020,0.0,12
2020-07-29 01:00:00+02:00,225,15,210,17.07968654570721,222,13,209,18.77573498601868,24,1020,0.0,12
2020-07-29 02:00:00+02:00,222,17,205,18.77573498601868,198,13,185,18.14522738171017,24,1020,0.0,12
2020-07-29 03:00:00+02:00,344,23,321,17.416933285982235,334,25,309,23.256671102053218,24,1020,0.0,12
2020-07-29 04:00:00+02:00,573,43,530,13.397132275797208,537,39,498,17.709537334724534,24,1020,0.0,12
2020-07-29 05:00:00+02:00,1038,72,966,25.59007792941324,938,69,869,14.640917048168077,24,1020,0.0,12
2020-07-29 06:00:00+02:00,1260,97,1163,24.587499711956337,1164,82,1082,17.89776216094967,24,1020,0.0,12
2020-07-29 07:00:00+02:00,1943,138,1805,21.79695566675712,1860,114,1746,21.02271279487101,24,1020,0.0,12
2020-07-29 08:00:00+02:00,2066,165,1901,19.249252909061877,1989,136,1853,21.56120693613885,24,1020,0.0,12
2020-07-29 09:00:00+02:00,1359,100,1259,26.17123576185462,1253,91,1162,17.98124723164861,24,1020,0.0,12
2020-07-29 10:00:00+02:00,1154,81,1073,25.719662473486025,1074,80,994,24.384279215656534,24,1020,0.0,12
2020-07-29 11:00:00+02:00,1353,103,1250,21.341796552724627,1336,93,1243,20.62861321334729,24,1020,0.0,12
2020-07-29 12:00:00+02:00,1134,87,1047,24.848180057984827,1127,77,1050,21.405421540571112,24,1020,0.0,12
2020-07-29 13:00:00+02:00,1127,82,1045,21.405421540571112,1044,67,977,25.17539561203,24,1020,0.0,12
2020-07-29 14:00:00+02:00,1134,86,1048,24.848180057984827,1127,77,1050,21.405421540571112,24,1020,0.0,12
2020-07-29 15:00:00+02:00,1240,90,1150,19.62052929289891,1157,80,1077,22.92806138704429,24,1020,0.0,12
2020-07-29 16:00:00+02:00,1363,94,1269,23.625407529205518,1286,79,1207,20.9564204782431,24,1020,0.0,12
2020-07-29 17:00:00+02:00,1953,160,1793,25.29038876744737,1860,111,1749,21.02271279487101,24,1020,0.0,12
2020-07-29 18:00:00+02:00,2066,165,1901,19.249252909061877,1989,136,1853,21.56120693613885,24,1020,0.0,12
2020-07-29 19:00:00+02:00,1475,109,1366,22.322473787310965,1402,96,1306,22.516514362217915,24,1020,0.0,12
2020-07-29 20:00:00+02:00,1459,105,1354,22.516018339405786,1316,89,1227,24.1604241731858,24,1020,0.0,12
2020-07-29 21:00:00+02:00,1127,87,1040,21.405421540571112,1044,67,977,25.17539561203,24,1020,0.0,12
2020-07-29 22:00:00+02:00,792,60,732,24.002822951179763,795,54,741,28.497132539612636,24,1020,0.0,12
2020-07-29 23:00:00+02:00,577,40,537,23.103874122084292,537,38,499,17.709537334724534,24,1020,0.0,12
2020-07-30 00:00:00+02:00,352,16,336,19.260282763631587,345,33,312,16.239828649782844,25,1021,0.0,11
2020-07-30 01:00:00+02:00,243,11,232,20.047908047539842,225,20,205,16.661436915864048,25,1021,0.0,11
2020-07-30 02:00:00+02:00,236,12,224,15.539654137252858,228,20,208,19.20243901718648,25,1021,0.0,11
2020-07-30 03:00:00+02:00,334,16,318,16.121444874138597,338,25,313,16.592322880399497,25,1021,0.0,11
2020-07-30 04:00:00+02:00,574,26,548,15.684649835412802,609,46,563,18.50873235092512,25,1021,0.0,11
2020-07-30 05:00:00+02:00,996,48,948,21.80745007104885,1032,76,956,21.510030134487824,25,1021,0.0,11
2020-07-30 06:00:00+02:00,1134,59,1075,21.351439587471354,1328,108,1220,24.175628663883305,25,1021,0.0,11
2020-07-30 07:00:00+02:00,2071,110,1961,10.94169168563226,2078,169,1909,23.418614961909313,25,1021,0.0,11
2020-07-30 08:00:00+02:00,1965,92,1873,20.532399398067295,2117,180,1937,17.020456734981348,25,1021,0.0,11
2020-07-30 09:00:00+02:00,1250,59,1191,17.894818489236755,1426,106,1320,24.54156244589326,25,1021,0.0,11
2020-07-30 10:00:00+02:00,1113,50,1063,18.350105714053825,1204,91,1113,17.64162412565009,25,1021,0.0,11
2020-07-30 11:00:00+02:00,1416,75,1341,21.264852093307574,1416,138,1278,21.264852093307574,25,1021,0.0,11
2020-07-30 12:00:00+02:00,1169,63,1106,22.04567095250258,1134,98,1036,21.351439587471354,25,1021,0.0,11
2020-07-30 13:00:00+02:00,1225,59,1166,19.380910823619857,1130,101,1029,21.5185605860936,25,1021,0.0,11
2020-07-30 14:00:00+02:00,1039,53,986,19.326783413339495,1127,85,1042,19.589634910055096,25,1021,0.0,11
2020-07-30 15:00:00+02:00,1285,67,1218,18.729838525758776,1275,123,1152,21.474560179522392,25,1021,0.0,11
2020-07-30 16:00:00+02:00,1373,72,1301,22.554585571004665,1373,103,1270,22.554585571004665,25,1021,0.0,11
2020-07-30 17:00:00+02:00,1874,86,1788,21.942717436847385,2064,163,1901,17.802572180408276,25,1021,0.0,11
2020-07-30 18:00:00+02:00,1972,93,1879,16.889183151595454,2043,193,1850,21.886979037322767,25,1021,0.0,11
2020-07-30 19:00:00+02:00,1497,70,1427,24.629925867396214,1479,139,1340,24.794945219981273,25,1021,0.0,11
2020-07-30 20:00:00+02:00,1440,70,1370,19.15142707299658,1595,117,1478,17.90474234020782,25,1021,0.0,11
2020-07-30 21:00:00+02:00,1032,49,983,21.510030134487824,1109,102,1007,19.331354068660346,25,1021,0.0,11
2020-07-30 22:00:00+02:00,845,46,799,19.33584584408964,852,68,784,17.074570556249217,25,1021,0.0,11
2020-07-30 23:00:00+02:00,595,32,563,19.26058236025398,598,50,548,13.432273774946989,25,1021,0.0,11
2020-07-31 00:00:00+02:00,427,24,403,18.2667082444511,431,28,403,17.430621680262487,31,1015,0.0,11
2020-07-31 01:00:00+02:00,277,17,260,18.53952922542662,261,16,245,17.415614153312035,31,1015,0.0,11
2020-07-31 02:00:00+02:00,286,15,271,17.683792022579453,265,13,252,21.659352492207965,31,1015,0.0,11
2020-07-31 03:00:00+02:00,423,27,396,16.203516397748324,389,26,363,16.378207686582655,31,1015,0.0,11
2020-07-31 04:00:00+02:00,688,45,643,23.77030631492574,655,34,621,21.266263816952357,31,1015,0.0,11
2020-07-31 05:00:00+02:00,1244,72,1172,19.1289917212426,1290,70,1220,25.489670886154155,31,1015,0.0,11
2020-07-31 06:00:00+02:00,1526,92,1434,19.06440046868339,1576,90,1486,19.373936995450347,31,1015,0.0,11
2020-07-31 07:00:00+02:00,2377,135,2242,21.629703052473662,2260,132,2128,22.430400734197793,31,1015,0.0,11
2020-07-31 08:00:00+02:00,2497,157,2340,23.194334715100304,2360,144,2216,19.609976821410022,31,1015,0.0,11
2020-07-31 09:00:00+02:00,1713,100,1613,18.700923249010376,1705,113,1592,21.069957666607994,31,1015,0.0,11
2020-07-31 10:00:00+02:00,1389,90,1299,21.569721327654584,1443,99,1344,23.7488687388318,31,1015,0.0,11
2020-07-31 11:00:00+02:00,1626,99,1527,21.331815889806304,1676,114,1562,20.064745922155097,31,1015,0.0,11
2020-07-31 12:00:00+02:00,1356,74,1282,22.174890739000176,1393,76,1317,18.88591149234884,31,1015,0.0,11
2020-07-31 13:00:00+02:00,1431,78,1353,18.69455992878865,1352,70,1282,15.625273139726433,31,1015,0.0,11
2020-07-31 14:00:00+02:00,1439,81,1358,26.551600412662243,1443,74,1369,23.7488687388318,31,1015,0.0,11
2020-07-31 15:00:00+02:00,1489,90,1399,20.636441201819782,1580,95,1485,23.500735172723896,31,1015,0.0,11
2020-07-31 16:00:00+02:00,1676,95,1581,20.064745922155097,1572,82,1490,18.056895089724954,31,1015,0.0,11
2020-07-31 17:00:00+02:00,2455,141,2314,18.686566600965154,2406,125,2281,16.395860099233687,31,1015,0.0,11
2020-07-31 18:00:00+02:00,2559,153,2406,22.14622601689305,2559,149,2410,22.14622601689305,31,1015,0.0,11
2020-07-31 19:00:00+02:00,1850,119,1731,19.74889576793901,1754,116,1638,19.91682877518685,31,1015,0.0,11
2020-07-31 20:00:00+02:00,1854,103,1751,16.832045219477013,1808,105,1703,19.458195929580718,31,1015,0.0,11
2020-07-31 21:00:00+02:00,1427,91,1336,25.710417395172005,1352,70,1282,15.625273139726433,31,1015,0.0,11
2020-07-31 22:00:00+02:00,1008,57,951,20.789454056654165,929,63,866,13.885339320671468,31,1015,0.0,11
2020-07-31 23:00:00+02:00,709,43,666,17.04052905942483,721,41,680,21.76983382346408,31,1015,0.0,11
2020-08-01 00:00:00+02:00,364,14,350,18.762095160533544,386,13,373,21.311148753338667,24,1014,0.3,6
2020-08-01 01:00:00+02:00,238,9,229,19.894659489704694,252,8,244,19.382112712433184,24,1014,0.3,6
2020-08-01 02:00:00+02:00,249,8,241,17.53630178048871,256,7,249,18.282460948594046,24,1014,0.3,6
2020-08-01 03:00:00+02:00,364,12,352,18.762095160533544,386,13,373,21.311148753338667,24,1014,0.3,6
2020-08-01 04:00:00+02:00,476,19,457,21.578485710413005,512,19,493,19.80410952319733,24,1014,0.3,6
2020-08-01 05:00:00+02:00,610,21,589,24.604995876219537,628,24,604,23.534978496867314,24,1014,0.3,6
2020-08-01 06:00:00+02:00,942,32,910,21.456478910512665,1007,38,969,21.871276256028683,24,1014,0.3,6
2020-08-01 07:00:00+02:00,1462,54,1408,18.03341537699158,1541,60,1481,19.27939746881924,24,1014,0.3,6
2020-08-01 08:00:00+02:00,2000,72,1928,22.459300774305042,2058,73,1985,15.749215982421882,24,1014,0.3,6
2020-08-01 09:00:00+02:00,2076,71,2005,19.930419583966476,2166,69,2097,21.89146974181524,24,1014,0.3,6
2020-08-01 10:00:00+02:00,1855,71,1784,19.831013517696476,1913,63,1850,18.271502100243325,24,1014,0.3,6
2020-08-01 11:00:00+02:00,1498,51,1447,20.099231750707837,1512,56,1456,19.085684764322693,24,1014,0.3,6
2020-08-01 12:00:00+02:00,1433,56,1377,19.537368133594907,1512,54,1458,19.085684764322693,24,1014,0.3,6
2020-08-01 13:00:00+02:00,1552,60,1492,17.806189211708023,1686,67,1619,17.920884979925603,24,1014,0.3,6
2020-08-01 14:00:00+02:00,1437,49,1388,19.332076611045384,1512,54,1458,19.085684764322693,24,1014,0.3,6
2020-08-01 15:00:00+02:00,1675,65,1610,17.09289024016376,1787,71,1716,22.11120717523564,24,1014,0.3,6
2020-08-01 16:00:00+02:00,1704,59,1645,17.021760795849666,1805,70,1735,17.410165263637154,24,1014,0.3,6
2020-08-01 17:00:00+02:00,2007,74,1933,18.049881581139765,2068,65,2003,21.799059866670127,24,1014,0.3,6
2020-08-01 18:00:00+02:00,1830,74,1756,16.773430547237417,1924,75,1849,21.228877690872913,24,1014,0.3,6
2020-08-01 19:00:00+02:00,1473,51,1422,19.252446782362185,1534,55,1479,18.73715062264188,24,1014,0.3,6
2020-08-01 20:00:00+02:00,1343,47,1296,20.708827666592388,1426,46,1380,22.232917691777853,24,1014,0.3,6
2020-08-01 21:00:00+02:00,1220,41,1179,19.4409456016129,1270,47,1223,23.633838688912228,24,1014,0.3,6
2020-08-01 22:00:00+02:00,985,40,945,19.532159878069237,1021,31,990,18.499271878394584,24,1014,0.3,6
2020-08-01 23:00:00+02:00,494,17,477,21.396837821245853,501,17,484,19.86221880757666,24,1014,0.3,6
2020-08-02 00:00:00+02:00,159,4,155,12.4605873158537,207,4,203,17.119838437657844,21,1017,0.0,14
2020-08-02 01:00:00+02:00,109,2,107,15.25040440003263,120,2,118,15.669755682265086,21,1017,0.0,14
2020-08-02 02:00:00+02:00,100,2,98,12.146755672851967,131,2,129,16.939966253796925,21,1017,0.0,14
2020-08-02 03:00:00+02:00,156,3,153,14.313945277913605,207,4,203,17.119838437657844,21,1017,0.0,14
2020-08-02 04:00:00+02:00,221,4,217,16.51685700341795,240,5,235,18.213578737084728,21,1017,0.0,14
2020-08-02 05:00:00+02:00,279,6,273,19.07835204637127,285,5,280,20.336052219275658,21,1017,0.0,14
2020-08-02 06:00:00+02:00,430,9,421,21.112878310349384,531,11,520,19.426620091106447,21,1017,0.0,14
2020-08-02 07:00:00+02:00,643,15,628,17.306805715927837,825,19,806,11.801472156464916,21,1017,0.0,14
2020-08-02 08:00:00+02:00,898,19,879,20.98558615058402,1021,22,999,18.499271878394584,21,1017,0.0,14
2020-08-02 09:00:00+02:00,940,21,919,15.906403409115752,951,23,928,14.600025001021109,21,1017,0.0,14
2020-08-02 10:00:00+02:00,775,18,757,21.82834521470701,990,22,968,23.289171160834865,21,1017,0.0,14
2020-08-02 11:00:00+02:00,618,14,604,19.70058254495543,749,19,730,22.354184713077586,21,1017,0.0,14
2020-08-02 12:00:00+02:00,609,13,596,22.728916140394023,733,18,715,23.91282318508789,21,1017,0.0,14
2020-08-02 13:00:00+02:00,677,15,662,20.149196952152575,839,19,820,21.62935111139554,21,1017,0.0,14
2020-08-02 14:00:00+02:00,643,15,628,17.306805715927837,825,19,806,11.801472156464916,21,1017,0.0,14
2020-08-02 15:00:00+02:00,786,17,769,21.92962351908799,962,24,938,23.16043660349329,21,1017,0.0,14
2020-08-02 16:00:00+02:00,752,19,733,22.707192944945145,1015,20,995,22.411943866720037,21,1017,0.0,14
2020-08-02 17:00:00+02:00,898,21,877,20.98558615058402,1021,22,999,18.499271878394584,21,1017,0.0,14
2020-08-02 18:00:00+02:00,830,19,811,23.681986709353712,816,17,799,16.925732844250618,21,1017,0.0,14
2020-08-02 19:00:00+02:00,640,15,625,21.85496419965211,884,18,866,17.926333594670417,21,1017,0.0,14
2020-08-02 20:00:00+02:00,615,15,600,24.027661345894813,828,17,811,20.577147493337108,21,1017,0.0,14
2020-08-02 21:00:00+02:00,553,12,541,18.823159771715975,702,14,688,25.50645456910462,21,1017,0.0,14
2020-08-02 22:00:00+02:00,450,10,440,20.185916479020335,523,11,512,20.7191567225353,21,1017,0.0,14
2020-08-02 23:00:00+02:00,204,4,200,15.478853824369667,212,5,207,18.02192615808873,21,1017,0.0,14
2020-08-03 00:00:00+02:00,286,16,270,17.683792022579453,297,17,280,17.9875078215099,20,1017,0.0,12
2020-08-03 01:00:00+02:00,193,11,182,15.803016108301952,202,11,191,17.00555627753825,20,1017,0.0,12
2020-08-03 02:00:00+02:00,202,12,190,17.00555627753825,196,12,184,16.38105770904846,20,1017,0.0,12
2020-08-03 03:00:00+02:00,309,20,289,17.873000534247286,297,17,280,17.9875078215099,20,1017,0.0,12
2020-08-03 04:00:00+02:00,488,28,460,14.749723336301003,497,31,466,21.93881886811261,20,1017,0.0,12
2020-08-03 05:00:00+02:00,931,53,878,15.989997831463118,902,60,842,15.213519013612297,20,1017,0.0,12
2020-08-03 06:00:00+02:00,1070,69,1001,24.712950845100785,1113,75,1038,18.350105714053825,20,1017,0.0,12
2020-08-03 07:00:00+02:00,1738,96,1642,22.294138056463854,1689,101,1588,23.63203586852005,20,1017,0.0,12
2020-08-03 08:00:00+02:00,1865,104,1761,18.225174257780303,1828,108,1720,21.4435952764888,20,1017,0.0,12
2020-08-03 09:00:00+02:00,1133,64,1069,24.13774569272726,1171,85,1086,21.577763426638608,20,1017,0.0,12
2020-08-03 10:00:00+02:00,1015,55,960,18.66521485179495,997,71,926,13.74979166870969,20,1017,0.0,12
2020-08-03 11:00:00+02:00,1197,68,1129,15.125679094733162,1191,67,1124,21.350740312613073,20,1017,0.0,12
2020-08-03 12:00:00+02:00,997,62,935,13.74979166870969,1029,64,965,17.50858882428106,20,1017,0.0,12
2020-08-03 13:00:00+02:00,969,58,911,18.882904951217604,1038,64,974,19.87537149157779,20,1017,0.0,12
2020-08-03 14:00:00+02:00,1038,57,981,19.87537149157779,992,69,923,15.296581905329582,20,1017,0.0,12
2020-08-03 15:00:00+02:00,1073,58,1015,21.484259354406472,1113,75,1038,18.350105714053825,20,1017,0.0,12
2020-08-03 16:00:00+02:00,1226,68,1158,17.118863790278894,1194,83,1111,19.735405768215895,20,1017,0.0,12
2020-08-03 17:00:00+02:00,1643,97,1546,23.06273920117239,1761,105,1656,21.150341709915647,20,1017,0.0,12
2020-08-03 18:00:00+02:00,1712,106,1606,23.705558178825907,1805,136,1669,19.257638310049785,20,1017,0.0,12
2020-08-03 19:00:00+02:00,1313,83,1230,22.777588021441254,1304,81,1223,23.689502806152973,20,1017,0.0,12
2020-08-03 20:00:00+02:00,1281,80,1201,17.215548773496284,1281,91,1190,17.215548773496284,20,1017,0.0,12
2020-08-03 21:00:00+02:00,1038,65,973,19.87537149157779,992,69,923,15.296581905329582,20,1017,0.0,12
2020-08-03 22:00:00+02:00,682,37,645,17.36373749431671,685,39,646,23.404770439070823,20,1017,0.0,12
2020-08-03 23:00:00+02:00,500,30,470,17.899939374975602,503,34,469,17.292829814524758,20,1017,0.0,12
2020-08-04 00:00:00+02:00,303,17,286,19.42032220804275,309,18,291,17.873000534247286,22,1017,0.0,13
2020-08-04 01:00:00+02:00,192,9,183,18.405256110010246,210,11,199,16.242964247092598,22,1017,0.0,13
2020-08-04 02:00:00+02:00,186,9,177,14.883580611736797,213,11,202,14.733316442006998,22,1017,0.0,13
2020-08-04 03:00:00+02:00,303,15,288,19.42032220804275,309,18,291,17.873000534247286,22,1017,0.0,13
2020-08-04 04:00:00+02:00,480,24,456,19.602439427466802,537,31,506,14.987091383273496,22,1017,0.0,13
2020-08-04 05:00:00+02:00,894,46,848,14.785741954233089,967,62,905,23.344639801874298,22,1017,0.0,13
2020-08-04 06:00:00+02:00,1060,53,1007,20.585731765578405,1162,78,1084,22.789046153550505,22,1017,0.0,13
2020-08-04 07:00:00+02:00,1774,89,1685,24.050184645806425,1891,113,1778,16.719080959394027,22,1017,0.0,13
2020-08-04 08:00:00+02:00,1870,99,1771,16.753084753914536,1943,125,1818,20.576980698411706,22,1017,0.0,13
2020-08-04 09:00:00+02:00,1156,60,1096,20.135955646809062,1333,89,1244,19.461439866245428,22,1017,0.0,13
2020-08-04 10:00:00+02:00,936,47,889,18.90266812520222,1081,59,1022,20.159540341862932,22,1017,0.0,13
2020-08-04 11:00:00+02:00,1204,66,1138,17.64162412565009,1318,79,1239,19.32568094844101,22,1017,0.0,13
2020-08-04 12:00:00+02:00,964,54,910,21.54885981421529,1102,60,1042,19.145311314430252,22,1017,0.0,13
2020-08-04 13:00:00+02:00,952,48,904,19.65427742636437,1045,66,979,20.083744984786637,22,1017,0.0,13
2020-08-04 14:00:00+02:00,945,53,892,17.157144994893883,1024,65,959,19.558156371320653,22,1017,0.0,13
2020-08-04 15:00:00+02:00,1096,55,1041,17.373128454029146,1222,69,1153,21.983269340118436,22,1017,0.0,13
2020-08-04 16:00:00+02:00,1222,72,1150,21.983269340118436,1279,86,1193,21.931933870604148,22,1017,0.0,13
2020-08-04 17:00:00+02:00,1705,100,1605,21.069957666607994,1768,120,1648,18.03888039964145,22,1017,0.0,13
2020-08-04 18:00:00+02:00,1729,97,1632,25.671264635036508,1946,109,1837,19.90636949701012,22,1017,0.0,13
2020-08-04 19:00:00+02:00,1279,72,1207,21.931933870604148,1375,93,1282,21.992439773971398,22,1017,0.0,13
2020-08-04 20:00:00+02:00,1243,69,1174,21.87806169964562,1402,89,1313,18.403958105546298,22,1017,0.0,13
2020-08-04 21:00:00+02:00,1042,60,982,20.364106174402306,1057,59,998,11.291374471431947,22,1017,0.0,13
2020-08-04 22:00:00+02:00,693,41,652,21.469669783705342,714,40,674,21.753614737357818,22,1017,0.0,13
2020-08-04 23:00:00+02:00,522,28,494,15.738301696479466,537,29,508,14.987091383273496,22,1017,0.0,13
2020-08-05 00:00:00+02:00,445,31,414,19.037524313009598,411,27,384,21.89950881174465,27,1017,0.0,5
2020-08-05 01:00:00+02:00,294,24,270,18.98421464015195,285,18,267,23.62629721954127,27,1017,0.0,5
2020-08-05 02:00:00+02:00,290,20,270,18.088844908617002,281,20,261,17.665733770068634,27,1017,0.0,5
2020-08-05 03:00:00+02:00,445,36,409,19.037524313009598,411,27,384,21.89950881174465,27,1017,0.0,5
2020-08-05 04:00:00+02:00,736,60,676,21.05706952478318,753,50,703,21.279016544148043,27,1017,0.0,5
2020-08-05 05:00:00+02:00,1337,105,1232,22.31397097827171,1329,82,1247,16.67497559326474,27,1017,0.0,5
2020-08-05 06:00:00+02:00,1627,127,1500,13.792495396552123,1584,97,1487,19.672889739038226,27,1017,0.0,5
2020-08-05 07:00:00+02:00,2554,195,2359,24.89406266553731,2242,133,2109,20.516615524598286,27,1017,0.0,5
2020-08-05 08:00:00+02:00,2645,211,2434,20.311115954095573,2376,156,2220,23.144481886225588,27,1017,0.0,5
2020-08-05 09:00:00+02:00,1762,125,1637,22.687807942002028,1636,97,1539,20.646190576499333,27,1017,0.0,5
2020-08-05 10:00:00+02:00,1493,107,1386,20.711254419088764,1415,96,1319,19.712780018663786,27,1017,0.0,5
2020-08-05 11:00:00+02:00,1757,133,1624,21.130973649748665,1783,119,1664,19.37600371542589,27,1017,0.0,5
2020-08-05 12:00:00+02:00,1476,114,1362,17.217930886271542,1407,96,1311,20.661174839995365,27,1017,0.0,5
2020-08-05 13:00:00+02:00,1476,119,1357,17.217930886271542,1407,96,1311,20.661174839995365,27,1017,0.0,5
2020-08-05 14:00:00+02:00,1476,119,1357,17.217930886271542,1407,96,1311,20.661174839995365,27,1017,0.0,5
2020-08-05 15:00:00+02:00,1623,131,1492,21.85805701056672,1472,87,1385,24.031930059108,27,1017,0.0,5
2020-08-05 16:00:00+02:00,1762,129,1633,22.687807942002028,1636,97,1539,20.646190576499333,27,1017,0.0,5
2020-08-05 17:00:00+02:00,2537,182,2355,26.31232479175807,2532,185,2347,24.544237143552017,27,1017,0.0,5
2020-08-05 18:00:00+02:00,2636,209,2427,19.610754839330614,2688,182,2506,26.522042628638374,27,1017,0.0,5
2020-08-05 19:00:00+02:00,1948,136,1812,27.05442558108783,1857,113,1744,23.865331420443372,27,1017,0.0,5
2020-08-05 20:00:00+02:00,1935,156,1779,16.864995918532298,1930,114,1816,18.2053384138421,27,1017,0.0,5
2020-08-05 21:00:00+02:00,1463,108,1355,25.653409102238907,1342,89,1253,19.29955187785579,27,1017,0.0,5
2020-08-05 22:00:00+02:00,1026,70,956,16.212449823690427,1004,60,944,24.012923051124588,27,1017,0.0,5
2020-08-05 23:00:00+02:00,740,50,690,22.499704569771684,710,50,660,22.11132854905193,27,1017,0.0,5
2020-08-06 00:00:00+02:00,368,17,351,13.914459163966901,422,31,391,15.39920043114212,29,1016,0.0,9
2020-08-06 01:00:00+02:00,248,12,236,17.84767155512712,281,23,258,13.335471171698996,29,1016,0.0,9
2020-08-06 02:00:00+02:00,273,13,260,21.28577278040721,260,23,237,19.57175307665717,29,1016,0.0,9
2020-08-06 03:00:00+02:00,409,18,391,18.9629233186537,397,38,359,18.199028450046157,29,1016,0.0,9
2020-08-06 04:00:00+02:00,720,37,683,22.39715740488537,674,61,613,22.58197276419814,29,1016,0.0,9
2020-08-06 05:00:00+02:00,1134,51,1083,21.351439587471354,1274,104,1170,20.559111744560646,29,1016,0.0,9
2020-08-06 06:00:00+02:00,1490,75,1415,22.309466367572774,1490,138,1352,22.309466367572774,29,1016,0.0,9
2020-08-06 07:00:00+02:00,2235,118,2117,26.44359251030167,2350,222,2128,17.594140772665245,29,1016,0.0,9
2020-08-06 08:00:00+02:00,2582,126,2456,14.801489022092143,2537,225,2312,17.89246064015996,29,1016,0.0,9
2020-08-06 09:00:00+02:00,1519,71,1448,17.075896030241843,1713,140,1573,18.700923249010376,29,1016,0.0,9
2020-08-06 10:00:00+02:00,1440,77,1363,19.15142707299658,1440,105,1335,19.15142707299658,29,1016,0.0,9
2020-08-06 11:00:00+02:00,1461,74,1387,15.85419815283708,1672,139,1533,21.415516475330207,29,1016,0.0,9
2020-08-06 12:00:00+02:00,1233,58,1175,19.66759277413655,1361,122,1239,23.034870998940253,29,1016,0.0,9
2020-08-06 13:00:00+02:00,1357,66,1291,15.328173588813724,1374,134,1240,19.861880457806773,29,1016,0.0,9
2020-08-06 14:00:00+02:00,1419,70,1349,23.634434141638867,1398,135,1263,19.27363515097152,29,1016,0.0,9
2020-08-06 15:00:00+02:00,1440,71,1369,19.15142707299658,1585,116,1469,20.502096401409684,29,1016,0.0,9
2020-08-06 16:00:00+02:00,1639,77,1562,22.91647648420566,1721,157,1564,22.26851481455034,29,1016,0.0,9
2020-08-06 17:00:00+02:00,2201,117,2084,20.433737459055337,2330,207,2123,22.68712254734899,29,1016,0.0,9
2020-08-06 18:00:00+02:00,2508,122,2386,15.76168585268061,2371,204,2167,25.561834471304408,29,1016,0.0,9
2020-08-06 19:00:00+02:00,1866,85,1781,18.335648793912345,1825,146,1679,17.452886252224268,29,1016,0.0,9
2020-08-06 20:00:00+02:00,1829,88,1741,20.101171645895796,1697,133,1564,15.838804890696554,29,1016,0.0,9
2020-08-06 21:00:00+02:00,1274,58,1216,20.559111744560646,1374,119,1255,19.861880457806773,29,1016,0.0,9
2020-08-06 22:00:00+02:00,993,49,944,18.821564537278963,943,70,873,15.571582167139367,29,1016,0.0,9
2020-08-06 23:00:00+02:00,620,32,588,16.78416230918013,649,61,588,23.57250214705965,29,1016,0.0,9
2020-08-07 00:00:00+02:00,415,23,392,17.260810238033525,415,24,391,17.260810238033525,31,1018,0.0,11
2020-08-07 01:00:00+02:00,282,16,266,20.23737833448665,278,16,262,18.588750350595824,31,1018,0.0,11
2020-08-07 02:00:00+02:00,278,17,261,18.588750350595824,269,17,252,17.405298576573397,31,1018,0.0,11
2020-08-07 03:00:00+02:00,419,23,396,16.260754118999643,398,23,375,15.528833477752881,31,1018,0.0,11
2020-08-07 04:00:00+02:00,680,40,640,23.55416420862656,655,40,615,21.266263816952357,31,1018,0.0,11
2020-08-07 05:00:00+02:00,1245,72,1173,16.39692855366147,1278,88,1190,23.35114843320693,31,1018,0.0,11
2020-08-07 06:00:00+02:00,1573,103,1470,21.233650234395295,1585,93,1492,20.502096401409684,31,1018,0.0,11
2020-08-07 07:00:00+02:00,2432,137,2295,21.1104457791494,2412,156,2256,19.915393370732154,31,1018,0.0,11
2020-08-07 08:00:00+02:00,2590,164,2426,20.916857985375458,2495,143,2352,20.448748517619705,31,1018,0.0,11
2020-08-07 09:00:00+02:00,1627,96,1531,18.35293040235441,1581,107,1474,24.860157254249373,31,1018,0.0,11
2020-08-07 10:00:00+02:00,1399,79,1320,24.528935167178957,1336,89,1247,25.100902639753272,31,1018,0.0,11
2020-08-07 11:00:00+02:00,1731,101,1630,22.061002781929634,1627,98,1529,18.35293040235441,31,1018,0.0,11
2020-08-07 12:00:00+02:00,1365,89,1276,23.77196991776294,1328,72,1256,24.175628663883305,31,1018,0.0,11
2020-08-07 13:00:00+02:00,1369,75,1294,22.257932738831848,1365,91,1274,23.77196991776294,31,1018,0.0,11
2020-08-07 14:00:00+02:00,1374,77,1297,19.861880457806773,1411,84,1327,23.862956521429666,31,1018,0.0,11
2020-08-07 15:00:00+02:00,1585,101,1484,20.502096401409684,1523,83,1440,16.51612150159071,31,1018,0.0,11
2020-08-07 16:00:00+02:00,1668,108,1560,22.70564302813872,1581,86,1495,24.860157254249373,31,1018,0.0,11
2020-08-07 17:00:00+02:00,2378,135,2243,25.16662510627241,2424,162,2262,20.96508565557041,31,1018,0.0,11
2020-08-07 18:00:00+02:00,2490,160,2330,26.618905237805976,2412,150,2262,19.915393370732154,31,1018,0.0,11
2020-08-07 19:00:00+02:00,1872,119,1753,18.670729846088307,1789,122,1667,18.643196383738413,31,1018,0.0,11
2020-08-07 20:00:00+02:00,1805,98,1707,19.257638310049785,1822,118,1704,21.99997707726524,31,1018,0.0,11
2020-08-07 21:00:00+02:00,1386,84,1302,21.825882781968403,1444,99,1345,25.04999540340529,31,1018,0.0,11
2020-08-07 22:00:00+02:00,958,52,906,15.947192533584554,996,62,934,21.80745007104885,31,1018,0.0,11
2020-08-07 23:00:00+02:00,697,38,659,20.811959753983317,660,37,623,21.62405031179609,31,1018,0.0,11
2020-08-08 00:00:00+02:00,463,18,445,20.64814119281507,476,15,461,21.578485710413005,32,1018,0.0,9
2020-08-08 01:00:00+02:00,298,11,287,20.492105699574804,307,11,296,21.794901971244688,32,1018,0.0,9
2020-08-08 02:00:00+02:00,298,10,288,20.492105699574804,307,11,296,21.794901971244688,32,1018,0.0,9
2020-08-08 03:00:00+02:00,445,15,430,21.99290430824215,467,14,453,19.993176457637603,32,1018,0.0,9
2020-08-08 04:00:00+02:00,615,23,592,24.027661345894813,628,21,607,23.534978496867314,32,1018,0.0,9
2020-08-08 05:00:00+02:00,726,24,702,21.62918680515137,788,27,761,24.213352272035593,32,1018,0.0,9
2020-08-08 06:00:00+02:00,1185,44,1141,16.651952811116093,1252,39,1213,19.577976542669003,32,1018,0.0,9
2020-08-08 07:00:00+02:00,1854,63,1791,18.33310575626328,1889,62,1827,15.681545636542163,32,1018,0.0,9
2020-08-08 08:00:00+02:00,2415,96,2319,22.468937389495622,2509,98,2411,17.820488035955954,32,1018,0.0,9
2020-08-08 09:00:00+02:00,2638,99,2539,18.453219277876993,2642,91,2551,22.75610251845816,32,1018,0.0,9
2020-08-08 10:00:00+02:00,2246,77,2169,21.672407314462987,2335,81,2254,20.344436057090245,32,1018,0.0,9
2020-08-08 11:00:00+02:00,1791,71,1720,21.598846562063304,1911,74,1837,25.922477913310388,32,1018,0.0,9
2020-08-08 12:00:00+02:00,1755,65,1690,15.310079252975628,1898,58,1840,24.03420669815065,32,1018,0.0,9
2020-08-08 13:00:00+02:00,1974,69,1905,23.24269089760752,2072,69,2003,20.366891088502786,32,1018,0.0,9
2020-08-08 14:00:00+02:00,1791,63,1728,21.598846562063304,1911,74,1837,25.922477913310388,32,1018,0.0,9
2020-08-08 15:00:00+02:00,2050,76,1974,18.554712530514337,2201,71,2130,27.81772655496526,32,1018,0.0,9
2020-08-08 16:00:00+02:00,2116,83,2033,12.747680661071294,2188,85,2103,24.29141264319128,32,1018,0.0,9
2020-08-08 17:00:00+02:00,2397,82,2315,19.414753052746416,2558,98,2460,21.039333822039673,32,1018,0.0,9
2020-08-08 18:00:00+02:00,2281,84,2197,23.13993420334493,2357,74,2283,22.8011385838015,32,1018,0.0,9
2020-08-08 19:00:00+02:00,1840,67,1773,19.89903449229046,1916,64,1852,20.975627285566212,32,1018,0.0,9
2020-08-08 20:00:00+02:00,1693,58,1635,24.061740669786523,1751,56,1695,20.506768028040582,32,1018,0.0,9
2020-08-08 21:00:00+02:00,1470,58,1412,17.02046875763603,1577,56,1521,21.22010576976392,32,1018,0.0,9
2020-08-08 22:00:00+02:00,1167,46,1121,19.74782119199281,1243,43,1200,19.05972589749731,32,1018,0.0,9
2020-08-08 23:00:00+02:00,583,20,563,18.431604118603584,628,23,605,23.534978496867314,32,1018,0.0,9
2020-08-09 00:00:00+02:00,208,4,204,15.500466492892206,262,5,257,16.518080150359744,33,1016,0.7,9
2020-08-09 01:00:00+02:00,146,3,143,15.22361746621585,181,4,177,19.20491147018031,33,1016,0.7,9
2020-08-09 02:00:00+02:00,138,3,135,17.771116054933273,177,3,174,18.32493748209408,33,1016,0.7,9
2020-08-09 03:00:00+02:00,231,5,226,17.781909711504213,277,7,270,15.66436341783579,33,1016,0.7,9
2020-08-09 04:00:00+02:00,308,7,301,20.6154927249965,386,8,378,21.311148753338667,33,1016,0.7,9
2020-08-09 05:00:00+02:00,355,9,346,21.84673395259502,505,11,494,18.922239013512577,33,1016,0.7,9
2020-08-09 06:00:00+02:00,563,14,549,15.54072112529785,787,16,771,23.78658526955978,33,1016,0.7,9
2020-08-09 07:00:00+02:00,864,20,844,21.10382654819081,1107,21,1086,22.664307183400016,33,1016,0.7,9
2020-08-09 08:00:00+02:00,1208,30,1178,20.606247534533097,1188,27,1161,24.481603582966375,33,1016,0.7,9
2020-08-09 09:00:00+02:00,1254,32,1222,23.063850406988294,1428,32,1396,22.463558596426044,33,1016,0.7,9
2020-08-09 10:00:00+02:00,1142,26,1116,21.19270789055955,1277,27,1250,21.09786158476675,33,1016,0.7,9
2020-08-09 11:00:00+02:00,849,21,828,21.892538407101426,1088,24,1064,21.732778477484317,33,1016,0.7,9
2020-08-09 12:00:00+02:00,876,20,856,20.51580319640794,918,23,895,21.123895030889194,33,1016,0.7,9
2020-08-09 13:00:00+02:00,988,24,964,19.478754902387976,1073,21,1052,19.064153484247157,33,1016,0.7,9
2020-08-09 14:00:00+02:00,883,21,862,18.91647524296627,1030,24,1006,16.464378902849642,33,1016,0.7,9
2020-08-09 15:00:00+02:00,1022,22,1000,21.12146276092261,1227,26,1201,23.541643353149336,33,1016,0.7,9
2020-08-09 16:00:00+02:00,1069,24,1045,22.620724783815188,1324,28,1296,21.403293046069233,33,1016,0.7,9
2020-08-09 17:00:00+02:00,1173,29,1144,19.258070397840825,1381,33,1348,19.179587869237896,33,1016,0.7,9
2020-08-09 18:00:00+02:00,1057,24,1033,22.5581785276945,1520,31,1489,16.808120670873752,33,1016,0.7,9
2020-08-09 19:00:00+02:00,833,18,815,20.15216609593774,1065,20,1045,23.0393068645617,33,1016,0.7,9
2020-08-09 20:00:00+02:00,772,18,754,23.438286359230418,934,21,913,16.840915498818756,33,1016,0.7,9
2020-08-09 21:00:00+02:00,710,17,693,22.15354781773007,968,22,946,19.817584404338046,33,1016,0.7,9
2020-08-09 22:00:00+02:00,590,15,575,15.463631814689824,822,19,803,17.294133752554114,33,1016,0.7,9
2020-08-09 23:00:00+02:00,293,6,287,18.18485065574223,331,6,325,19.01247365698417,33,1016,0.7,9
2020-08-10 00:00:00+02:00,228,14,214,19.20243901718648,226,15,211,13.127873271262342,33,1014,2.5,8
2020-08-10 01:00:00+02:00,148,9,139,17.225908215945253,144,8,136,18.30100377188736,33,1014,2.5,8
2020-08-10 02:00:00+02:00,146,8,138,17.043186316188024,153,8,145,14.855598998768997,33,1014,2.5,8
2020-08-10 03:00:00+02:00,230,12,218,14.964272020980927,220,13,207,19.525285937159467,33,1014,2.5,8
2020-08-10 04:00:00+02:00,358,22,336,17.266463146446004,373,23,350,21.959269594519817,33,1014,2.5,8
2020-08-10 05:00:00+02:00,647,36,611,18.734241259643852,686,43,643,21.478058518789883,33,1014,2.5,8
2020-08-10 06:00:00+02:00,817,50,767,22.36001507478258,848,60,788,19.314911843566403,33,1014,2.5,8
2020-08-10 07:00:00+02:00,1281,79,1202,17.215548773496284,1249,89,1160,20.92937590323121,33,1014,2.5,8
2020-08-10 08:00:00+02:00,1355,74,1281,25.95260838365675,1394,85,1309,22.010624469974434,33,1014,2.5,8
2020-08-10 09:00:00+02:00,893,48,845,21.578410255104366,904,68,836,20.851823844071124,33,1014,2.5,8
2020-08-10 10:00:00+02:00,751,43,708,24.369669572878724,761,55,706,19.7510859277752,33,1014,2.5,8
2020-08-10 11:00:00+02:00,858,46,812,20.31135900139536,917,63,854,20.648122791140516,33,1014,2.5,8
2020-08-10 12:00:00+02:00,725,45,680,23.467340538903493,729,54,675,18.477854851200163,33,1014,2.5,8
2020-08-10 13:00:00+02:00,707,40,667,25.9859980509736,748,49,699,25.30954529273543,33,1014,2.5,8
2020-08-10 14:00:00+02:00,770,50,720,14.731680239930954,757,48,709,18.700987078927977,33,1014,2.5,8
2020-08-10 15:00:00+02:00,781,50,731,19.40247607837333,852,51,801,17.074570556249217,33,1014,2.5,8
2020-08-10 16:00:00+02:00,904,59,845,20.851823844071124,930,58,872,21.4794831056504,33,1014,2.5,8
2020-08-10 17:00:00+02:00,1309,73,1236,20.03625739127993,1292,92,1200,20.815832720673015,33,1014,2.5,8
2020-08-10 18:00:00+02:00,1361,75,1286,23.034870998940253,1379,89,1290,19.297644205260525,33,1014,2.5,8
2020-08-10 19:00:00+02:00,936,60,876,18.90266812520222,971,65,906,17.837811918414854,33,1014,2.5,8
2020-08-10 20:00:00+02:00,949,61,888,17.097387724780006,994,72,922,17.443946020111213,33,1014,2.5,8
2020-08-10 21:00:00+02:00,727,39,688,22.606507322491233,753,53,700,21.51612827148557,33,1014,2.5,8
2020-08-10 22:00:00+02:00,496,32,464,17.338309517669067,513,34,479,17.087132975157285,33,1014,2.5,8
2020-08-10 23:00:00+02:00,386,21,365,16.144755675484674,364,24,340,18.504116434485987,33,1014,2.5,8
2020-08-11 00:00:00+02:00,475,24,451,21.299893323798482,504,34,470,22.041349991174183,33,1013,0.0,7
2020-08-11 01:00:00+02:00,309,18,291,17.873000534247286,347,23,324,21.10654626064635,33,1013,0.0,7
2020-08-11 02:00:00+02:00,309,18,291,17.873000534247286,347,23,324,21.10654626064635,33,1013,0.0,7
2020-08-11 03:00:00+02:00,466,27,439,21.78555834863052,518,31,487,19.507042450498037,33,1013,0.0,7
2020-08-11 04:00:00+02:00,723,38,685,22.385964506677706,856,44,812,21.420291050373567,33,1013,0.0,7
2020-08-11 05:00:00+02:00,1446,80,1366,15.701925215369355,1446,76,1370,15.701925215369355,33,1013,0.0,7
2020-08-11 06:00:00+02:00,1593,79,1514,17.52532885576255,1841,122,1719,22.485516398063204,33,1013,0.0,7
2020-08-11 07:00:00+02:00,2673,157,2516,20.179005729588148,2916,175,2741,16.70008132751576,33,1013,0.0,7
2020-08-11 08:00:00+02:00,2649,156,2493,16.129373256677315,3030,156,2874,16.933776400708652,33,1013,0.0,7
2020-08-11 09:00:00+02:00,1902,106,1796,22.81365347072395,2012,123,1889,18.61224745928405,33,1013,0.0,7
2020-08-11 10:00:00+02:00,1565,87,1478,21.523975798196478,1712,116,1596,23.705558178825907,33,1013,0.0,7
2020-08-11 11:00:00+02:00,1841,109,1732,22.485516398063204,2069,117,1952,16.224100334412224,33,1013,0.0,7
2020-08-11 12:00:00+02:00,1517,86,1431,21.614986554409697,1641,90,1551,23.53179637465267,33,1013,0.0,7
2020-08-11 13:00:00+02:00,1588,77,1511,24.669634851917355,1650,99,1551,21.945006034687704,33,1013,0.0,7
2020-08-11 14:00:00+02:00,1579,92,1487,18.74951710030999,1707,96,1611,19.566221981961515,33,1013,0.0,7
2020-08-11 15:00:00+02:00,1636,81,1555,20.944890404436187,1850,106,1744,19.74889576793901,33,1013,0.0,7
2020-08-11 16:00:00+02:00,1855,108,1747,20.35460981688373,1936,102,1834,22.01576773313643,33,1013,0.0,7
2020-08-11 17:00:00+02:00,2668,137,2531,23.39519371912067,2754,163,2591,22.0946399451037,33,1013,0.0,7
2020-08-11 18:00:00+02:00,2768,146,2622,19.373687116396074,3044,187,2857,17.961879804140914,33,1013,0.0,7
2020-08-11 19:00:00+02:00,2097,112,1985,19.889124847908427,2169,133,2036,21.11072819561311,33,1013,0.0,7
2020-08-11 20:00:00+02:00,2102,105,1997,17.328380554272144,2107,112,1995,23.09356307342536,33,1013,0.0,7
2020-08-11 21:00:00+02:00,1541,79,1462,17.453770736188126,1607,109,1498,23.53753795116656,33,1013,0.0,7
2020-08-11 22:00:00+02:00,1046,60,986,17.07842513226638,1222,76,1146,21.983269340118436,33,1013,0.0,7
2020-08-11 23:00:00+02:00,803,47,756,12.897437744361985,870,57,813,20.20072901956326,33,1013,0.0,7
2020-08-12 00:00:00+02:00,348,25,323,20.566317862558048,334,22,312,23.256671102053218,32,1013,1.3,6
2020-08-12 01:00:00+02:00,238,18,220,16.13336525085207,224,15,209,16.30248157536985,32,1013,1.3,6
2020-08-12 02:00:00+02:00,234,15,219,19.754580108435302,214,13,201,18.560318290748608,32,1013,1.3,6
2020-08-12 03:00:00+02:00,348,25,323,20.566317862558048,334,22,312,23.256671102053218,32,1013,1.3,6
2020-08-12 04:00:00+02:00,597,45,552,20.96302352029361,566,32,534,17.19426395043967,32,1013,1.3,6
2020-08-12 05:00:00+02:00,1070,83,987,21.082010363695602,1035,77,958,15.589258351782167,32,1013,1.3,6
2020-08-12 06:00:00+02:00,1297,93,1204,21.713221667079193,1177,83,1094,21.49155380480503,32,1013,1.3,6
2020-08-12 07:00:00+02:00,2026,147,1879,17.451342437127042,1926,115,1811,22.886600809684857,32,1013,1.3,6
2020-08-12 08:00:00+02:00,2119,161,1958,20.916797113605412,2071,158,1913,23.598250416226488,32,1013,1.3,6
2020-08-12 09:00:00+02:00,1415,100,1315,19.712780018663786,1270,86,1184,18.575681633354343,32,1013,1.3,6
2020-08-12 10:00:00+02:00,1197,81,1116,25.25740485301948,1118,80,1038,21.753647008387006,32,1013,1.3,6
2020-08-12 11:00:00+02:00,1429,114,1315,22.445811019052492,1394,86,1308,16.39342487904114,32,1013,1.3,6
2020-08-12 12:00:00+02:00,1201,84,1117,20.11075606080311,1118,80,1038,21.753647008387006,32,1013,1.3,6
2020-08-12 13:00:00+02:00,1190,95,1095,17.777886359993257,1159,80,1079,20.905997590512598,32,1013,1.3,6
2020-08-12 14:00:00+02:00,1190,95,1095,17.777886359993257,1159,80,1079,20.905997590512598,32,1013,1.3,6
2020-08-12 15:00:00+02:00,1308,105,1203,20.746459550058557,1197,81,1116,25.25740485301948,32,1013,1.3,6
2020-08-12 16:00:00+02:00,1418,112,1306,16.71713567141691,1398,81,1317,16.383697163498013,32,1013,1.3,6
2020-08-12 17:00:00+02:00,1988,144,1844,19.469725610290265,1870,138,1732,27.4110484354055,32,1013,1.3,6
2020-08-12 18:00:00+02:00,2102,145,1957,17.40903416136713,1971,149,1822,21.72498524493694,32,1013,1.3,6
2020-08-12 19:00:00+02:00,1518,104,1414,13.452192364200531,1411,80,1331,17.790544055329683,32,1013,1.3,6
2020-08-12 20:00:00+02:00,1539,114,1425,27.40257885254144,1487,111,1376,19.223730676089602,32,1013,1.3,6
2020-08-12 21:00:00+02:00,1184,93,1091,19.553049265064693,1190,88,1102,17.777886359993257,32,1013,1.3,6
2020-08-12 22:00:00+02:00,831,63,768,22.26552315568468,831,59,772,22.26552315568468,32,1013,1.3,6
2020-08-12 23:00:00+02:00,597,46,551,20.96302352029361,566,32,534,17.19426395043967,32,1013,1.3,6
2020-08-13 00:00:00+02:00,103,4,99,15.382954428343787,101,8,93,15.722824076028786,25,1012,4.9,4
2020-08-13 01:00:00+02:00,67,3,64,8.7820789764259,68,5,63,8.76838954329883,25,1012,4.9,4
2020-08-13 02:00:00+02:00,58,3,55,9.553390843343198,64,5,59,10.861502998298342,25,1012,4.9,4
2020-08-13 03:00:00+02:00,96,4,92,14.216912378866963,97,9,88,12.899076821727318,25,1012,4.9,4
2020-08-13 04:00:00+02:00,147,6,141,15.368688681481572,168,12,156,18.826549160784868,25,1012,4.9,4
2020-08-13 05:00:00+02:00,281,12,269,13.335471171698996,302,25,277,15.388460750733547,25,1012,4.9,4
2020-08-13 06:00:00+02:00,324,17,307,16.73552361007021,371,31,340,22.160808065992768,25,1012,4.9,4
2020-08-13 07:00:00+02:00,585,31,554,19.939414463599903,552,41,511,19.146280906772695,25,1012,4.9,4
2020-08-13 08:00:00+02:00,562,27,535,16.760248746749884,621,49,572,16.83849858700539,25,1012,4.9,4
2020-08-13 09:00:00+02:00,383,20,363,16.374944526750998,380,32,348,17.309275284538113,25,1012,4.9,4
2020-08-13 10:00:00+02:00,336,17,319,15.958874822620459,333,32,301,20.32010801444679,25,1012,4.9,4
2020-08-13 11:00:00+02:00,357,18,339,17.217656619200195,386,33,353,16.144755675484674,25,1012,4.9,4
2020-08-13 12:00:00+02:00,295,14,281,18.124850955878475,321,30,291,16.145632477670972,25,1012,4.9,4
2020-08-13 13:00:00+02:00,305,13,292,17.950849983805522,316,29,287,20.62407905935427,25,1012,4.9,4
2020-08-13 14:00:00+02:00,305,13,292,17.950849983805522,316,29,287,20.62407905935427,25,1012,4.9,4
2020-08-13 15:00:00+02:00,336,15,321,15.958874822620459,367,35,332,17.587667378831867,25,1012,4.9,4
2020-08-13 16:00:00+02:00,411,18,393,20.19047191446031,384,34,350,18.328255577407415,25,1012,4.9,4
2020-08-13 17:00:00+02:00,589,28,561,18.12336350672661,542,52,490,19.962845961808647,25,1012,4.9,4
2020-08-13 18:00:00+02:00,534,24,510,17.863758913120975,613,49,564,19.97690214137227,25,1012,4.9,4
2020-08-13 19:00:00+02:00,446,20,426,21.950882073931346,446,41,405,21.950882073931346,25,1012,4.9,4
2020-08-13 20:00:00+02:00,452,20,432,20.457835069065744,451,41,410,18.26483114220407,25,1012,4.9,4
2020-08-13 21:00:00+02:00,304,13,291,17.388899925714064,316,29,287,20.62407905935427,25,1012,4.9,4
2020-08-13 22:00:00+02:00,214,9,205,15.924572551583156,237,19,218,19.639472056784783,25,1012,4.9,4
2020-08-13 23:00:00+02:00,159,7,152,14.902124069206264,164,15,149,17.04508883203371,25,1012,4.9,4
2020-08-14 00:00:00+02:00,322,20,302,15.303808798755027,306,18,288,17.29338931061959,22,1013,0.0,12
2020-08-14 01:00:00+02:00,207,13,194,15.748956490487041,201,10,191,13.923110814237354,22,1013,0.0,12
2020-08-14 02:00:00+02:00,207,12,195,15.748956490487041,201,10,191,13.923110814237354,22,1013,0.0,12
2020-08-14 03:00:00+02:00,313,18,295,19.597411881440696,322,22,300,15.303808798755027,22,1013,0.0,12
2020-08-14 04:00:00+02:00,533,32,501,18.186873348292107,514,32,482,21.0963529036627,22,1013,0.0,12
2020-08-14 05:00:00+02:00,911,53,858,20.001801203541675,960,53,907,18.584415217545775,22,1013,0.0,12
2020-08-14 06:00:00+02:00,1128,69,1059,22.641454851341713,1072,70,1002,19.84126315682822,22,1013,0.0,12
2020-08-14 07:00:00+02:00,1729,105,1624,25.671264635036508,1778,100,1678,18.710498264707567,22,1013,0.0,12
2020-08-14 08:00:00+02:00,1906,110,1796,24.020642084957274,1797,110,1687,20.59167885676239,22,1013,0.0,12
2020-08-14 09:00:00+02:00,1211,68,1143,21.069063648041947,1208,62,1146,20.536356751139678,22,1013,0.0,12
2020-08-14 10:00:00+02:00,1022,66,956,17.852741678054436,1004,56,948,16.68540068085009,22,1013,0.0,12
2020-08-14 11:00:00+02:00,1292,72,1220,20.815832720673015,1261,67,1194,22.841876087162312,22,1013,0.0,12
2020-08-14 12:00:00+02:00,1010,54,956,22.28283154038431,1019,55,964,18.55777247392709,22,1013,0.0,12
2020-08-14 13:00:00+02:00,1028,56,972,22.446317894676316,1016,59,957,18.268621485072682,22,1013,0.0,12
2020-08-14 14:00:00+02:00,1028,56,972,22.446317894676316,1016,59,957,18.268621485072682,22,1013,0.0,12
2020-08-14 15:00:00+02:00,1131,61,1070,19.719161854583163,1072,70,1002,19.84126315682822,22,1013,0.0,12
2020-08-14 16:00:00+02:00,1221,74,1147,20.289255545925798,1286,83,1203,17.188403238748414,22,1013,0.0,12
2020-08-14 17:00:00+02:00,1791,116,1675,22.14170702920631,1658,90,1568,20.820234148739466,22,1013,0.0,12
2020-08-14 18:00:00+02:00,1822,116,1706,21.99997707726524,1803,111,1692,18.85870627515355,22,1013,0.0,12
2020-08-14 19:00:00+02:00,1388,89,1299,20.3853165959561,1345,69,1276,17.670555033748876,22,1013,0.0,12
2020-08-14 20:00:00+02:00,1335,85,1250,23.56963182820281,1310,84,1226,18.96116747760953,22,1013,0.0,12
2020-08-14 21:00:00+02:00,1056,66,990,20.345707944337423,1078,67,1011,22.163831638084048,22,1013,0.0,12
2020-08-14 22:00:00+02:00,728,44,684,18.762401425442647,709,45,664,17.04052905942483,22,1013,0.0,12
2020-08-14 23:00:00+02:00,529,34,495,18.35398907738163,495,31,464,16.391068433143204,22,1013,0.0,12
2020-08-15 00:00:00+02:00,364,13,351,18.762095160533544,397,14,383,18.899886787636014,25,1015,0.0,9
2020-08-15 01:00:00+02:00,252,10,242,19.382112712433184,263,8,255,19.66899610333254,25,1015,0.0,9
2020-08-15 02:00:00+02:00,245,8,237,18.942695865735725,263,8,255,19.66899610333254,25,1015,0.0,9
2020-08-15 03:00:00+02:00,367,13,354,20.910500334719835,397,14,383,18.899886787636014,25,1015,0.0,9
2020-08-15 04:00:00+02:00,509,20,489,16.304056037448426,516,17,499,19.255137248062134,25,1015,0.0,9
2020-08-15 05:00:00+02:00,617,22,595,20.27053160664296,661,20,641,15.511475011107802,25,1015,0.0,9
2020-08-15 06:00:00+02:00,977,34,943,21.09446061040559,1051,32,1019,16.528120732008574,25,1015,0.0,9
2020-08-15 07:00:00+02:00,1512,61,1451,19.085684764322693,1564,58,1506,24.26240036720556,25,1015,0.0,9
2020-08-15 08:00:00+02:00,2051,78,1973,15.816852253590913,2100,68,2032,16.889119558100358,25,1015,0.0,9
2020-08-15 09:00:00+02:00,2111,82,2029,20.06838825555893,2215,85,2130,21.40726159005658,25,1015,0.0,9
2020-08-15 10:00:00+02:00,1910,71,1839,19.786449902487625,1951,67,1884,19.654078790399655,25,1015,0.0,9
2020-08-15 11:00:00+02:00,1464,50,1414,18.377312079929357,1587,48,1539,18.3049249197236,25,1015,0.0,9
2020-08-15 12:00:00+02:00,1475,53,1422,19.31515325219891,1561,48,1513,17.526377982488057,25,1015,0.0,9
2020-08-15 13:00:00+02:00,1676,67,1609,17.67444267943892,1706,68,1638,17.663016162245842,25,1015,0.0,9
2020-08-15 14:00:00+02:00,1501,58,1443,16.23867527691484,1557,58,1499,21.190133610430877,25,1015,0.0,9
2020-08-15 15:00:00+02:00,1802,68,1734,17.80551395233518,1862,72,1790,18.78576165719149,25,1015,0.0,9
2020-08-15 16:00:00+02:00,1750,59,1691,21.43304636663496,1847,56,1791,20.516356104558866,25,1015,0.0,9
2020-08-15 17:00:00+02:00,2062,76,1986,19.710680688616748,2092,65,2027,18.323270663359995,25,1015,0.0,9
2020-08-15 18:00:00+02:00,1839,63,1776,17.803626193122792,1951,68,1883,19.654078790399655,25,1015,0.0,9
2020-08-15 19:00:00+02:00,1464,50,1414,18.377312079929357,1587,48,1539,18.3049249197236,25,1015,0.0,9
2020-08-15 20:00:00+02:00,1352,49,1303,17.123433878157478,1449,55,1394,20.628658786740132,25,1015,0.0,9
2020-08-15 21:00:00+02:00,1211,49,1162,16.37589950643026,1312,46,1266,22.703905375496692,25,1015,0.0,9
2020-08-15 22:00:00+02:00,973,33,940,18.048607286827366,1051,32,1019,16.528120732008574,25,1015,0.0,9
2020-08-15 23:00:00+02:00,501,20,481,19.86221880757666,524,20,504,16.344948794567816,25,1015,0.0,9
2020-08-16 00:00:00+02:00,210,4,206,18.51819170469006,229,5,224,16.73127952934685,26,1013,0.0,9
2020-08-16 01:00:00+02:00,145,3,142,17.178859914201208,145,3,142,17.178859914201208,26,1013,0.0,9
2020-08-16 02:00:00+02:00,137,3,134,15.841239687070441,202,4,198,12.370131654196136,26,1013,0.0,9
2020-08-16 03:00:00+02:00,206,4,202,18.430249728400767,259,5,254,19.654896199931585,26,1013,0.0,9
2020-08-16 04:00:00+02:00,297,7,290,16.18377682767148,393,9,384,15.564531738870263,26,1013,0.0,9
2020-08-16 05:00:00+02:00,347,8,339,16.954050024728947,469,9,460,20.392863614223188,26,1013,0.0,9
2020-08-16 06:00:00+02:00,588,14,574,18.925346458803528,794,19,775,25.847011005588996,26,1013,0.0,9
2020-08-16 07:00:00+02:00,871,20,851,22.09873172304356,1020,22,998,22.730297734726403,26,1013,0.0,9
2020-08-16 08:00:00+02:00,1180,27,1153,17.167075407056345,1509,32,1477,20.113812245287612,26,1013,0.0,9
2020-08-16 09:00:00+02:00,1222,27,1195,20.20147059901282,1742,36,1706,22.781872353023072,26,1013,0.0,9
2020-08-16 10:00:00+02:00,1069,24,1045,22.620724783815188,1402,30,1372,18.70278064369957,26,1013,0.0,9
2020-08-16 11:00:00+02:00,924,23,901,18.80632590176873,1199,23,1176,17.657020025781453,26,1013,0.0,9
2020-08-16 12:00:00+02:00,874,18,856,18.858041494445132,1138,22,1116,21.901511126969698,26,1013,0.0,9
2020-08-16 13:00:00+02:00,958,22,936,21.538568249751293,1176,25,1151,20.01278424492512,26,1013,0.0,9
2020-08-16 14:00:00+02:00,855,20,835,19.823586839849877,939,20,919,14.785135718404062,26,1013,0.0,9
2020-08-16 15:00:00+02:00,1058,27,1031,22.52865291573114,1417,30,1387,23.536604681410324,26,1013,0.0,9
2020-08-16 16:00:00+02:00,1069,23,1046,22.620724783815188,1310,28,1282,21.153490999216118,26,1013,0.0,9
2020-08-16 17:00:00+02:00,1153,28,1125,21.354421927836945,1195,28,1167,22.36009463647494,26,1013,0.0,9
2020-08-16 18:00:00+02:00,1062,23,1039,21.584150731479806,1352,30,1322,17.123433878157478,26,1013,0.0,9
2020-08-16 19:00:00+02:00,874,22,852,18.858041494445132,1138,22,1116,21.901511126969698,26,1013,0.0,9
2020-08-16 20:00:00+02:00,809,19,790,19.950384445429144,1088,24,1064,21.732778477484317,26,1013,0.0,9
2020-08-16 21:00:00+02:00,722,17,705,20.37966137086952,916,18,898,17.288363105362446,26,1013,0.0,9
2020-08-16 22:00:00+02:00,576,14,562,15.596893013693986,676,14,662,20.358556100397674,26,1013,0.0,9
2020-08-16 23:00:00+02:00,275,6,269,17.667184644222043,401,10,391,18.847767174104906,26,1013,0.0,9
2020-08-17 00:00:00+02:00,285,18,267,18.902660914640844,288,16,272,15.208482117639065,22,1010,0.0,15
2020-08-17 01:00:00+02:00,184,10,174,12.292667221027513,190,12,178,15.19291553207947,22,1010,0.0,15
2020-08-17 02:00:00+02:00,198,11,187,16.988362462756626,195,11,184,17.033571067166147,22,1010,0.0,15
2020-08-17 03:00:00+02:00,299,19,280,17.916061047290665,288,19,269,15.208482117639065,22,1010,0.0,15
2020-08-17 04:00:00+02:00,464,26,438,17.998209325652255,500,29,471,17.899939374975602,22,1010,0.0,15
2020-08-17 05:00:00+02:00,889,58,831,20.678606294909446,900,64,836,19.99135410158291,22,1010,0.0,15
2020-08-17 06:00:00+02:00,1040,68,972,19.386470270605383,1054,62,992,18.797788403647242,22,1010,0.0,15
2020-08-17 07:00:00+02:00,1677,104,1573,16.379472773097593,1607,93,1514,23.53753795116656,22,1010,0.0,15
2020-08-17 08:00:00+02:00,1669,105,1564,22.852690749490932,1711,104,1607,23.78846361744334,22,1010,0.0,15
2020-08-17 09:00:00+02:00,1157,73,1084,19.17268370741797,1138,78,1060,19.4451519943098,22,1010,0.0,15
2020-08-17 10:00:00+02:00,989,57,932,18.706822549594804,953,58,895,17.33503915526209,22,1010,0.0,15
2020-08-17 11:00:00+02:00,1205,68,1137,18.009034178417348,1171,87,1084,21.577763426638608,22,1010,0.0,15
2020-08-17 12:00:00+02:00,981,53,928,21.628318172900137,984,73,911,20.72887876240093,22,1010,0.0,15
2020-08-17 13:00:00+02:00,989,57,932,18.706822549594804,953,58,895,17.33503915526209,22,1010,0.0,15
2020-08-17 14:00:00+02:00,1003,56,947,12.263106650544199,947,63,884,17.116854142767842,22,1010,0.0,15
2020-08-17 15:00:00+02:00,1015,63,952,18.66521485179495,1059,75,984,17.243708720097658,22,1010,0.0,15
2020-08-17 16:00:00+02:00,1180,76,1104,20.393737689339545,1154,74,1080,21.755362743899802,22,1010,0.0,15
2020-08-17 17:00:00+02:00,1619,92,1527,19.227465284449963,1638,117,1521,20.197490769794804,22,1010,0.0,15
2020-08-17 18:00:00+02:00,1800,112,1688,18.70378284776037,1789,132,1657,18.643196383738413,22,1010,0.0,15
2020-08-17 19:00:00+02:00,1216,66,1150,15.750972665880825,1227,80,1147,18.173584517901066,22,1010,0.0,15
2020-08-17 20:00:00+02:00,1208,74,1134,20.536356751139678,1241,93,1148,19.216482016512472,22,1010,0.0,15
2020-08-17 21:00:00+02:00,998,56,942,19.40151342158681,992,59,933,15.296581905329582,22,1010,0.0,15
2020-08-17 22:00:00+02:00,659,36,623,20.86989438299481,693,46,647,21.469669783705342,22,1010,0.0,15
2020-08-17 23:00:00+02:00,458,26,432,16.012859161215747,489,31,458,14.32068527140049,22,1010,0.0,15
2020-08-18 00:00:00+02:00,340,18,322,18.59482979319313,364,24,340,18.504116434485987,23,1012,0.0,10
2020-08-18 01:00:00+02:00,228,11,217,19.20243901718648,238,14,224,17.10199423111376,23,1012,0.0,10
2020-08-18 02:00:00+02:00,231,12,219,23.040251819935676,231,12,219,23.040251819935676,23,1012,0.0,10
2020-08-18 03:00:00+02:00,316,16,300,20.62407905935427,350,18,332,18.120899273422324,23,1012,0.0,10
2020-08-18 04:00:00+02:00,537,29,508,14.987091383273496,595,33,562,19.26058236025398,23,1012,0.0,10
2020-08-18 05:00:00+02:00,1044,55,989,20.338723776906686,1119,68,1051,19.363646327014123,23,1012,0.0,10
2020-08-18 06:00:00+02:00,1283,63,1220,18.85306447998401,1361,71,1290,23.034870998940253,23,1012,0.0,10
2020-08-18 07:00:00+02:00,1963,104,1859,19.522176711194096,2045,109,1936,24.6886841230072,23,1012,0.0,10
2020-08-18 08:00:00+02:00,2072,106,1966,19.963136673619648,2263,129,2134,20.31841827180673,23,1012,0.0,10
2020-08-18 09:00:00+02:00,1310,75,1235,18.96116747760953,1439,92,1347,26.551600412662243,23,1012,0.0,10
2020-08-18 10:00:00+02:00,1038,57,981,19.87537149157779,1259,67,1192,22.449581143024034,23,1012,0.0,10
2020-08-18 11:00:00+02:00,1347,72,1275,22.904669914192432,1398,91,1307,19.27363515097152,23,1012,0.0,10
2020-08-18 12:00:00+02:00,1116,60,1056,16.293044690950076,1238,66,1172,21.59972439582209,23,1012,0.0,10
2020-08-18 13:00:00+02:00,1181,60,1121,16.41109994350771,1194,81,1113,19.735405768215895,23,1012,0.0,10
2020-08-18 14:00:00+02:00,1089,58,1031,17.859501126001717,1245,76,1169,16.39692855366147,23,1012,0.0,10
2020-08-18 15:00:00+02:00,1160,60,1100,22.97410060244509,1269,78,1191,22.241781814956735,23,1012,0.0,10
2020-08-18 16:00:00+02:00,1351,77,1274,22.367973119312673,1473,88,1385,23.12909862865351,23,1012,0.0,10
2020-08-18 17:00:00+02:00,1885,108,1777,20.124246861537106,1994,121,1873,21.11232189552062,23,1012,0.0,10
2020-08-18 18:00:00+02:00,1929,107,1822,18.124931830980984,2151,114,2037,20.22998511059656,23,1012,0.0,10
2020-08-18 19:00:00+02:00,1483,87,1396,14.44402502211772,1609,84,1525,19.5178863010264,23,1012,0.0,10
2020-08-18 20:00:00+02:00,1368,69,1299,22.05829459033411,1538,81,1457,19.648070206159485,23,1012,0.0,10
2020-08-18 21:00:00+02:00,1055,57,998,21.824561115679543,1198,81,1117,16.931003304322644,23,1012,0.0,10
2020-08-18 22:00:00+02:00,758,41,717,20.579839951061928,810,54,756,18.257022974603583,23,1012,0.0,10
2020-08-18 23:00:00+02:00,578,31,547,21.623424740806865,626,33,593,17.842135856858388,23,1012,0.0,10
2020-08-19 00:00:00+02:00,359,25,334,21.41163694321985,335,23,312,21.419812345615075,21,1012,0.0,7
2020-08-19 01:00:00+02:00,234,18,216,19.754580108435302,216,14,202,21.273439412003903,21,1012,0.0,7
2020-08-19 02:00:00+02:00,241,19,222,21.076687701702674,227,15,212,19.269071808142694,21,1012,0.0,7
2020-08-19 03:00:00+02:00,352,25,327,20.33829699034963,338,22,316,21.115663704400472,21,1012,0.0,7
2020-08-19 04:00:00+02:00,597,45,552,20.96302352029361,572,33,539,22.464428218647974,21,1012,0.0,7
2020-08-19 05:00:00+02:00,1075,86,989,14.857308963425098,1026,66,960,16.212449823690427,21,1012,0.0,7
2020-08-19 06:00:00+02:00,1323,92,1231,20.823119112266404,1240,77,1163,19.62052929289891,21,1012,0.0,7
2020-08-19 07:00:00+02:00,2022,156,1866,21.327007886009117,2025,126,1899,22.125978752479227,21,1012,0.0,7
2020-08-19 08:00:00+02:00,2144,147,1997,26.135493602250303,2190,155,2035,19.135457928748895,21,1012,0.0,7
2020-08-19 09:00:00+02:00,1449,111,1338,25.087503935958395,1421,91,1330,23.334175431917725,21,1012,0.0,7
2020-08-19 10:00:00+02:00,1208,95,1113,22.481505300867184,1117,72,1045,18.940485450940074,21,1012,0.0,7
2020-08-19 11:00:00+02:00,1446,115,1331,16.005846611675015,1400,90,1310,24.33031118059648,21,1012,0.0,7
2020-08-19 12:00:00+02:00,1180,85,1095,13.393899153064936,1075,68,1007,14.857308963425098,21,1012,0.0,7
2020-08-19 13:00:00+02:00,1198,88,1110,17.951183561571412,1089,67,1022,22.964951071112843,21,1012,0.0,7
2020-08-19 14:00:00+02:00,1191,84,1107,22.108761562398644,1065,70,995,18.682129026592364,21,1012,0.0,7
2020-08-19 15:00:00+02:00,1313,90,1223,22.598551039378805,1184,67,1117,19.553049265064693,21,1012,0.0,7
2020-08-19 16:00:00+02:00,1456,117,1339,14.380559662872496,1313,75,1238,22.598551039378805,21,1012,0.0,7
2020-08-19 17:00:00+02:00,2008,136,1872,19.50916660692301,2043,136,1907,22.91262046096982,21,1012,0.0,7
2020-08-19 18:00:00+02:00,2148,150,1998,18.98687935050268,1984,129,1855,21.821623737404956,21,1012,0.0,7
2020-08-19 19:00:00+02:00,1557,109,1448,19.14187537296079,1460,95,1365,26.030234042931394,21,1012,0.0,7
2020-08-19 20:00:00+02:00,1564,127,1437,20.435127709434173,1386,92,1294,23.794756133444526,21,1012,0.0,7
2020-08-19 21:00:00+02:00,1194,82,1112,22.850349364469974,1110,71,1039,22.159907876740853,21,1012,0.0,7
2020-08-19 22:00:00+02:00,841,61,780,20.63744972669111,782,44,738,18.682847804062455,21,1012,0.0,7
2020-08-19 23:00:00+02:00,597,46,551,20.96302352029361,572,33,539,22.464428218647974,21,1012,0.0,7
2020-08-20 00:00:00+02:00,355,18,337,15.9786287907944,362,34,328,20.127656808136514,27,1005,0.0,10
2020-08-20 01:00:00+02:00,240,11,229,21.48004742484552,259,25,234,22.347082262814325,27,1005,0.0,10
2020-08-20 02:00:00+02:00,251,11,240,18.518613406024617,248,19,229,17.84767155512712,27,1005,0.0,10
2020-08-20 03:00:00+02:00,366,17,349,21.55465930066985,393,33,360,18.9997609120005,27,1005,0.0,10
2020-08-20 04:00:00+02:00,580,31,549,15.515137836649197,610,56,554,21.63574172729095,27,1005,0.0,10
2020-08-20 05:00:00+02:00,1099,54,1045,15.119487672548313,1103,84,1019,17.493552855200125,27,1005,0.0,10
2020-08-20 06:00:00+02:00,1229,61,1168,17.75769720592956,1382,124,1258,18.091503487504237,27,1005,0.0,10
2020-08-20 07:00:00+02:00,2183,106,2077,19.571013231318997,2187,180,2007,17.7574981727593,27,1005,0.0,10
2020-08-20 08:00:00+02:00,2057,92,1965,20.626000037167213,2340,217,2123,21.095673038129476,27,1005,0.0,10
2020-08-20 09:00:00+02:00,1420,75,1345,21.114458824072877,1450,126,1324,17.339243645177806,27,1005,0.0,10
2020-08-20 10:00:00+02:00,1305,59,1246,26.67454229130446,1259,115,1144,22.449581143024034,27,1005,0.0,10
2020-08-20 11:00:00+02:00,1458,72,1386,20.39038776915953,1481,113,1368,20.26656008871154,27,1005,0.0,10
2020-08-20 12:00:00+02:00,1301,68,1233,24.237041966137912,1214,117,1097,17.175141770222666,27,1005,0.0,10
2020-08-20 13:00:00+02:00,1122,55,1067,23.56325102955057,1328,111,1217,24.175628663883305,27,1005,0.0,10
2020-08-20 14:00:00+02:00,1320,70,1250,19.066637162913523,1275,93,1182,21.474560179522392,27,1005,0.0,10
2020-08-20 15:00:00+02:00,1366,72,1294,22.307035171180875,1343,104,1239,17.841384205335434,27,1005,0.0,10
2020-08-20 16:00:00+02:00,1488,76,1412,17.64655247576578,1584,136,1448,22.27636306008054,27,1005,0.0,10
2020-08-20 17:00:00+02:00,1920,101,1819,19.553618097736035,2076,168,1908,19.679554910785434,27,1005,0.0,10
2020-08-20 18:00:00+02:00,2092,101,1991,18.361055322472964,2199,184,2015,17.978258665966436,27,1005,0.0,10
2020-08-20 19:00:00+02:00,1634,77,1557,24.79467348252945,1695,133,1562,20.056706992798528,27,1005,0.0,10
2020-08-20 20:00:00+02:00,1492,68,1424,21.170987982771095,1603,150,1453,15.422700718459073,27,1005,0.0,10
2020-08-20 21:00:00+02:00,1130,53,1077,21.5185605860936,1206,107,1099,22.0833338705889,27,1005,0.0,10
2020-08-20 22:00:00+02:00,843,45,798,22.155591542348155,923,74,849,21.67166554118645,27,1005,0.0,10
2020-08-20 23:00:00+02:00,572,28,544,15.403677008919987,633,55,578,21.13393709392507,27,1005,0.0,10
2020-08-21 00:00:00+02:00,367,23,344,17.587667378831867,378,19,359,19.221564538347636,25,1006,0.0,9
2020-08-21 01:00:00+02:00,241,14,227,21.315195794429545,237,15,222,19.639472056784783,25,1006,0.0,9
2020-08-21 02:00:00+02:00,248,14,234,17.84767155512712,252,14,238,16.53923049831929,25,1006,0.0,9
2020-08-21 03:00:00+02:00,378,21,357,19.221564538347636,352,21,331,19.260282763631587,25,1006,0.0,9
2020-08-21 04:00:00+02:00,622,40,582,20.628711514033206,582,38,544,18.61172350970083,25,1006,0.0,9
2020-08-21 05:00:00+02:00,1105,69,1036,16.415762562135736,1134,77,1057,21.351439587471354,25,1006,0.0,9
2020-08-21 06:00:00+02:00,1390,88,1302,19.910559975296454,1294,73,1221,23.792766810185167,25,1006,0.0,9
2020-08-21 07:00:00+02:00,2176,127,2049,20.775247558630568,2158,133,2025,23.280235175348512,25,1006,0.0,9
2020-08-21 08:00:00+02:00,2247,138,2109,23.612961616100595,2110,124,1986,21.60156522728317,25,1006,0.0,9
2020-08-21 09:00:00+02:00,1494,84,1410,21.45673022818724,1438,94,1344,19.945009162481366,25,1006,0.0,9
2020-08-21 10:00:00+02:00,1212,73,1139,18.133905012156223,1168,69,1099,18.228218574473072,25,1006,0.0,9
2020-08-21 11:00:00+02:00,1461,84,1377,15.85419815283708,1498,87,1411,24.91114641626594,25,1006,0.0,9
2020-08-21 12:00:00+02:00,1253,80,1173,23.71366929311188,1205,78,1127,18.009034178417348,25,1006,0.0,9
2020-08-21 13:00:00+02:00,1253,81,1172,23.71366929311188,1205,78,1127,18.009034178417348,25,1006,0.0,9
2020-08-21 14:00:00+02:00,1253,81,1172,23.71366929311188,1205,78,1127,18.009034178417348,25,1006,0.0,9
2020-08-21 15:00:00+02:00,1379,89,1290,19.297644205260525,1316,87,1229,20.520361642659587,25,1006,0.0,9
2020-08-21 16:00:00+02:00,1490,93,1397,22.309466367572774,1457,94,1363,21.216993499164737,25,1006,0.0,9
2020-08-21 17:00:00+02:00,2187,142,2045,17.7574981727593,2006,102,1904,21.859235474724706,25,1006,0.0,9
2020-08-21 18:00:00+02:00,2254,132,2122,19.754344744978834,2228,132,2096,27.2105523737384,25,1006,0.0,9
2020-08-21 19:00:00+02:00,1583,104,1479,20.05209098389943,1568,87,1481,25.168676057124415,25,1006,0.0,9
2020-08-21 20:00:00+02:00,1672,107,1565,21.415516475330207,1531,84,1447,18.576384733342593,25,1006,0.0,9
2020-08-21 21:00:00+02:00,1208,65,1143,20.536356751139678,1182,80,1102,18.502140622681345,25,1006,0.0,9
2020-08-21 22:00:00+02:00,882,54,828,18.418001455527968,826,54,772,19.451040612230987,25,1006,0.0,9
2020-08-21 23:00:00+02:00,619,33,586,18.57717122163533,585,29,556,19.939414463599903,25,1006,0.0,9
2020-08-22 00:00:00+02:00,230,7,223,18.412524986153088,244,9,235,17.342351354429947,22,1016,0.0,20
2020-08-22 01:00:00+02:00,158,6,152,14.956478606708535,163,6,157,13.093038660981513,22,1016,0.0,20
2020-08-22 02:00:00+02:00,149,5,144,16.487385747228558,163,5,158,13.093038660981513,22,1016,0.0,20
2020-08-22 03:00:00+02:00,225,7,218,15.006444037321533,244,9,235,17.342351354429947,22,1016,0.0,20
2020-08-22 04:00:00+02:00,317,12,305,20.880759813755745,324,11,313,16.783082396921834,22,1016,0.0,20
2020-08-22 05:00:00+02:00,395,16,379,16.372238321812947,409,16,393,15.464491050485762,22,1016,0.0,20
2020-08-22 06:00:00+02:00,610,22,588,24.604995876219537,642,25,617,22.60813179027775,22,1016,0.0,20
2020-08-22 07:00:00+02:00,946,34,912,21.709548346991106,966,37,929,21.06730935688747,22,1016,0.0,20
2020-08-22 08:00:00+02:00,1245,50,1195,18.484032671263748,1321,40,1281,19.258284076157715,22,1016,0.0,20
2020-08-22 09:00:00+02:00,1293,44,1249,20.800435570669922,1374,51,1323,16.39033023011504,22,1016,0.0,20
2020-08-22 10:00:00+02:00,1199,42,1157,17.657020025781453,1222,36,1186,20.20147059901282,22,1016,0.0,20
2020-08-22 11:00:00+02:00,918,35,883,21.123895030889194,985,36,949,19.532159878069237,22,1016,0.0,20
2020-08-22 12:00:00+02:00,932,31,901,20.222689506186526,987,33,954,18.821663371702275,22,1016,0.0,20
2020-08-22 13:00:00+02:00,1031,37,994,22.676689870060383,1063,34,1029,20.815501240228752,22,1016,0.0,20
2020-08-22 14:00:00+02:00,934,35,899,16.840915498818756,969,36,933,20.517773286613668,22,1016,0.0,20
2020-08-22 15:00:00+02:00,1118,43,1075,22.083758732522256,1151,37,1114,22.485107940190495,22,1016,0.0,20
2020-08-22 16:00:00+02:00,1059,40,1019,19.352874321300064,1158,40,1118,22.733186124487545,22,1016,0.0,20
2020-08-22 17:00:00+02:00,1208,43,1165,20.606247534533097,1284,44,1240,22.239230222561787,22,1016,0.0,20
2020-08-22 18:00:00+02:00,1155,43,1112,19.66896715164529,1206,40,1166,22.803359845409663,22,1016,0.0,20
2020-08-22 19:00:00+02:00,911,37,874,18.44446142090579,976,36,940,22.970643698800124,22,1016,0.0,20
2020-08-22 20:00:00+02:00,861,34,827,22.006513788328416,904,34,870,22.44837735593554,22,1016,0.0,20
2020-08-22 21:00:00+02:00,791,27,764,20.730611866978737,814,26,788,23.730070564958115,22,1016,0.0,20
2020-08-22 22:00:00+02:00,619,22,597,22.392667768754887,656,20,636,16.50025171455705,22,1016,0.0,20
2020-08-22 23:00:00+02:00,306,11,295,21.27863543526117,329,11,318,17.300825364354644,22,1016,0.0,20
2020-08-23 00:00:00+02:00,153,3,150,15.924797186195313,171,4,167,17.0432297467077,20,1020,0.1,14
2020-08-23 01:00:00+02:00,98,2,96,12.969802473207528,121,2,119,17.403109650369732,20,1020,0.1,14
2020-08-23 02:00:00+02:00,93,2,91,10.288013164732348,103,2,101,14.170530940300988,20,1020,0.1,14
2020-08-23 03:00:00+02:00,140,3,137,16.45326635481627,207,4,203,17.119838437657844,20,1020,0.1,14
2020-08-23 04:00:00+02:00,205,4,201,16.381911432613446,275,6,269,17.667184644222043,20,1020,0.1,14
2020-08-23 05:00:00+02:00,241,5,236,19.22571527977998,314,7,307,21.942256310548892,20,1020,0.1,14
2020-08-23 06:00:00+02:00,410,9,401,19.263485804042553,417,9,408,17.44588231489179,20,1020,0.1,14
2020-08-23 07:00:00+02:00,594,13,581,17.941579995260316,620,13,607,20.466376878508733,20,1020,0.1,14
2020-08-23 08:00:00+02:00,773,19,754,21.91760806863206,851,16,835,20.4610074410549,20,1020,0.1,14
2020-08-23 09:00:00+02:00,822,18,804,17.294133752554114,939,21,918,14.785135718404062,20,1020,0.1,14
2020-08-23 10:00:00+02:00,768,19,749,18.6530792179708,1007,24,983,21.871276256028683,20,1020,0.1,14
2020-08-23 11:00:00+02:00,594,14,580,17.941579995260316,620,13,607,20.466376878508733,20,1020,0.1,14
2020-08-23 12:00:00+02:00,578,14,564,19.301228217107035,794,17,777,25.847011005588996,20,1020,0.1,14
2020-08-23 13:00:00+02:00,641,15,626,18.26387895250176,835,18,817,22.205043284317806,20,1020,0.1,14
2020-08-23 14:00:00+02:00,602,15,587,22.27358164052891,752,15,737,22.707192944945145,20,1020,0.1,14
2020-08-23 15:00:00+02:00,661,14,647,15.511475011107802,924,22,902,18.80632590176873,20,1020,0.1,14
2020-08-23 16:00:00+02:00,654,14,640,21.789309107530595,825,21,804,11.801472156464916,20,1020,0.1,14
2020-08-23 17:00:00+02:00,833,18,815,20.15216609593774,955,18,937,18.65896835834016,20,1020,0.1,14
2020-08-23 18:00:00+02:00,718,17,701,24.05588713714659,840,20,820,23.203569459234682,20,1020,0.1,14
2020-08-23 19:00:00+02:00,602,15,587,22.27358164052891,752,15,737,22.707192944945145,20,1020,0.1,14
2020-08-23 20:00:00+02:00,519,11,508,15.88960536848539,661,13,648,15.511475011107802,20,1020,0.1,14
2020-08-23 21:00:00+02:00,474,10,464,22.344329515378842,659,16,643,15.898810905326314,20,1020,0.1,14
2020-08-23 22:00:00+02:00,381,8,373,17.794140531290886,539,11,528,17.82246102622206,20,1020,0.1,14
2020-08-23 23:00:00+02:00,197,4,193,18.25433789555192,238,6,232,19.894659489704694,20,1020,0.1,14
2020-08-24 00:00:00+02:00,306,17,289,17.29338931061959,324,23,301,16.73552361007021,20,1019,0.0,10
2020-08-24 01:00:00+02:00,213,12,201,14.733316442006998,219,13,206,16.290372345258966,20,1019,0.0,10
2020-08-24 02:00:00+02:00,204,12,192,16.808951167115225,219,16,203,16.290372345258966,20,1019,0.0,10
2020-08-24 03:00:00+02:00,309,19,290,17.873000534247286,318,19,299,18.935672225662945,20,1019,0.0,10
2020-08-24 04:00:00+02:00,532,32,500,15.246449583032442,526,34,492,17.73939772545267,20,1019,0.0,10
2020-08-24 05:00:00+02:00,912,52,860,18.725325172560677,965,68,897,20.157432077419593,20,1019,0.0,10
2020-08-24 06:00:00+02:00,1123,62,1061,21.738502069676905,1206,78,1128,22.0833338705889,20,1019,0.0,10
2020-08-24 07:00:00+02:00,1779,115,1664,20.111943548997225,1782,135,1647,22.173235621083016,20,1019,0.0,10
2020-08-24 08:00:00+02:00,1866,102,1764,18.335648793912345,1946,133,1813,19.90636949701012,20,1019,0.0,10
2020-08-24 09:00:00+02:00,1253,77,1176,23.71366929311188,1290,93,1197,25.489670886154155,20,1019,0.0,10
2020-08-24 10:00:00+02:00,1080,66,1014,21.601745002603856,1076,71,1005,18.035647421696137,20,1019,0.0,10
2020-08-24 11:00:00+02:00,1250,75,1175,17.894818489236755,1262,77,1185,26.274321185915127,20,1019,0.0,10
2020-08-24 12:00:00+02:00,1083,67,1016,22.992032341734422,1095,77,1018,17.46621028728195,20,1019,0.0,10
2020-08-24 13:00:00+02:00,1107,64,1043,20.03519817978281,1042,70,972,20.364106174402306,20,1019,0.0,10
2020-08-24 14:00:00+02:00,1052,60,992,21.054817810477743,1073,62,1011,21.484259354406472,20,1019,0.0,10
2020-08-24 15:00:00+02:00,1200,69,1131,22.159067323379073,1200,77,1123,22.159067323379073,20,1019,0.0,10
2020-08-24 16:00:00+02:00,1268,74,1194,22.55194486065332,1302,93,1209,26.70885421740732,20,1019,0.0,10
2020-08-24 17:00:00+02:00,1729,112,1617,25.671264635036508,1841,138,1703,22.485516398063204,20,1019,0.0,10
2020-08-24 18:00:00+02:00,1958,113,1845,21.2740800449195,1890,110,1780,12.209871640317717,20,1019,0.0,10
2020-08-24 19:00:00+02:00,1408,87,1321,19.42114709151158,1423,83,1340,20.265320043360127,20,1019,0.0,10
2020-08-24 20:00:00+02:00,1404,91,1313,19.37400373469419,1423,83,1340,20.265320043360127,20,1019,0.0,10
2020-08-24 21:00:00+02:00,1080,70,1010,21.601745002603856,1076,71,1005,18.035647421696137,20,1019,0.0,10
2020-08-24 22:00:00+02:00,727,43,684,22.606507322491233,755,54,701,17.985965335815543,20,1019,0.0,10
2020-08-24 23:00:00+02:00,507,32,475,20.77671352358277,547,39,508,14.942365450642125,20,1019,0.0,10
2020-08-25 00:00:00+02:00,382,20,362,20.125902913903722,425,24,401,17.94960870048977,23,1015,0.0,5
2020-08-25 01:00:00+02:00,253,13,240,18.298344436736624,285,16,269,18.902660914640844,23,1015,0.0,5
2020-08-25 02:00:00+02:00,246,12,234,18.77282817762498,281,18,263,13.335471171698996,23,1015,0.0,5
2020-08-25 03:00:00+02:00,402,21,381,16.843963747651472,429,22,407,15.391905148038742,23,1015,0.0,5
2020-08-25 04:00:00+02:00,632,36,596,18.45454039035094,660,38,622,21.62405031179609,23,1015,0.0,5
2020-08-25 05:00:00+02:00,1222,72,1150,21.983269340118436,1246,83,1163,18.099803844842363,23,1015,0.0,5
2020-08-25 06:00:00+02:00,1371,77,1294,23.341403167475352,1511,101,1410,22.997013109020738,23,1015,0.0,5
2020-08-25 07:00:00+02:00,2039,115,1924,20.980977265087567,2336,134,2202,25.154158253074996,23,1015,0.0,5
2020-08-25 08:00:00+02:00,2132,115,2017,20.95381892140387,2414,141,2273,24.320634003714574,23,1015,0.0,5
2020-08-25 09:00:00+02:00,1457,75,1382,21.216993499164737,1679,113,1566,19.39040202255472,23,1015,0.0,5
2020-08-25 10:00:00+02:00,1269,74,1195,22.241781814956735,1433,94,1339,12.35509249923399,23,1015,0.0,5
2020-08-25 11:00:00+02:00,1566,83,1483,22.908518404779553,1691,106,1585,18.86830482162543,23,1015,0.0,5
2020-08-25 12:00:00+02:00,1246,64,1182,18.099803844842363,1437,78,1359,20.623253754488832,23,1015,0.0,5
2020-08-25 13:00:00+02:00,1191,65,1126,21.350740312613073,1394,89,1305,22.010624469974434,23,1015,0.0,5
2020-08-25 14:00:00+02:00,1336,66,1270,25.100902639753272,1402,81,1321,18.403958105546298,23,1015,0.0,5
2020-08-25 15:00:00+02:00,1492,86,1406,21.170987982771095,1484,97,1387,23.712632715847217,23,1015,0.0,5
2020-08-25 16:00:00+02:00,1527,81,1446,20.692892376837953,1582,81,1501,25.04562375590631,23,1015,0.0,5
2020-08-25 17:00:00+02:00,2039,117,1922,20.980977265087567,2336,134,2202,25.154158253074996,23,1015,0.0,5
2020-08-25 18:00:00+02:00,2132,115,2017,20.95381892140387,2414,141,2273,24.320634003714574,23,1015,0.0,5
2020-08-25 19:00:00+02:00,1578,81,1497,16.158627751635514,1796,111,1685,21.543980740948363,23,1015,0.0,5
2020-08-25 20:00:00+02:00,1543,79,1464,21.617433911160035,1718,116,1602,25.484512494333394,23,1015,0.0,5
2020-08-25 21:00:00+02:00,1312,65,1247,20.423361916225964,1375,88,1287,21.992439773971398,23,1015,0.0,5
2020-08-25 22:00:00+02:00,867,48,819,18.67328566614061,1007,63,944,18.980038691217896,23,1015,0.0,5
2020-08-25 23:00:00+02:00,675,34,641,18.808217183165738,691,45,646,25.568586687639538,23,1015,0.0,5
2020-08-26 00:00:00+02:00,191,14,177,20.658016380524305,196,14,182,20.04912381427717,21,1012,0.0,23
2020-08-26 01:00:00+02:00,130,9,121,15.65660051079879,123,7,116,19.074654696202938,21,1012,0.0,23
2020-08-26 02:00:00+02:00,128,9,119,19.601953989978306,123,7,116,19.074654696202938,21,1012,0.0,23
2020-08-26 03:00:00+02:00,194,15,179,21.593451125557873,194,11,183,21.593451125557873,21,1012,0.0,23
2020-08-26 04:00:00+02:00,327,22,305,17.492932564197055,302,18,284,17.71336274061634,21,1012,0.0,23
2020-08-26 05:00:00+02:00,577,43,534,23.103874122084292,552,39,513,20.92859955221443,21,1012,0.0,23
2020-08-26 06:00:00+02:00,725,56,669,27.6201430329488,717,42,675,21.920103302141136,21,1012,0.0,23
2020-08-26 07:00:00+02:00,1105,76,1029,22.155475610983313,1012,60,952,22.678180476917685,21,1012,0.0,23
2020-08-26 08:00:00+02:00,1158,82,1076,23.268256964600123,1137,84,1053,21.63708091023091,21,1012,0.0,23
2020-08-26 09:00:00+02:00,783,57,726,22.386866745743653,736,52,684,21.05706952478318,21,1012,0.0,23
2020-08-26 10:00:00+02:00,658,49,609,21.97385875439763,605,42,563,20.803493067467333,21,1012,0.0,23
2020-08-26 11:00:00+02:00,776,60,716,20.16450692078572,700,41,659,20.872865652778124,21,1012,0.0,23
2020-08-26 12:00:00+02:00,639,44,595,21.888977134041827,605,39,566,20.803493067467333,21,1012,0.0,23
2020-08-26 13:00:00+02:00,647,50,597,16.63657610205669,577,37,540,23.103874122084292,21,1012,0.0,23
2020-08-26 14:00:00+02:00,647,51,596,16.63657610205669,577,37,540,23.103874122084292,21,1012,0.0,23
2020-08-26 15:00:00+02:00,713,56,657,21.970165024978442,653,48,605,26.227353076284384,21,1012,0.0,23
2020-08-26 16:00:00+02:00,779,60,719,19.3592159217282,738,53,685,25.724184382070998,21,1012,0.0,23
2020-08-26 17:00:00+02:00,1105,86,1019,22.155475610983313,1012,60,952,22.678180476917685,21,1012,0.0,23
2020-08-26 18:00:00+02:00,1158,82,1076,23.268256964600123,1137,84,1053,21.63708091023091,21,1012,0.0,23
2020-08-26 19:00:00+02:00,848,62,786,23.71978789956193,836,48,788,21.975494772407213,21,1012,0.0,23
2020-08-26 20:00:00+02:00,842,61,781,18.43657043535353,789,44,745,26.567435219517467,21,1012,0.0,23
2020-08-26 21:00:00+02:00,653,48,605,26.227353076284384,619,43,576,21.130188595205187,21,1012,0.0,23
2020-08-26 22:00:00+02:00,460,34,426,18.198266997149677,414,28,386,21.211929621647883,21,1012,0.0,23
2020-08-26 23:00:00+02:00,319,23,296,20.382766877627866,302,18,284,17.71336274061634,21,1012,0.0,23
2020-08-27 00:00:00+02:00,329,16,313,19.42296356680245,366,34,332,21.55465930066985,22,1019,0.0,6
2020-08-27 01:00:00+02:00,244,12,232,21.645479919989064,233,18,215,19.131071941994424,22,1019,0.0,6
2020-08-27 02:00:00+02:00,222,10,212,14.063275896744535,244,22,222,21.645479919989064,22,1019,0.0,6
2020-08-27 03:00:00+02:00,333,15,318,20.32010801444679,351,31,320,18.48694136783097,22,1019,0.0,6
2020-08-27 04:00:00+02:00,581,31,550,18.750194352465222,611,49,562,19.31683839381675,22,1019,0.0,6
2020-08-27 05:00:00+02:00,1067,53,1014,21.0880359747088,1130,94,1036,21.5185605860936,22,1019,0.0,6
2020-08-27 06:00:00+02:00,1204,61,1143,17.64162412565009,1396,119,1277,20.85155857030983,22,1019,0.0,6
2020-08-27 07:00:00+02:00,1993,99,1894,16.658001010011095,2097,200,1897,19.889124847908427,22,1019,0.0,6
2020-08-27 08:00:00+02:00,2130,108,2022,23.496442934792448,2286,194,2092,20.94477605860669,22,1019,0.0,6
2020-08-27 09:00:00+02:00,1333,66,1267,19.461439866245428,1419,107,1312,23.634434141638867,22,1019,0.0,6
2020-08-27 10:00:00+02:00,1256,68,1188,18.175892866846603,1241,91,1150,19.216482016512472,22,1019,0.0,6
2020-08-27 11:00:00+02:00,1370,71,1299,23.993456538053017,1444,108,1336,25.04999540340529,22,1019,0.0,6
2020-08-27 12:00:00+02:00,1118,50,1068,20.396371172852078,1267,96,1171,23.660366120522824,22,1019,0.0,6
2020-08-27 13:00:00+02:00,1181,62,1119,16.41109994350771,1218,119,1099,19.134388365817088,22,1019,0.0,6
2020-08-27 14:00:00+02:00,1252,65,1187,17.356682529859306,1267,93,1174,23.660366120522824,22,1019,0.0,6
2020-08-27 15:00:00+02:00,1300,68,1232,20.951800134692427,1348,112,1236,18.91804497978965,22,1019,0.0,6
2020-08-27 16:00:00+02:00,1507,75,1432,20.726010424903183,1407,128,1279,18.22575434727913,22,1019,0.0,6
2020-08-27 17:00:00+02:00,2115,112,2003,18.78627740303048,1982,181,1801,19.457034063715785,22,1019,0.0,6
2020-08-27 18:00:00+02:00,2078,102,1976,23.418614961909313,2156,167,1989,23.02160750040958,22,1019,0.0,6
2020-08-27 19:00:00+02:00,1426,71,1355,24.54156244589326,1570,117,1453,21.07349397341393,22,1019,0.0,6
2020-08-27 20:00:00+02:00,1593,81,1512,17.52532885576255,1589,151,1438,25.969709353154084,22,1019,0.0,6
2020-08-27 21:00:00+02:00,1278,59,1219,23.35114843320693,1237,121,1116,22.006377879515043,22,1019,0.0,6
2020-08-27 22:00:00+02:00,792,37,755,22.719439059347067,818,76,742,23.33586269948024,22,1019,0.0,6
2020-08-27 23:00:00+02:00,581,28,553,18.750194352465222,611,49,562,19.31683839381675,22,1019,0.0,6
2020-08-28 00:00:00+02:00,202,12,190,17.00555627753825,200,12,188,18.990759817446737,20,1007,0.0,21
2020-08-28 01:00:00+02:00,128,8,120,16.4960956019319,132,7,125,17.234839193331982,20,1007,0.0,21
2020-08-28 02:00:00+02:00,136,7,129,16.439997521399615,132,6,126,17.234839193331982,20,1007,0.0,21
2020-08-28 03:00:00+02:00,206,11,195,16.841693952319364,198,13,185,16.988362462756626,20,1007,0.0,21
2020-08-28 04:00:00+02:00,339,18,321,18.816064403360887,341,21,320,13.9787487722985,20,1007,0.0,21
2020-08-28 05:00:00+02:00,598,34,564,13.432273774946989,608,35,573,18.32520001541616,20,1007,0.0,21
2020-08-28 06:00:00+02:00,721,46,675,21.76983382346408,713,45,668,21.194268455583238,20,1007,0.0,21
2020-08-28 07:00:00+02:00,1173,70,1103,17.312671623656808,1064,63,1001,18.91635548375545,20,1007,0.0,21
2020-08-28 08:00:00+02:00,1205,70,1135,18.009034178417348,1167,78,1089,23.64468237403281,20,1007,0.0,21
2020-08-28 09:00:00+02:00,781,45,736,19.40247607837333,803,48,755,12.897437744361985,20,1007,0.0,21
2020-08-28 10:00:00+02:00,670,37,633,17.902259814682342,636,33,603,18.93496792452342,20,1007,0.0,21
2020-08-28 11:00:00+02:00,777,42,735,20.6872420826963,813,46,767,19.274944408821757,20,1007,0.0,21
2020-08-28 12:00:00+02:00,682,40,642,17.36373749431671,626,32,594,17.842135856858388,20,1007,0.0,21
2020-08-28 13:00:00+02:00,680,38,642,23.55416420862656,628,39,589,18.743919548672437,20,1007,0.0,21
2020-08-28 14:00:00+02:00,658,41,617,14.071965962910248,652,38,614,18.509238163555942,20,1007,0.0,21
2020-08-28 15:00:00+02:00,727,42,685,22.606507322491233,713,45,668,21.194268455583238,20,1007,0.0,21
2020-08-28 16:00:00+02:00,828,50,778,21.320795158524785,775,45,730,18.661990926076427,20,1007,0.0,21
2020-08-28 17:00:00+02:00,1152,67,1085,19.60638609290252,1171,79,1092,21.577763426638608,20,1007,0.0,21
2020-08-28 18:00:00+02:00,1165,69,1096,21.38120199398787,1132,64,1068,23.585946753692596,20,1007,0.0,21
2020-08-28 19:00:00+02:00,878,55,823,20.494714851317973,894,56,838,14.785741954233089,20,1007,0.0,21
2020-08-28 20:00:00+02:00,892,56,836,19.50607416454189,848,49,799,19.314911843566403,20,1007,0.0,21
2020-08-28 21:00:00+02:00,670,40,630,17.902259814682342,636,33,603,18.93496792452342,20,1007,0.0,21
2020-08-28 22:00:00+02:00,452,24,428,20.457835069065744,481,30,451,20.97595000651861,20,1007,0.0,21
2020-08-28 23:00:00+02:00,337,20,317,17.267378436340927,343,18,325,17.146295462927593,20,1007,0.0,21
2020-08-29 00:00:00+02:00,246,10,236,16.615281048636945,253,7,246,19.52264004070869,18,1003,0.1,14
2020-08-29 01:00:00+02:00,163,5,158,13.093038660981513,165,5,160,14.512589256942755,18,1003,0.1,14
2020-08-29 02:00:00+02:00,158,5,153,14.956478606708535,168,6,162,15.841993625402548,18,1003,0.1,14
2020-08-29 03:00:00+02:00,246,9,237,16.615281048636945,253,7,246,19.52264004070869,18,1003,0.1,14
2020-08-29 04:00:00+02:00,326,11,315,17.967288523343843,336,10,326,20.26386767051146,18,1003,0.1,14
2020-08-29 05:00:00+02:00,397,14,383,18.899886787636014,421,16,405,20.884695937787182,18,1003,0.1,14
2020-08-29 06:00:00+02:00,632,22,610,17.51146535759236,660,20,640,18.436016339905624,18,1003,0.1,14
2020-08-29 07:00:00+02:00,935,33,902,18.668758346626248,997,37,960,16.242020528589048,18,1003,0.1,14
2020-08-29 08:00:00+02:00,1255,44,1211,22.334656199702454,1342,50,1292,19.117077585661143,18,1003,0.1,14
2020-08-29 09:00:00+02:00,1352,48,1304,17.123433878157478,1425,54,1371,21.783900585360662,18,1003,0.1,14
2020-08-29 10:00:00+02:00,1212,44,1168,18.709435771279466,1255,44,1211,22.334656199702454,18,1003,0.1,14
2020-08-29 11:00:00+02:00,959,37,922,22.562001056425025,1001,31,970,18.944124582717592,18,1003,0.1,14
2020-08-29 12:00:00+02:00,945,38,907,17.463356926366288,997,40,957,16.242020528589048,18,1003,0.1,14
2020-08-29 13:00:00+02:00,1020,36,984,22.730297734726403,1091,37,1054,21.90252181648089,18,1003,0.1,14
2020-08-29 14:00:00+02:00,966,35,931,21.06730935688747,1006,39,967,22.743002231860064,18,1003,0.1,14
2020-08-29 15:00:00+02:00,1106,43,1063,18.591958908839434,1165,39,1126,20.29855231898275,18,1003,0.1,14
2020-08-29 16:00:00+02:00,1084,40,1044,23.482466314161073,1165,43,1122,20.29855231898275,18,1003,0.1,14
2020-08-29 17:00:00+02:00,1238,46,1192,22.054927832412588,1326,43,1283,17.89146889078921,18,1003,0.1,14
2020-08-29 18:00:00+02:00,1215,47,1168,21.82182658903795,1269,50,1219,24.221585495019742,18,1003,0.1,14
2020-08-29 19:00:00+02:00,947,36,911,21.26556544682232,1008,37,971,22.060482319525345,18,1003,0.1,14
2020-08-29 20:00:00+02:00,871,31,840,22.09873172304356,928,31,897,15.369660763920054,18,1003,0.1,14
2020-08-29 21:00:00+02:00,793,29,764,21.63276820090768,838,27,811,16.566158270897766,18,1003,0.1,14
2020-08-29 22:00:00+02:00,641,26,615,18.26387895250176,677,23,654,20.149196952152575,18,1003,0.1,14
2020-08-29 23:00:00+02:00,326,12,314,17.967288523343843,336,10,326,20.26386767051146,18,1003,0.1,14
2020-08-30 00:00:00+02:00,57,2,55,11.247345675463038,77,3,74,11.693765322784895,18,1009,0.0,10
2020-08-30 01:00:00+02:00,40,1,39,6.907029621336792,51,1,50,13.024781207847502,18,1009,0.0,10
2020-08-30 02:00:00+02:00,40,1,39,6.907029621336792,51,1,50,13.024781207847502,18,1009,0.0,10
2020-08-30 03:00:00+02:00,60,2,58,12.98342242386016,77,3,74,11.693765322784895,18,1009,0.0,10
2020-08-30 04:00:00+02:00,83,3,80,9.333357558089729,91,3,88,8.844154374326946,18,1009,0.0,10
2020-08-30 05:00:00+02:00,100,3,97,12.129363492765288,132,5,127,15.82621260035259,18,1009,0.0,10
2020-08-30 06:00:00+02:00,158,6,152,19.40470350916573,175,6,169,18.893708159250245,18,1009,0.0,10
2020-08-30 07:00:00+02:00,247,10,237,19.091366395871336,310,11,299,15.258998808795859,18,1009,0.0,10
2020-08-30 08:00:00+02:00,313,12,301,12.040192542056978,330,13,317,18.864376108789497,18,1009,0.0,10
2020-08-30 09:00:00+02:00,353,13,340,19.24169978578992,445,19,426,21.520045849832552,18,1009,0.0,10
2020-08-30 10:00:00+02:00,310,12,298,15.258998808795859,330,12,318,18.864376108789497,18,1009,0.0,10
2020-08-30 11:00:00+02:00,247,9,238,19.091366395871336,310,11,299,15.258998808795859,18,1009,0.0,10
2020-08-30 12:00:00+02:00,232,9,223,19.09590246733257,287,11,276,13.917461050382924,18,1009,0.0,10
2020-08-30 13:00:00+02:00,267,10,257,24.84759596655304,333,11,322,16.13750958895024,18,1009,0.0,10
2020-08-30 14:00:00+02:00,247,9,238,19.091366395871336,310,11,299,15.258998808795859,18,1009,0.0,10
2020-08-30 15:00:00+02:00,273,11,262,23.139691796211615,350,15,335,19.39294883514927,18,1009,0.0,10
2020-08-30 16:00:00+02:00,275,10,265,20.236154766209,350,15,335,19.39294883514927,18,1009,0.0,10
2020-08-30 17:00:00+02:00,316,12,304,17.068110656006358,434,18,416,21.64946895511234,18,1009,0.0,10
2020-08-30 18:00:00+02:00,296,11,285,18.406113827007673,336,11,325,15.374523455613796,18,1009,0.0,10
2020-08-30 19:00:00+02:00,250,9,241,19.251014174910523,258,9,249,20.847323082118503,18,1009,0.0,10
2020-08-30 20:00:00+02:00,227,9,218,13.349035543905368,273,11,262,23.139691796211615,18,1009,0.0,10
2020-08-30 21:00:00+02:00,201,8,193,21.060930109433922,247,8,239,19.091366395871336,18,1009,0.0,10
2020-08-30 22:00:00+02:00,163,6,157,16.305265165047643,175,6,169,18.893708159250245,18,1009,0.0,10
2020-08-30 23:00:00+02:00,80,3,77,12.9514806028411,106,4,102,19.560878716092326,18,1009,0.0,10
2020-08-31 00:00:00+02:00,71,7,64,15.50461576454985,71,8,63,15.50461576454985,18,1017,0.0,20
2020-08-31 01:00:00+02:00,47,5,42,10.718407092962304,47,4,43,10.718407092962304,18,1017,0.0,20
2020-08-31 02:00:00+02:00,45,4,41,8.16653528554085,47,5,42,10.718407092962304,18,1017,0.0,20
2020-08-31 03:00:00+02:00,69,6,63,19.29595730158091,69,7,62,19.29595730158091,18,1017,0.0,20
2020-08-31 04:00:00+02:00,114,11,103,18.09348958441383,118,14,104,23.272574380346793,18,1017,0.0,20
2020-08-31 05:00:00+02:00,222,21,201,18.77573498601868,210,24,186,16.3212742992447,18,1017,0.0,20
2020-08-31 06:00:00+02:00,265,24,241,24.143057918667047,263,27,236,18.706444640225143,18,1017,0.0,20
2020-08-31 07:00:00+02:00,423,45,378,23.290663678046883,412,51,361,21.450154879298072,18,1017,0.0,20
2020-08-31 08:00:00+02:00,414,40,374,21.211929621647883,446,52,394,22.957333740469338,18,1017,0.0,20
2020-08-31 09:00:00+02:00,280,28,252,25.91177046818179,289,34,255,20.14984129628082,18,1017,0.0,20
2020-08-31 10:00:00+02:00,229,21,208,19.950856030294574,242,24,218,20.990360069331732,18,1017,0.0,20
2020-08-31 11:00:00+02:00,286,28,258,20.398524223626136,295,35,260,20.557446011766526,18,1017,0.0,20
2020-08-31 12:00:00+02:00,233,21,212,20.426009043155588,242,24,218,20.990360069331732,18,1017,0.0,20
2020-08-31 13:00:00+02:00,239,24,215,13.74553452780325,244,30,214,17.108671526861457,18,1017,0.0,20
2020-08-31 14:00:00+02:00,239,24,215,13.74553452780325,244,30,214,17.108671526861457,18,1017,0.0,20
2020-08-31 15:00:00+02:00,261,26,235,21.270868579361668,263,31,232,18.706444640225143,18,1017,0.0,20
2020-08-31 16:00:00+02:00,297,31,266,18.348417493587977,284,27,257,21.60666647068217,18,1017,0.0,20
2020-08-31 17:00:00+02:00,406,36,370,17.471736216533994,419,40,379,22.446709242047174,18,1017,0.0,20
2020-08-31 18:00:00+02:00,436,47,389,21.770703310925605,423,40,383,23.290663678046883,18,1017,0.0,20
2020-08-31 19:00:00+02:00,314,34,280,19.381500590217087,312,30,282,18.640393178431868,18,1017,0.0,20
2020-08-31 20:00:00+02:00,310,29,281,16.921651532922695,312,32,280,18.640393178431868,18,1017,0.0,20
2020-08-31 21:00:00+02:00,239,22,217,13.74553452780325,244,30,214,17.108671526861457,18,1017,0.0,20
2020-08-31 22:00:00+02:00,165,16,149,20.56038540292619,167,20,147,21.39117903937357,18,1017,0.0,20
2020-08-31 23:00:00+02:00,120,11,109,16.69246741071004,122,13,109,20.245567873519157,18,1017,0.0,20
2020-09-01 00:00:00+02:00,110,10,100,16.975871844207738,110,10,100,16.975871844207738,17,1020,0.0,8
2020-09-01 01:00:00+02:00,65,5,60,15.361527134905547,80,8,72,18.237765354324676,17,1020,0.0,8
2020-09-01 02:00:00+02:00,68,5,63,14.701855472363336,80,8,72,18.237765354324676,17,1020,0.0,8
2020-09-01 03:00:00+02:00,104,8,96,11.935148455597123,119,13,106,22.46945513312648,17,1020,0.0,8
2020-09-01 04:00:00+02:00,172,15,157,19.644113972447897,196,22,174,20.04912381427717,17,1020,0.0,8
2020-09-01 05:00:00+02:00,333,31,302,26.7685298712925,348,37,311,20.566317862558048,17,1020,0.0,8
2020-09-01 06:00:00+02:00,384,34,350,23.18758332904822,443,45,398,13.62175880122913,17,1020,0.0,8
2020-09-01 07:00:00+02:00,587,53,534,20.028899672241884,679,69,610,23.086813289974494,17,1020,0.0,8
2020-09-01 08:00:00+02:00,649,63,586,15.80047652296909,670,64,606,16.908196156468264,17,1020,0.0,8
2020-09-01 09:00:00+02:00,446,37,409,22.957333740469338,458,46,412,24.591159780297854,17,1020,0.0,8
2020-09-01 10:00:00+02:00,369,36,333,22.180217499440115,381,38,343,21.060383299923174,17,1020,0.0,8
2020-09-01 11:00:00+02:00,455,41,414,18.957107089369835,461,47,414,24.16987876504356,17,1020,0.0,8
2020-09-01 12:00:00+02:00,381,31,350,21.060383299923174,399,41,358,20.89817652151005,17,1020,0.0,8
2020-09-01 13:00:00+02:00,348,32,316,20.566317862558048,384,38,346,23.18758332904822,17,1020,0.0,8
2020-09-01 14:00:00+02:00,372,36,336,17.388398109436665,390,36,354,23.204029211730827,17,1020,0.0,8
2020-09-01 15:00:00+02:00,381,37,344,21.060383299923174,441,45,396,21.65218956350676,17,1020,0.0,8
2020-09-01 16:00:00+02:00,417,35,382,23.51661645113794,452,44,408,20.424814624877964,17,1020,0.0,8
2020-09-01 17:00:00+02:00,628,55,573,23.275765064849683,682,64,618,24.31583681205499,17,1020,0.0,8
2020-09-01 18:00:00+02:00,685,68,617,22.980275291432218,697,62,635,20.696803893643118,17,1020,0.0,8
2020-09-01 19:00:00+02:00,473,43,430,22.543653481241357,509,49,460,12.20192288247499,17,1020,0.0,8
2020-09-01 20:00:00+02:00,494,41,453,22.10454361750988,515,58,457,22.56064635427968,17,1020,0.0,8
2020-09-01 21:00:00+02:00,375,37,338,22.64494297948435,390,36,354,23.204029211730827,17,1020,0.0,8
2020-09-01 22:00:00+02:00,241,23,218,21.076687701702674,271,27,244,24.814459053724722,17,1020,0.0,8
2020-09-01 23:00:00+02:00,181,15,166,20.051163259817507,193,16,177,21.558071117560736,17,1020,0.0,8
2020-09-02 00:00:00+02:00,106,12,94,16.557953076837858,95,11,84,17.590478556460255,20,1019,0.0,13
2020-09-02 01:00:00+02:00,69,7,62,8.03614801962393,61,6,55,12.120017072784945,20,1019,0.0,13
2020-09-02 02:00:00+02:00,69,8,61,8.03614801962393,61,6,55,12.120017072784945,20,1019,0.0,13
2020-09-02 03:00:00+02:00,103,12,91,12.121956354954024,97,10,87,13.44369084549097,20,1019,0.0,13
2020-09-02 04:00:00+02:00,176,19,157,20.032450650587887,162,16,146,16.65184232996673,20,1019,0.0,13
2020-09-02 05:00:00+02:00,318,40,278,14.187384224905502,296,29,267,17.230558324905093,20,1019,0.0,13
2020-09-02 06:00:00+02:00,385,45,340,22.594345401183464,368,36,332,19.38080111435795,20,1019,0.0,13
2020-09-02 07:00:00+02:00,609,72,537,22.41448022487832,556,65,491,24.52295551948352,20,1019,0.0,13
2020-09-02 08:00:00+02:00,631,79,552,19.989752871263,628,61,567,18.831524381794868,20,1019,0.0,13
2020-09-02 09:00:00+02:00,421,52,369,14.62842676005305,421,49,372,14.62842676005305,20,1019,0.0,13
2020-09-02 10:00:00+02:00,357,46,311,24.97252919374565,335,37,298,22.25380340127623,20,1019,0.0,13
2020-09-02 11:00:00+02:00,421,47,374,14.62842676005305,421,49,372,14.62842676005305,20,1019,0.0,13
2020-09-02 12:00:00+02:00,357,46,311,24.97252919374565,335,37,298,22.25380340127623,20,1019,0.0,13
2020-09-02 13:00:00+02:00,349,39,310,17.290559234581835,346,37,309,21.64813738514888,20,1019,0.0,13
2020-09-02 14:00:00+02:00,354,42,312,23.46295366080014,321,36,285,15.379227791989987,20,1019,0.0,13
2020-09-02 15:00:00+02:00,394,47,347,22.05126282448999,354,35,319,23.46295366080014,20,1019,0.0,13
2020-09-02 16:00:00+02:00,419,53,366,14.863975805015587,421,49,372,14.62842676005305,20,1019,0.0,13
2020-09-02 17:00:00+02:00,609,78,531,22.41448022487832,556,65,491,24.52295551948352,20,1019,0.0,13
2020-09-02 18:00:00+02:00,631,79,552,19.989752871263,628,61,567,18.831524381794868,20,1019,0.0,13
2020-09-02 19:00:00+02:00,455,56,399,18.53849215090982,419,47,372,14.863975805015587,20,1019,0.0,13
2020-09-02 20:00:00+02:00,466,60,406,19.4378602775798,416,47,369,18.869548080226345,20,1019,0.0,13
2020-09-02 21:00:00+02:00,349,47,302,17.290559234581835,346,37,309,21.64813738514888,20,1019,0.0,13
2020-09-02 22:00:00+02:00,248,29,219,22.98129959572143,231,26,205,18.00711943545906,20,1019,0.0,13
2020-09-02 23:00:00+02:00,173,22,151,18.207988535584114,178,17,161,13.537284957794041,20,1019,0.0,13
2020-09-03 00:00:00+02:00,140,11,129,15.331768592489755,133,19,114,22.07413438879217,22,1021,0.0,5
2020-09-03 01:00:00+02:00,91,7,84,13.154481673544206,91,11,80,13.154481673544206,22,1021,0.0,5
2020-09-03 02:00:00+02:00,95,8,87,11.735389228725284,91,12,79,13.154481673544206,22,1021,0.0,5
2020-09-03 03:00:00+02:00,140,12,128,15.331768592489755,133,19,114,22.07413438879217,22,1021,0.0,5
2020-09-03 04:00:00+02:00,236,18,218,19.106111918840778,236,36,200,19.106111918840778,22,1021,0.0,5
2020-09-03 05:00:00+02:00,395,34,361,19.65690968439359,422,58,364,20.257299015157166,22,1021,0.0,5
2020-09-03 06:00:00+02:00,468,42,426,19.71650853762924,498,62,436,21.292954399658242,22,1021,0.0,5
2020-09-03 07:00:00+02:00,742,64,678,22.30845863664502,776,100,676,20.16450692078572,22,1021,0.0,5
2020-09-03 08:00:00+02:00,856,65,791,22.873350706035236,799,115,684,24.543008417981625,22,1021,0.0,5
2020-09-03 09:00:00+02:00,559,43,516,22.603831145806197,548,73,475,21.450998981477422,22,1021,0.0,5
2020-09-03 10:00:00+02:00,483,38,445,21.366599546374843,460,66,394,18.198266997149677,22,1021,0.0,5
2020-09-03 11:00:00+02:00,506,42,464,18.537819376216163,536,76,460,19.543488507279786,22,1021,0.0,5
2020-09-03 12:00:00+02:00,449,37,412,18.601165629732545,456,66,390,14.42236972784694,22,1021,0.0,5
2020-09-03 13:00:00+02:00,472,37,435,21.284214830242632,487,75,412,15.627714583030805,22,1021,0.0,5
2020-09-03 14:00:00+02:00,487,40,447,15.627714583030805,479,70,409,24.037051458292083,22,1021,0.0,5
2020-09-03 15:00:00+02:00,468,39,429,19.71650853762924,498,62,436,21.292954399658242,22,1021,0.0,5
2020-09-03 16:00:00+02:00,521,45,476,19.221358989967857,571,88,483,20.06134321564653,22,1021,0.0,5
2020-09-03 17:00:00+02:00,795,62,733,28.497132539612636,826,118,708,22.664472248020957,22,1021,0.0,5
2020-09-03 18:00:00+02:00,837,67,770,21.759514900649297,833,115,718,17.006735714661623,22,1021,0.0,5
2020-09-03 19:00:00+02:00,620,55,565,18.519972387525783,624,90,534,23.06138109451472,22,1021,0.0,5
2020-09-03 20:00:00+02:00,544,41,503,25.1241889325097,586,81,505,18.247067316767854,22,1021,0.0,5
2020-09-03 21:00:00+02:00,468,36,432,19.71650853762924,453,56,397,18.726095790194968,22,1021,0.0,5
2020-09-03 22:00:00+02:00,331,25,306,18.08059708638437,319,42,277,20.382766877627866,22,1021,0.0,5
2020-09-03 23:00:00+02:00,236,20,216,19.106111918840778,236,36,200,19.106111918840778,22,1021,0.0,5
2020-09-04 00:00:00+02:00,160,16,144,19.89239402952506,155,13,142,19.469409355748308,25,1023,0.0,3
2020-09-04 01:00:00+02:00,103,11,92,12.113442962320551,108,11,97,14.813734676069407,25,1023,0.0,3
2020-09-04 02:00:00+02:00,103,9,94,12.113442962320551,108,11,97,14.813734676069407,25,1023,0.0,3
2020-09-04 03:00:00+02:00,155,14,141,19.469409355748308,151,17,134,19.408157188048275,25,1023,0.0,3
2020-09-04 04:00:00+02:00,268,24,244,16.114987230113258,263,23,240,18.706444640225143,25,1023,0.0,3
2020-09-04 05:00:00+02:00,488,52,436,14.865596092809506,488,50,438,14.865596092809506,25,1023,0.0,3
2020-09-04 06:00:00+02:00,596,60,536,17.72863338968537,575,50,525,21.211821520021783,25,1023,0.0,3
2020-09-04 07:00:00+02:00,938,84,854,14.640917048168077,916,95,821,17.25745951707594,25,1023,0.0,3
2020-09-04 08:00:00+02:00,960,104,856,24.087282033395923,977,107,870,16.198790853490635,25,1023,0.0,3
2020-09-04 09:00:00+02:00,661,62,599,20.04894052105568,644,61,583,21.208715044598513,25,1023,0.0,3
2020-09-04 10:00:00+02:00,553,56,497,21.584774386830425,549,55,494,18.718889066861195,25,1023,0.0,3
2020-09-04 11:00:00+02:00,644,61,583,21.208715044598513,618,67,551,19.55823856061009,25,1023,0.0,3
2020-09-04 12:00:00+02:00,540,51,489,16.578820343867154,540,47,493,16.578820343867154,25,1023,0.0,3
2020-09-04 13:00:00+02:00,540,49,491,16.578820343867154,540,47,493,16.578820343867154,25,1023,0.0,3
2020-09-04 14:00:00+02:00,540,49,491,16.578820343867154,540,47,493,16.578820343867154,25,1023,0.0,3
2020-09-04 15:00:00+02:00,592,54,538,22.180533990256023,566,58,508,17.19426395043967,25,1023,0.0,3
2020-09-04 16:00:00+02:00,657,63,594,15.746859620588204,622,65,557,18.821807206946435,25,1023,0.0,3
2020-09-04 17:00:00+02:00,942,89,853,18.515965441242063,916,95,821,17.25745951707594,25,1023,0.0,3
2020-09-04 18:00:00+02:00,960,104,856,24.087282033395923,977,107,870,16.198790853490635,25,1023,0.0,3
2020-09-04 19:00:00+02:00,717,67,650,21.920103302141136,691,60,631,23.421142464456967,25,1023,0.0,3
2020-09-04 20:00:00+02:00,700,74,626,20.872865652778124,657,58,599,15.746859620588204,25,1023,0.0,3
2020-09-04 21:00:00+02:00,553,58,495,21.584774386830425,549,55,494,18.718889066861195,25,1023,0.0,3
2020-09-04 22:00:00+02:00,376,35,341,15.920759199358614,376,33,343,15.920759199358614,25,1023,0.0,3
2020-09-04 23:00:00+02:00,268,25,243,16.114987230113258,263,23,240,18.706444640225143,25,1023,0.0,3
2020-09-05 00:00:00+02:00,99,6,93,10.313624634117142,104,6,98,18.50502851366146,19,1020,0.0,13
2020-09-05 01:00:00+02:00,64,3,61,8.557251957401023,69,4,65,11.382640456570568,19,1020,0.0,13
2020-09-05 02:00:00+02:00,67,4,63,10.762428640062312,69,4,65,11.382640456570568,19,1020,0.0,13
2020-09-05 03:00:00+02:00,102,6,96,19.007848371684837,102,5,97,19.007848371684837,19,1020,0.0,13
2020-09-05 04:00:00+02:00,129,7,122,12.81298343964759,139,8,131,19.408576933840735,19,1020,0.0,13
2020-09-05 05:00:00+02:00,172,11,161,18.863206387348974,177,8,169,13.959346220493531,19,1020,0.0,13
2020-09-05 06:00:00+02:00,263,15,248,18.06193495748254,279,14,265,20.757341864573803,19,1020,0.0,13
2020-09-05 07:00:00+02:00,398,23,375,15.189044379634549,427,22,405,17.684962245617744,19,1020,0.0,13
2020-09-05 08:00:00+02:00,529,32,497,16.649089834553955,564,29,535,21.848445480580413,19,1020,0.0,13
2020-09-05 09:00:00+02:00,586,34,552,16.81893103683717,602,31,571,17.424831150133677,19,1020,0.0,13
2020-09-05 10:00:00+02:00,513,31,482,19.088102492304294,532,33,499,21.99526994910307,19,1020,0.0,13
2020-09-05 11:00:00+02:00,390,22,368,22.823808870670177,419,24,395,17.376963499336668,19,1020,0.0,13
2020-09-05 12:00:00+02:00,392,25,367,22.18304148250548,419,25,394,17.376963499336668,19,1020,0.0,13
2020-09-05 13:00:00+02:00,425,27,398,17.81110597716838,457,30,427,20.01126294383405,19,1020,0.0,13
2020-09-05 14:00:00+02:00,411,23,388,17.61880175865933,422,27,395,15.562162592523094,19,1020,0.0,13
2020-09-05 15:00:00+02:00,462,26,436,22.520787209725228,495,27,468,17.429821470150856,19,1020,0.0,13
2020-09-05 16:00:00+02:00,476,32,444,20.090041264055532,492,27,465,23.51531207195642,19,1020,0.0,13
2020-09-05 17:00:00+02:00,543,31,512,21.26508543455116,567,31,536,21.02460829557805,19,1020,0.0,13
2020-09-05 18:00:00+02:00,516,30,486,18.189169879710622,538,29,509,19.746681426359476,19,1020,0.0,13
2020-09-05 19:00:00+02:00,411,23,388,17.61880175865933,422,27,395,15.562162592523094,19,1020,0.0,13
2020-09-05 20:00:00+02:00,363,20,343,15.396964962658,387,20,367,20.68470776467254,19,1020,0.0,13
2020-09-05 21:00:00+02:00,344,22,322,19.49330876116528,349,20,329,19.114918279434413,19,1020,0.0,13
2020-09-05 22:00:00+02:00,274,16,258,20.52791870989968,279,15,264,20.757341864573803,19,1020,0.0,13
2020-09-05 23:00:00+02:00,131,7,124,17.703689985975256,137,8,129,15.965917364236809,19,1020,0.0,13
2020-09-06 00:00:00+02:00,56,2,54,11.681432660358455,56,2,54,11.681432660358455,17,1022,0.0,11
2020-09-06 01:00:00+02:00,34,1,33,4.1719622498891535,48,1,47,9.964553643509852,17,1022,0.0,11
2020-09-06 02:00:00+02:00,37,1,36,3.5125252112896685,50,1,49,13.833131991765365,17,1022,0.0,11
2020-09-06 03:00:00+02:00,56,2,54,11.681432660358455,56,2,54,11.681432660358455,17,1022,0.0,11
2020-09-06 04:00:00+02:00,69,2,67,11.382640456570568,101,3,98,14.022694861996197,17,1022,0.0,11
2020-09-06 05:00:00+02:00,96,3,93,10.792244903732447,120,4,116,15.329119598546,17,1022,0.0,11
2020-09-06 06:00:00+02:00,142,5,137,19.57947604189084,206,7,199,20.90053052788098,17,1022,0.0,11
2020-09-06 07:00:00+02:00,219,8,211,18.74397758884313,227,9,218,13.349035543905368,17,1022,0.0,11
2020-09-06 08:00:00+02:00,303,12,291,21.350092399480108,362,13,349,18.876684992305748,17,1022,0.0,11
2020-09-06 09:00:00+02:00,305,13,292,21.145143787586594,383,13,370,21.26625994117601,17,1022,0.0,11
2020-09-06 10:00:00+02:00,292,11,281,17.87884891495493,311,10,301,18.777054340822975,17,1022,0.0,11
2020-09-06 11:00:00+02:00,217,8,209,18.791759657796693,233,8,225,15.034753042734176,17,1022,0.0,11
2020-09-06 12:00:00+02:00,222,8,214,17.594973015311762,260,10,250,14.992506001947714,17,1022,0.0,11
2020-09-06 13:00:00+02:00,252,10,242,19.00138202247206,278,11,267,19.287262138921047,17,1022,0.0,11
2020-09-06 14:00:00+02:00,222,8,214,17.594973015311762,260,10,250,14.992506001947714,17,1022,0.0,11
2020-09-06 15:00:00+02:00,270,11,259,18.31838596155419,300,11,289,22.416712006057992,17,1022,0.0,11
2020-09-06 16:00:00+02:00,252,10,242,19.00138202247206,300,12,288,22.416712006057992,17,1022,0.0,11
2020-09-06 17:00:00+02:00,289,12,277,18.938144972747136,329,11,318,20.177718732958198,17,1022,0.0,11
2020-09-06 18:00:00+02:00,289,10,279,18.938144972747136,311,10,301,18.777054340822975,17,1022,0.0,11
2020-09-06 19:00:00+02:00,217,8,209,18.791759657796693,233,8,225,15.034753042734176,17,1022,0.0,11
2020-09-06 20:00:00+02:00,203,8,195,16.97445579481889,254,8,246,20.69602346457387,17,1022,0.0,11
2020-09-06 21:00:00+02:00,193,8,185,18.376565992281673,203,7,196,16.97445579481889,17,1022,0.0,11
2020-09-06 22:00:00+02:00,150,5,145,19.93003466929675,176,5,171,16.20057962349047,17,1022,0.0,11
2020-09-06 23:00:00+02:00,72,2,70,10.765287360581397,96,4,92,10.792244903732447,17,1022,0.0,11
2020-09-07 00:00:00+02:00,128,11,117,19.601953989978306,125,12,113,23.026828253397017,20,1022,0.0,8
2020-09-07 01:00:00+02:00,82,7,75,16.39179981762634,82,9,73,16.39179981762634,20,1022,0.0,8
2020-09-07 02:00:00+02:00,85,8,77,19.289671453475872,82,9,73,16.39179981762634,20,1022,0.0,8
2020-09-07 03:00:00+02:00,128,13,115,19.601953989978306,125,12,113,23.026828253397017,20,1022,0.0,8
2020-09-07 04:00:00+02:00,207,19,188,21.877297854955202,207,21,186,21.877297854955202,20,1022,0.0,8
2020-09-07 05:00:00+02:00,366,35,331,21.40807985369936,379,48,331,18.713391269845218,20,1022,0.0,8
2020-09-07 06:00:00+02:00,471,47,424,24.71489709392721,458,44,414,24.591159780297854,20,1022,0.0,8
2020-09-07 07:00:00+02:00,745,80,665,24.741896667257816,705,76,629,27.972959296472958,20,1022,0.0,8
2020-09-07 08:00:00+02:00,771,69,702,21.594999300801096,745,73,672,24.741896667257816,20,1022,0.0,8
2020-09-07 09:00:00+02:00,484,47,437,17.863314460235074,514,51,463,17.018673574730677,20,1022,0.0,8
2020-09-07 10:00:00+02:00,418,42,376,19.740254716385955,425,53,372,20.977086023346995,20,1022,0.0,8
2020-09-07 11:00:00+02:00,504,49,455,17.785796251967053,507,56,451,20.732028813124888,20,1022,0.0,8
2020-09-07 12:00:00+02:00,402,40,362,17.230856788696144,418,49,369,19.740254716385955,20,1022,0.0,8
2020-09-07 13:00:00+02:00,422,45,377,20.257299015157166,415,51,364,23.376361640310524,20,1022,0.0,8
2020-09-07 14:00:00+02:00,428,45,383,17.985011931135546,418,41,377,19.740254716385955,20,1022,0.0,8
2020-09-07 15:00:00+02:00,464,50,414,21.884111394069308,478,47,431,19.93054974447541,20,1022,0.0,8
2020-09-07 16:00:00+02:00,507,49,458,20.732028813124888,524,50,474,19.821110984782088,20,1022,0.0,8
2020-09-07 17:00:00+02:00,708,75,633,23.057413052758587,705,72,633,27.972959296472958,20,1022,0.0,8
2020-09-07 18:00:00+02:00,771,69,702,21.594999300801096,745,73,672,24.741896667257816,20,1022,0.0,8
2020-09-07 19:00:00+02:00,524,51,473,19.821110984782088,570,58,512,25.11924504296083,20,1022,0.0,8
2020-09-07 20:00:00+02:00,537,51,486,17.709537334724534,557,55,502,19.98095345665478,20,1022,0.0,8
2020-09-07 21:00:00+02:00,422,41,381,20.257299015157166,415,51,364,23.376361640310524,20,1022,0.0,8
2020-09-07 22:00:00+02:00,300,32,268,19.621479548992166,290,32,258,18.088844908617002,20,1022,0.0,8
2020-09-07 23:00:00+02:00,207,21,186,21.877297854955202,207,21,186,21.877297854955202,20,1022,0.0,8
2020-09-08 00:00:00+02:00,133,11,122,22.07413438879217,148,14,134,18.058884943386857,22,1027,0.0,4
2020-09-08 01:00:00+02:00,97,9,88,11.610310166035164,101,9,92,11.280950715811313,22,1027,0.0,4
2020-09-08 02:00:00+02:00,93,8,85,12.914854269394333,97,8,89,11.610310166035164,22,1027,0.0,4
2020-09-08 03:00:00+02:00,136,11,125,16.594078125250377,156,15,141,23.175119746499636,22,1027,0.0,4
2020-09-08 04:00:00+02:00,223,22,201,21.320656431140716,246,23,223,17.57126233227549,22,1027,0.0,4
2020-09-08 05:00:00+02:00,414,39,375,21.211929621647883,446,43,403,22.957333740469338,22,1027,0.0,4
2020-09-08 06:00:00+02:00,496,45,451,19.543873703625547,563,59,504,20.337981892053655,22,1027,0.0,4
2020-09-08 07:00:00+02:00,786,69,717,22.007217782245615,864,91,773,24.209267295838718,22,1027,0.0,4
2020-09-08 08:00:00+02:00,872,86,786,20.385974334603535,954,93,861,19.940202369040847,22,1027,0.0,4
2020-09-08 09:00:00+02:00,536,51,485,19.543488507279786,629,63,566,19.562414399045025,22,1027,0.0,4
2020-09-08 10:00:00+02:00,442,36,406,20.352399635415985,504,45,459,17.785796251967053,22,1027,0.0,4
2020-09-08 11:00:00+02:00,563,51,512,20.337981892053655,610,58,552,19.929525822534373,22,1027,0.0,4
2020-09-08 12:00:00+02:00,489,43,446,13.901530333723658,524,53,471,19.821110984782088,22,1027,0.0,4
2020-09-08 13:00:00+02:00,504,43,461,17.785796251967053,516,52,464,23.45871840478751,22,1027,0.0,4
2020-09-08 14:00:00+02:00,489,40,449,13.901530333723658,524,53,471,19.821110984782088,22,1027,0.0,4
2020-09-08 15:00:00+02:00,555,48,507,17.57269749774077,583,61,522,17.990582160320795,22,1027,0.0,4
2020-09-08 16:00:00+02:00,571,52,519,20.06134321564653,610,67,543,19.929525822534373,22,1027,0.0,4
2020-09-08 17:00:00+02:00,833,74,759,17.006735714661623,864,83,781,24.209267295838718,22,1027,0.0,4
2020-09-08 18:00:00+02:00,872,86,786,20.385974334603535,954,93,861,19.940202369040847,22,1027,0.0,4
2020-09-08 19:00:00+02:00,583,55,528,17.990582160320795,680,69,611,18.823295675144326,22,1027,0.0,4
2020-09-08 20:00:00+02:00,618,60,558,19.55823856061009,676,62,614,24.363753137515978,22,1027,0.0,4
2020-09-08 21:00:00+02:00,473,43,430,22.543653481241357,512,50,462,24.456321505157344,22,1027,0.0,4
2020-09-08 22:00:00+02:00,348,28,320,20.566317862558048,352,35,317,20.33829699034963,22,1027,0.0,4
2020-09-08 23:00:00+02:00,226,20,206,20.308697708911414,246,23,223,17.57126233227549,22,1027,0.0,4
2020-09-09 00:00:00+02:00,148,19,129,16.32552078684666,148,16,132,16.32552078684666,23,1026,0.0,4
2020-09-09 01:00:00+02:00,100,12,88,17.894290172585407,88,9,79,14.606173107577572,23,1026,0.0,4
2020-09-09 02:00:00+02:00,100,12,88,17.894290172585407,88,9,79,14.606173107577572,23,1026,0.0,4
2020-09-09 03:00:00+02:00,148,19,129,16.32552078684666,148,16,132,16.32552078684666,23,1026,0.0,4
2020-09-09 04:00:00+02:00,257,31,226,23.082421553922877,237,28,209,21.958682170629807,23,1026,0.0,4
2020-09-09 05:00:00+02:00,457,53,404,20.05766811031021,461,46,415,22.135518273089986,23,1026,0.0,4
2020-09-09 06:00:00+02:00,554,72,482,25.596672216234026,534,61,473,12.135759298461622,23,1026,0.0,4
2020-09-09 07:00:00+02:00,879,112,767,20.431208490085396,851,84,767,18.517207683695112,23,1026,0.0,4
2020-09-09 08:00:00+02:00,931,113,818,18.26571533340233,915,94,821,19.110126712991114,23,1026,0.0,4
2020-09-09 09:00:00+02:00,614,80,534,21.415297218291705,602,65,537,18.665297214327193,23,1026,0.0,4
2020-09-09 10:00:00+02:00,506,60,446,19.419273749095993,478,56,422,23.9297705740146,23,1026,0.0,4
2020-09-09 11:00:00+02:00,614,74,540,21.415297218291705,602,65,537,18.665297214327193,23,1026,0.0,4
2020-09-09 12:00:00+02:00,506,60,446,19.419273749095993,478,56,422,23.9297705740146,23,1026,0.0,4
2020-09-09 13:00:00+02:00,510,62,448,18.942458099303334,502,57,445,17.102378314033963,23,1026,0.0,4
2020-09-09 14:00:00+02:00,514,66,448,21.274653588569578,498,63,435,21.34062018382874,23,1026,0.0,4
2020-09-09 15:00:00+02:00,562,68,494,25.337764963562588,530,58,472,19.083977996999057,23,1026,0.0,4
2020-09-09 16:00:00+02:00,606,79,527,17.760423192087483,570,55,515,24.288421000074564,23,1026,0.0,4
2020-09-09 17:00:00+02:00,859,105,754,19.314655554509162,831,78,753,24.661136830251476,23,1026,0.0,4
2020-09-09 18:00:00+02:00,927,112,815,25.446082901205706,915,94,821,19.110126712991114,23,1026,0.0,4
2020-09-09 19:00:00+02:00,662,87,575,22.089124583570545,590,74,516,27.085010184648272,23,1026,0.0,4
2020-09-09 20:00:00+02:00,666,87,579,21.837239142201785,630,66,564,18.08859787789587,23,1026,0.0,4
2020-09-09 21:00:00+02:00,506,63,443,19.419273749095993,478,56,422,23.9297705740146,23,1026,0.0,4
2020-09-09 22:00:00+02:00,357,43,314,24.97252919374565,337,38,299,13.20715492745961,23,1026,0.0,4
2020-09-09 23:00:00+02:00,249,28,221,17.9608555538356,232,27,205,24.606618615768106,23,1026,0.0,4
2020-09-10 00:00:00+02:00,112,9,103,14.898852003445265,122,17,105,20.245567873519157,22,1023,0.0,9
2020-09-10 01:00:00+02:00,81,7,74,16.076626545182606,81,11,70,16.076626545182606,22,1023,0.0,9
2020-09-10 02:00:00+02:00,81,6,75,16.076626545182606,81,11,70,16.076626545182606,22,1023,0.0,9
2020-09-10 03:00:00+02:00,122,9,113,20.245567873519157,129,20,109,17.995114557081255,22,1023,0.0,9
2020-09-10 04:00:00+02:00,194,14,180,21.593451125557873,214,27,187,18.560318290748608,22,1023,0.0,9
2020-09-10 05:00:00+02:00,368,30,338,19.722641588533307,368,52,316,19.722641588533307,22,1023,0.0,9
2020-09-10 06:00:00+02:00,415,34,381,23.376361640310524,470,74,396,21.98902238846196,22,1023,0.0,9
2020-09-10 07:00:00+02:00,664,54,610,24.610870329151194,709,115,594,22.92274107245687,22,1023,0.0,9
2020-09-10 08:00:00+02:00,664,57,607,24.610870329151194,749,122,627,21.672063984994253,22,1023,0.0,9
2020-09-10 09:00:00+02:00,497,41,456,23.514377363791095,501,75,426,20.940750692732994,22,1023,0.0,9
2020-09-10 10:00:00+02:00,395,33,362,19.65690968439359,422,58,364,20.257299015157166,22,1023,0.0,9
2020-09-10 11:00:00+02:00,456,41,415,14.42236972784694,494,72,422,22.10454361750988,22,1023,0.0,9
2020-09-10 12:00:00+02:00,398,36,362,15.798181076462747,398,57,341,15.798181076462747,22,1023,0.0,9
2020-09-10 13:00:00+02:00,371,31,340,20.767700865402965,412,55,357,21.450154879298072,22,1023,0.0,9
2020-09-10 14:00:00+02:00,415,35,380,23.376361640310524,429,67,362,21.355504409446556,22,1023,0.0,9
2020-09-10 15:00:00+02:00,480,37,443,21.905802263169644,467,64,403,22.874976747697783,22,1023,0.0,9
2020-09-10 16:00:00+02:00,453,34,419,18.726095790194968,494,72,422,22.10454361750988,22,1023,0.0,9
2020-09-10 17:00:00+02:00,674,61,613,19.944091763626055,743,110,633,24.268538123315878,22,1023,0.0,9
2020-09-10 18:00:00+02:00,702,61,641,17.538529369117686,770,115,655,23.82133488848587,22,1023,0.0,9
2020-09-10 19:00:00+02:00,565,47,518,17.51797887308028,545,82,463,19.63111833719715,22,1023,0.0,9
2020-09-10 20:00:00+02:00,480,37,443,21.905802263169644,552,76,476,20.92859955221443,22,1023,0.0,9
2020-09-10 21:00:00+02:00,405,34,371,18.172278090342537,402,65,337,17.230856788696144,22,1023,0.0,9
2020-09-10 22:00:00+02:00,269,23,246,17.49919499982951,289,36,253,20.14984129628082,22,1023,0.0,9
2020-09-10 23:00:00+02:00,204,15,189,12.517560993101368,201,31,170,22.51450761920508,22,1023,0.0,9
2020-09-11 00:00:00+02:00,133,13,120,22.07413438879217,133,12,121,22.07413438879217,24,1018,0.1,7
2020-09-11 01:00:00+02:00,92,8,84,10.404364071122256,85,7,78,19.289671453475872,24,1018,0.1,7
2020-09-11 02:00:00+02:00,89,8,81,17.562315027840828,89,7,82,17.562315027840828,24,1018,0.1,7
2020-09-11 03:00:00+02:00,137,12,125,18.928795118329443,130,13,117,15.65660051079879,24,1018,0.1,7
2020-09-11 04:00:00+02:00,230,21,209,17.120376816836934,230,20,210,17.120376816836934,24,1018,0.1,7
2020-09-11 05:00:00+02:00,416,38,378,17.117872401421668,393,38,355,19.01393712330975,24,1018,0.1,7
2020-09-11 06:00:00+02:00,497,50,447,23.514377363791095,501,53,448,20.940750692732994,24,1018,0.1,7
2020-09-11 07:00:00+02:00,783,78,705,22.386866745743653,768,81,687,19.17235077337456,24,1018,0.1,7
2020-09-11 08:00:00+02:00,813,88,725,22.527079347661243,846,89,757,21.175201873198624,24,1018,0.1,7
2020-09-11 09:00:00+02:00,572,55,517,22.464428218647974,542,59,483,18.696090470502615,24,1018,0.1,7
2020-09-11 10:00:00+02:00,460,42,418,18.198266997149677,442,45,397,20.352399635415985,24,1018,0.1,7
2020-09-11 11:00:00+02:00,546,51,495,20.84279480803274,527,51,476,18.36347321630945,24,1018,0.1,7
2020-09-11 12:00:00+02:00,479,48,431,24.037051458292083,449,45,404,18.601165629732545,24,1018,0.1,7
2020-09-11 13:00:00+02:00,453,45,408,18.726095790194968,449,45,404,18.601165629732545,24,1018,0.1,7
2020-09-11 14:00:00+02:00,453,45,408,18.726095790194968,449,45,404,18.601165629732545,24,1018,0.1,7
2020-09-11 15:00:00+02:00,497,50,447,23.514377363791095,501,53,448,20.940750692732994,24,1018,0.1,7
2020-09-11 16:00:00+02:00,553,55,498,21.584774386830425,568,57,511,20.442364330592024,24,1018,0.1,7
2020-09-11 17:00:00+02:00,802,77,725,20.084109863752683,757,81,676,25.93158863522369,24,1018,0.1,7
2020-09-11 18:00:00+02:00,809,80,729,20.888496543059407,802,80,722,20.084109863752683,24,1018,0.1,7
2020-09-11 19:00:00+02:00,590,62,528,24.741329330337763,575,59,516,21.211821520021783,24,1018,0.1,7
2020-09-11 20:00:00+02:00,616,55,561,22.224127738373518,579,66,513,20.213676817558014,24,1018,0.1,7
2020-09-11 21:00:00+02:00,471,46,425,24.71489709392721,442,38,404,20.352399635415985,24,1018,0.1,7
2020-09-11 22:00:00+02:00,319,29,290,20.382766877627866,330,36,294,16.43301680059058,24,1018,0.1,7
2020-09-11 23:00:00+02:00,226,21,205,20.308697708911414,219,21,198,21.009686825041197,24,1018,0.1,7
2020-09-12 00:00:00+02:00,114,6,108,16.208309351778738,120,7,113,15.329119598546,21,1016,0.0,11
2020-09-12 01:00:00+02:00,74,4,70,9.886934519670994,80,5,75,12.9514806028411,21,1016,0.0,11
2020-09-12 02:00:00+02:00,77,5,72,11.693765322784895,80,5,75,12.9514806028411,21,1016,0.0,11
2020-09-12 03:00:00+02:00,117,7,110,13.539944397802945,120,7,113,15.329119598546,21,1016,0.0,11
2020-09-12 04:00:00+02:00,148,8,140,21.655119289441767,161,9,152,19.39413115763897,21,1016,0.0,11
2020-09-12 05:00:00+02:00,192,11,181,17.31696395349906,204,12,192,20.27930898180519,21,1016,0.0,11
2020-09-12 06:00:00+02:00,312,19,293,17.101813661047903,328,21,307,18.977288676463566,21,1016,0.0,11
2020-09-12 07:00:00+02:00,473,28,445,14.300214591159298,486,27,459,25.256807440063877,21,1016,0.0,11
2020-09-12 08:00:00+02:00,637,41,596,18.70777261267793,659,40,619,18.083923653758244,21,1016,0.0,11
2020-09-12 09:00:00+02:00,647,38,609,19.90895123424384,678,40,638,20.43985683175368,21,1016,0.0,11
2020-09-12 10:00:00+02:00,597,34,563,17.1525212658891,616,33,583,20.64561882033615,21,1016,0.0,11
2020-09-12 11:00:00+02:00,476,28,448,20.090041264055532,486,27,459,25.256807440063877,21,1016,0.0,11
2020-09-12 12:00:00+02:00,476,31,445,20.090041264055532,486,27,459,25.256807440063877,21,1016,0.0,11
2020-09-12 13:00:00+02:00,517,33,484,16.994238402717986,535,29,506,22.618224109294086,21,1016,0.0,11
2020-09-12 14:00:00+02:00,473,29,444,14.300214591159298,486,27,459,25.256807440063877,21,1016,0.0,11
2020-09-12 15:00:00+02:00,557,36,521,12.160249077344764,563,32,531,20.57076110354256,21,1016,0.0,11
2020-09-12 16:00:00+02:00,554,32,522,14.24598637599239,576,38,538,12.499771352819842,21,1016,0.0,11
2020-09-12 17:00:00+02:00,606,40,566,21.223883053081224,641,38,603,20.968994853354097,21,1016,0.0,11
2020-09-12 18:00:00+02:00,560,34,526,17.86463346985913,613,34,579,17.497047599626537,21,1016,0.0,11
2020-09-12 19:00:00+02:00,455,28,427,20.707907447169188,492,30,462,23.51531207195642,21,1016,0.0,11
2020-09-12 20:00:00+02:00,430,25,405,17.047954055769576,439,22,417,16.88815045240334,21,1016,0.0,11
2020-09-12 21:00:00+02:00,377,23,354,20.61326270709296,405,24,381,16.41142237268212,21,1016,0.0,11
2020-09-12 22:00:00+02:00,315,20,295,17.275310260978717,325,20,305,18.163130994775884,21,1016,0.0,11
2020-09-12 23:00:00+02:00,151,9,142,19.14578123638998,161,8,153,19.39413115763897,21,1016,0.0,11
2020-09-13 00:00:00+02:00,84,3,81,7.6306798135980785,117,3,114,13.539944397802945,27,1024,0.0,8
2020-09-13 01:00:00+02:00,56,2,54,11.681432660358455,56,2,54,11.681432660358455,27,1024,0.0,8
2020-09-13 02:00:00+02:00,52,2,50,14.472017643602554,72,3,69,10.765287360581397,27,1024,0.0,8
2020-09-13 03:00:00+02:00,84,3,81,7.6306798135980785,117,3,114,13.539944397802945,27,1024,0.0,8
2020-09-13 04:00:00+02:00,113,4,109,20.97275705288615,129,4,125,12.81298343964759,27,1024,0.0,8
2020-09-13 05:00:00+02:00,141,5,136,17.007652233540448,193,7,186,18.376565992281673,27,1024,0.0,8
2020-09-13 06:00:00+02:00,217,8,209,18.791759657796693,234,8,226,18.523045519331724,27,1024,0.0,8
2020-09-13 07:00:00+02:00,335,13,322,21.63506552863301,452,17,435,22.405685364755907,27,1024,0.0,8
2020-09-13 08:00:00+02:00,480,17,463,22.699493069996517,581,23,558,18.321670939409056,27,1024,0.0,8
2020-09-13 09:00:00+02:00,488,19,469,21.564433597573284,605,26,579,16.706179884848982,27,1024,0.0,8
2020-09-13 10:00:00+02:00,407,16,391,18.86836233630375,597,24,573,17.1525212658891,27,1024,0.0,8
2020-09-13 11:00:00+02:00,359,13,346,19.276631617836294,399,17,382,22.11505355738079,27,1024,0.0,8
2020-09-13 12:00:00+02:00,326,14,312,17.62714820570872,431,16,415,19.594917580038825,27,1024,0.0,8
2020-09-13 13:00:00+02:00,347,15,332,19.911580344317716,480,20,460,22.699493069996517,27,1024,0.0,8
2020-09-13 14:00:00+02:00,343,13,330,16.93402466287014,443,19,424,17.374921079246555,27,1024,0.0,8
2020-09-13 15:00:00+02:00,407,15,392,18.86836233630375,557,22,535,12.160249077344764,27,1024,0.0,8
2020-09-13 16:00:00+02:00,387,15,372,20.68470776467254,552,20,532,20.753952450553925,27,1024,0.0,8
2020-09-13 17:00:00+02:00,468,17,451,19.201560947119127,641,25,616,20.968994853354097,27,1024,0.0,8
2020-09-13 18:00:00+02:00,403,15,388,21.627704849822535,464,20,444,21.34229223380193,27,1024,0.0,8
2020-09-13 19:00:00+02:00,347,13,334,19.911580344317716,443,19,424,17.374921079246555,27,1024,0.0,8
2020-09-13 20:00:00+02:00,318,12,306,22.522150292755875,415,17,398,20.29207139621444,27,1024,0.0,8
2020-09-13 21:00:00+02:00,282,12,270,20.995138580232226,326,11,315,17.62714820570872,27,1024,0.0,8
2020-09-13 22:00:00+02:00,230,9,221,16.58682627515864,266,10,256,15.200054248100818,27,1024,0.0,8
2020-09-13 23:00:00+02:00,117,4,113,13.539944397802945,133,5,128,15.567856067550506,27,1024,0.0,8
2020-09-14 00:00:00+02:00,169,16,153,18.567569965901342,165,20,145,20.56038540292619,30,1023,0.0,8
2020-09-14 01:00:00+02:00,108,11,97,14.813734676069407,108,11,97,14.813734676069407,30,1023,0.0,8
2020-09-14 02:00:00+02:00,104,9,95,11.935148455597123,113,14,99,20.093188266697116,30,1023,0.0,8
2020-09-14 03:00:00+02:00,165,16,149,20.56038540292619,165,20,145,20.56038540292619,30,1023,0.0,8
2020-09-14 04:00:00+02:00,274,29,245,20.56786912693606,278,35,243,17.988889489265482,30,1023,0.0,8
2020-09-14 05:00:00+02:00,491,48,443,20.132647487478383,504,57,447,17.785796251967053,30,1023,0.0,8
2020-09-14 06:00:00+02:00,613,61,552,18.08041903389946,626,68,558,19.126469181365696,30,1023,0.0,8
2020-09-14 07:00:00+02:00,905,82,823,26.04340494897988,952,110,842,16.066458742472516,30,1023,0.0,8
2020-09-14 08:00:00+02:00,1035,97,938,15.589258351782167,996,104,892,22.232096850101385,30,1023,0.0,8
2020-09-14 09:00:00+02:00,665,72,593,16.589612733582396,687,79,608,22.327338468557514,30,1023,0.0,8
2020-09-14 10:00:00+02:00,539,49,490,14.75171382469777,561,62,499,19.266161028294455,30,1023,0.0,8
2020-09-14 11:00:00+02:00,691,65,626,23.421142464456967,674,82,592,19.944091763626055,30,1023,0.0,8
2020-09-14 12:00:00+02:00,574,58,516,23.368497533964078,574,54,520,23.368497533964078,30,1023,0.0,8
2020-09-14 13:00:00+02:00,526,56,470,21.343558174072673,548,65,483,21.450998981477422,30,1023,0.0,8
2020-09-14 14:00:00+02:00,552,52,500,20.92859955221443,565,65,500,17.51797887308028,30,1023,0.0,8
2020-09-14 15:00:00+02:00,609,63,546,17.500922035745717,626,68,558,19.126469181365696,30,1023,0.0,8
2020-09-14 16:00:00+02:00,639,58,581,21.888977134041827,661,71,590,20.04894052105568,30,1023,0.0,8
2020-09-14 17:00:00+02:00,952,91,861,16.066458742472516,965,98,867,15.12765321316363,30,1023,0.0,8
2020-09-14 18:00:00+02:00,952,100,852,16.066458742472516,1022,103,919,23.117988941505136,30,1023,0.0,8
2020-09-14 19:00:00+02:00,744,69,675,24.83230914488915,713,72,641,21.970165024978442,30,1023,0.0,8
2020-09-14 20:00:00+02:00,696,74,622,26.69245726125086,709,82,627,22.92274107245687,30,1023,0.0,8
2020-09-14 21:00:00+02:00,526,55,471,21.343558174072673,548,65,483,21.450998981477422,30,1023,0.0,8
2020-09-14 22:00:00+02:00,387,36,351,22.869757461740583,387,48,339,22.869757461740583,30,1023,0.0,8
2020-09-14 23:00:00+02:00,269,29,240,17.49919499982951,274,26,248,20.56786912693606,30,1023,0.0,8
2020-09-15 00:00:00+02:00,152,15,137,20.188330220444417,165,15,150,20.56038540292619,29,1019,0.0,8
2020-09-15 01:00:00+02:00,97,9,88,11.610310166035164,110,10,100,16.975871844207738,29,1019,0.0,8
2020-09-15 02:00:00+02:00,93,8,85,12.914854269394333,106,9,97,12.94750706735717,29,1019,0.0,8
2020-09-15 03:00:00+02:00,156,15,141,23.175119746499636,161,18,143,19.983041252146048,29,1019,0.0,8
2020-09-15 04:00:00+02:00,237,20,217,15.922060682410839,288,32,256,22.858888837585067,29,1019,0.0,8
2020-09-15 05:00:00+02:00,475,39,436,26.73035993542065,509,48,461,12.20192288247499,29,1019,0.0,8
2020-09-15 06:00:00+02:00,598,49,549,20.057049682033714,610,53,557,19.929525822534373,29,1019,0.0,8
2020-09-15 07:00:00+02:00,903,81,822,18.37149569119113,958,89,869,19.15346532293557,29,1019,0.0,8
2020-09-15 08:00:00+02:00,873,83,790,27.880668244208938,979,90,889,12.787255957327325,29,1019,0.0,8
2020-09-15 09:00:00+02:00,627,54,573,19.204908130853333,640,54,586,16.53063246999195,29,1019,0.0,8
2020-09-15 10:00:00+02:00,487,46,441,15.627714583030805,568,58,510,20.442364330592024,29,1019,0.0,8
2020-09-15 11:00:00+02:00,636,55,581,21.66562740120439,670,74,596,16.908196156468264,29,1019,0.0,8
2020-09-15 12:00:00+02:00,530,45,485,19.57875562009149,559,62,497,22.603831145806197,29,1019,0.0,8
2020-09-15 13:00:00+02:00,492,42,450,19.891083729909596,576,56,520,19.54878368039628,29,1019,0.0,8
2020-09-15 14:00:00+02:00,530,47,483,19.57875562009149,559,62,497,22.603831145806197,29,1019,0.0,8
2020-09-15 15:00:00+02:00,538,46,492,22.05606214078663,585,54,531,20.788212486517235,29,1019,0.0,8
2020-09-15 16:00:00+02:00,589,57,532,24.4118965594369,649,66,583,15.80047652296909,29,1019,0.0,8
2020-09-15 17:00:00+02:00,810,71,739,22.708324160653998,903,92,811,18.37149569119113,29,1019,0.0,8
2020-09-15 18:00:00+02:00,920,79,841,17.831951809597363,1035,96,939,15.589258351782167,29,1019,0.0,8
2020-09-15 19:00:00+02:00,644,56,588,21.208715044598513,704,76,628,26.58879619211277,29,1019,0.0,8
2020-09-15 20:00:00+02:00,699,68,631,25.275934758615588,691,61,630,23.421142464456967,29,1019,0.0,8
2020-09-15 21:00:00+02:00,513,49,464,24.12103157612141,534,53,481,22.13831863455401,29,1019,0.0,8
2020-09-15 22:00:00+02:00,339,30,309,21.378284288972047,398,33,365,15.798181076462747,29,1019,0.0,8
2020-09-15 23:00:00+02:00,237,21,216,15.922060682410839,288,32,256,22.858888837585067,29,1019,0.0,8
2020-09-16 00:00:00+02:00,164,18,146,22.782143669494815,151,17,134,19.198981193831877,27,1019,0.0,5
2020-09-16 01:00:00+02:00,108,13,95,15.542504625013809,99,10,89,14.833512798015287,27,1019,0.0,5
2020-09-16 02:00:00+02:00,108,12,96,15.542504625013809,99,10,89,14.833512798015287,27,1019,0.0,5
2020-09-16 03:00:00+02:00,164,18,146,22.782143669494815,151,17,134,19.198981193831877,27,1019,0.0,5
2020-09-16 04:00:00+02:00,277,34,243,22.842683015901265,264,25,239,19.326928751905097,27,1019,0.0,5
2020-09-16 05:00:00+02:00,489,58,431,20.979024543119948,467,50,417,23.392169574456698,27,1019,0.0,5
2020-09-16 06:00:00+02:00,606,72,534,17.760423192087483,563,54,509,22.589818073805013,27,1019,0.0,5
2020-09-16 07:00:00+02:00,931,115,816,18.26571533340233,935,96,839,23.034019705991792,27,1019,0.0,5
2020-09-16 08:00:00+02:00,1000,123,877,20.174292304894557,965,120,845,16.729318642476997,27,1019,0.0,5
2020-09-16 09:00:00+02:00,671,87,584,23.971107131659732,654,75,579,23.571320233127302,27,1019,0.0,5
2020-09-16 10:00:00+02:00,541,68,473,20.362745061624192,537,56,481,15.183293437990013,27,1019,0.0,5
2020-09-16 11:00:00+02:00,658,89,569,15.999136717904042,584,55,529,19.403324970579884,27,1019,0.0,5
2020-09-16 12:00:00+02:00,558,66,492,21.241662475833486,511,49,462,23.46483660517307,27,1019,0.0,5
2020-09-16 13:00:00+02:00,554,75,479,25.596672216234026,524,60,464,20.560147412005747,27,1019,0.0,5
2020-09-16 14:00:00+02:00,554,64,490,25.596672216234026,524,60,464,20.560147412005747,27,1019,0.0,5
2020-09-16 15:00:00+02:00,610,71,539,18.090033192115353,545,68,477,24.889232080242863,27,1019,0.0,5
2020-09-16 16:00:00+02:00,662,77,585,22.089124583570545,589,73,516,16.22308117067377,27,1019,0.0,5
2020-09-16 17:00:00+02:00,922,123,799,25.101905797912824,866,108,758,19.07719176013991,27,1019,0.0,5
2020-09-16 18:00:00+02:00,1004,126,878,13.360072389014173,983,104,879,23.041747034737654,27,1019,0.0,5
2020-09-16 19:00:00+02:00,706,82,624,20.9344607659246,675,65,610,15.477752346599248,27,1019,0.0,5
2020-09-16 20:00:00+02:00,719,92,627,23.182381262698684,641,66,575,20.64294138890802,27,1019,0.0,5
2020-09-16 21:00:00+02:00,545,73,472,24.889232080242863,528,52,476,22.202095855996042,27,1019,0.0,5
2020-09-16 22:00:00+02:00,381,50,331,20.33707664399945,359,37,322,15.903895825886657,27,1019,0.0,5
2020-09-16 23:00:00+02:00,272,33,239,13.314603904224033,268,33,235,19.54671273578713,27,1019,0.0,5
2020-09-17 00:00:00+02:00,95,8,87,11.735389228725284,90,11,79,13.960700117154147,23,1020,0.2,17
2020-09-17 01:00:00+02:00,62,5,57,14.48690450543278,57,7,50,10.480552878481939,23,1020,0.2,17
2020-09-17 02:00:00+02:00,60,4,56,10.583722413773145,57,7,50,10.480552878481939,23,1020,0.2,17
2020-09-17 03:00:00+02:00,90,7,83,13.960700117154147,90,11,79,13.960700117154147,23,1020,0.2,17
2020-09-17 04:00:00+02:00,155,13,142,19.469409355748308,148,23,125,18.058884943386857,23,1020,0.2,17
2020-09-17 05:00:00+02:00,291,25,266,17.50237418524224,273,35,238,23.61851837889036,23,1020,0.2,17
2020-09-17 06:00:00+02:00,323,24,299,19.17862862818099,354,55,299,21.22371738501729,23,1020,0.2,17
2020-09-17 07:00:00+02:00,527,41,486,18.36347321630945,497,67,430,23.514377363791095,23,1020,0.2,17
2020-09-17 08:00:00+02:00,517,44,473,18.94022137532123,539,80,459,14.75171382469777,23,1020,0.2,17
2020-09-17 09:00:00+02:00,354,29,325,21.22371738501729,364,47,317,19.12804198058144,23,1020,0.2,17
2020-09-17 10:00:00+02:00,286,26,260,20.398524223626136,323,50,273,19.17862862818099,23,1020,0.2,17
2020-09-17 11:00:00+02:00,384,32,352,23.18758332904822,384,56,328,23.18758332904822,23,1020,0.2,17
2020-09-17 12:00:00+02:00,318,27,291,21.634505447676812,298,43,255,18.335119688608,23,1020,0.2,17
2020-09-17 13:00:00+02:00,278,21,257,17.988889489265482,303,41,262,15.98015338859148,23,1020,0.2,17
2020-09-17 14:00:00+02:00,281,21,260,17.665733770068634,311,50,261,16.325599187415413,23,1020,0.2,17
2020-09-17 15:00:00+02:00,316,25,291,20.52457281115525,334,42,292,23.256671102053218,23,1020,0.2,17
2020-09-17 16:00:00+02:00,376,30,346,15.920759199358614,374,48,326,18.17629135420491,23,1020,0.2,17
2020-09-17 17:00:00+02:00,489,39,450,13.901530333723658,539,79,460,14.75171382469777,23,1020,0.2,17
2020-09-17 18:00:00+02:00,532,44,488,22.31530989594808,577,77,500,23.103874122084292,23,1020,0.2,17
2020-09-17 19:00:00+02:00,404,31,373,21.094548442403457,386,51,335,18.304254687443294,23,1020,0.2,17
2020-09-17 20:00:00+02:00,391,31,360,20.019115852021912,391,50,341,20.019115852021912,23,1020,0.2,17
2020-09-17 21:00:00+02:00,281,21,260,17.665733770068634,311,50,261,16.325599187415413,23,1020,0.2,17
2020-09-17 22:00:00+02:00,200,16,184,19.256012935412965,208,30,178,17.851758798784658,23,1020,0.2,17
2020-09-17 23:00:00+02:00,145,11,134,18.85528596371164,160,22,138,19.89239402952506,23,1020,0.2,17
2020-09-18 00:00:00+02:00,107,9,98,12.156196464705383,104,11,93,11.935148455597123,23,1021,0.0,15
2020-09-18 01:00:00+02:00,72,7,65,19.53768091870668,72,6,66,19.53768091870668,23,1021,0.0,15
2020-09-18 02:00:00+02:00,72,6,66,19.53768091870668,72,6,66,19.53768091870668,23,1021,0.0,15
2020-09-18 03:00:00+02:00,110,10,100,16.975871844207738,101,9,92,11.280950715811313,23,1021,0.0,15
2020-09-18 04:00:00+02:00,180,18,162,20.970253971133605,183,19,164,16.4856647978058,23,1021,0.0,15
2020-09-18 05:00:00+02:00,317,29,288,23.692514426518255,311,31,280,16.325599187415413,23,1021,0.0,15
2020-09-18 06:00:00+02:00,396,38,358,20.199948477295223,375,37,338,22.64494297948435,23,1021,0.0,15
2020-09-18 07:00:00+02:00,614,58,556,16.05349448397906,588,60,528,15.545784204606317,23,1021,0.0,15
2020-09-18 08:00:00+02:00,672,62,610,20.239222641694617,629,60,569,19.562414399045025,23,1021,0.0,15
2020-09-18 09:00:00+02:00,422,38,384,20.257299015157166,419,47,372,22.446709242047174,23,1021,0.0,15
2020-09-18 10:00:00+02:00,361,39,322,19.1870055662437,355,40,315,23.18890281037911,23,1021,0.0,15
2020-09-18 11:00:00+02:00,445,45,400,19.037524313009598,419,42,377,22.446709242047174,23,1021,0.0,15
2020-09-18 12:00:00+02:00,361,39,322,19.1870055662437,355,40,315,23.18890281037911,23,1021,0.0,15
2020-09-18 13:00:00+02:00,372,38,334,17.388398109436665,358,33,325,18.044939279580262,23,1021,0.0,15
2020-09-18 14:00:00+02:00,358,37,321,18.044939279580262,352,37,315,20.33829699034963,23,1021,0.0,15
2020-09-18 15:00:00+02:00,393,39,354,19.01393712330975,384,38,346,23.18758332904822,23,1021,0.0,15
2020-09-18 16:00:00+02:00,442,48,394,20.352399635415985,422,38,384,20.257299015157166,23,1021,0.0,15
2020-09-18 17:00:00+02:00,605,65,540,20.803493067467333,599,63,536,22.66737383874895,23,1021,0.0,15
2020-09-18 18:00:00+02:00,672,69,603,20.239222641694617,629,60,569,19.562414399045025,23,1021,0.0,15
2020-09-18 19:00:00+02:00,457,41,416,24.393218626777333,486,54,432,18.71988428719074,23,1021,0.0,15
2020-09-18 20:00:00+02:00,477,44,433,19.637502490728593,486,48,438,18.71988428719074,23,1021,0.0,15
2020-09-18 21:00:00+02:00,366,34,332,21.40807985369936,355,40,315,23.18890281037911,23,1021,0.0,15
2020-09-18 22:00:00+02:00,259,26,233,22.988395045636892,241,22,219,21.076687701702674,23,1021,0.0,15
2020-09-18 23:00:00+02:00,177,17,160,20.028957588616944,186,18,168,22.772295906033783,23,1021,0.0,15
2020-09-19 00:00:00+02:00,118,6,112,16.65435568776215,121,6,115,11.617438248542046,24,1014,0.0,14
2020-09-19 01:00:00+02:00,74,4,70,9.886934519670994,80,5,75,12.9514806028411,24,1014,0.0,14
2020-09-19 02:00:00+02:00,77,5,72,11.693765322784895,80,5,75,12.9514806028411,24,1014,0.0,14
2020-09-19 03:00:00+02:00,118,7,111,16.65435568776215,121,6,115,11.617438248542046,24,1014,0.0,14
2020-09-19 04:00:00+02:00,149,8,141,17.937448228249327,161,9,152,19.39413115763897,24,1014,0.0,14
2020-09-19 05:00:00+02:00,192,11,181,17.31696395349906,205,13,192,22.456574383830734,24,1014,0.0,14
2020-09-19 06:00:00+02:00,307,17,290,16.74476305242919,320,20,300,21.84611391715035,24,1014,0.0,14
2020-09-19 07:00:00+02:00,479,32,447,18.854981551601607,488,29,459,21.564433597573284,24,1014,0.0,14
2020-09-19 08:00:00+02:00,622,42,580,12.695140458710284,643,32,611,20.52198944499182,24,1014,0.0,14
2020-09-19 09:00:00+02:00,637,36,601,18.70777261267793,703,43,660,18.81247619491939,24,1014,0.0,14
2020-09-19 10:00:00+02:00,578,37,541,19.016387711485798,612,36,576,14.880406360759972,24,1014,0.0,14
2020-09-19 11:00:00+02:00,469,29,440,17.241075976543623,485,28,457,23.26524199136097,24,1014,0.0,14
2020-09-19 12:00:00+02:00,460,29,431,21.56348705434536,491,30,461,20.639383164942465,24,1014,0.0,14
2020-09-19 13:00:00+02:00,500,32,468,17.53149172402289,535,33,502,22.618224109294086,24,1014,0.0,14
2020-09-19 14:00:00+02:00,475,29,446,22.666846653339356,494,29,465,16.357556690934846,24,1014,0.0,14
2020-09-19 15:00:00+02:00,541,33,508,18.81222066269775,569,34,535,19.424344306636577,24,1014,0.0,14
2020-09-19 16:00:00+02:00,525,35,490,20.014875638820815,575,34,541,15.295280006044948,24,1014,0.0,14
2020-09-19 17:00:00+02:00,640,37,603,19.89133908452712,640,32,608,19.89133908452712,24,1014,0.0,14
2020-09-19 18:00:00+02:00,563,31,532,20.57076110354256,619,33,586,17.744936787964466,24,1014,0.0,14
2020-09-19 19:00:00+02:00,451,25,426,21.269750099500666,482,31,451,21.554128287623442,24,1014,0.0,14
2020-09-19 20:00:00+02:00,429,27,402,19.67571066122959,451,24,427,21.269750099500666,24,1014,0.0,14
2020-09-19 21:00:00+02:00,376,25,351,20.486350839145686,413,24,389,15.570830889271724,24,1014,0.0,14
2020-09-19 22:00:00+02:00,307,20,287,16.74476305242919,320,20,300,21.84611391715035,24,1014,0.0,14
2020-09-19 23:00:00+02:00,158,10,148,19.40470350916573,164,8,156,18.874121315806054,24,1014,0.0,14
2020-09-20 00:00:00+02:00,73,2,71,10.015349835153332,87,3,84,9.504121716770046,23,1014,0.1,8
2020-09-20 01:00:00+02:00,49,1,48,12.126419816698254,66,2,64,9.595877216947136,23,1014,0.1,8
2020-09-20 02:00:00+02:00,45,1,44,8.150223537761923,63,2,61,11.83290839187245,23,1014,0.1,8
2020-09-20 03:00:00+02:00,70,2,68,11.628132043946147,80,3,77,12.9514806028411,23,1014,0.1,8
2020-09-20 04:00:00+02:00,101,4,97,14.022694861996197,133,5,128,15.567856067550506,23,1014,0.1,8
2020-09-20 05:00:00+02:00,126,5,121,13.391954395859463,147,6,141,16.306492316544293,23,1014,0.1,8
2020-09-20 06:00:00+02:00,206,8,198,20.90053052788098,224,8,216,19.039166559272836,23,1014,0.1,8
2020-09-20 07:00:00+02:00,283,11,272,18.945435241048195,340,11,329,14.37984208663957,23,1014,0.1,8
2020-09-20 08:00:00+02:00,375,15,360,21.145699806578275,424,18,406,17.857202021513903,23,1014,0.1,8
2020-09-20 09:00:00+02:00,403,15,388,21.627704849822535,455,19,436,20.707907447169188,23,1014,0.1,8
2020-09-20 10:00:00+02:00,392,16,376,22.18304148250548,427,17,410,17.684962245617744,23,1014,0.1,8
2020-09-20 11:00:00+02:00,290,11,279,19.079826100657762,322,10,312,18.644637808692327,23,1014,0.1,8
2020-09-20 12:00:00+02:00,287,11,276,13.917461050382924,385,14,371,18.20092151022271,23,1014,0.1,8
2020-09-20 13:00:00+02:00,340,14,326,14.37984208663957,333,13,320,16.13750958895024,23,1014,0.1,8
2020-09-20 14:00:00+02:00,301,11,290,20.607812327110423,354,12,342,22.475031570210557,23,1014,0.1,8
2020-09-20 15:00:00+02:00,361,13,348,18.385612781936853,424,14,410,17.857202021513903,23,1014,0.1,8
2020-09-20 16:00:00+02:00,333,13,320,16.13750958895024,459,17,442,24.390364188305586,23,1014,0.1,8
2020-09-20 17:00:00+02:00,410,15,395,17.249472070304,553,22,531,19.32438306591248,23,1014,0.1,8
2020-09-20 18:00:00+02:00,385,16,369,18.20092151022271,382,14,368,19.156893019800307,23,1014,0.1,8
2020-09-20 19:00:00+02:00,311,13,298,18.777054340822975,322,12,310,18.644637808692327,23,1014,0.1,8
2020-09-20 20:00:00+02:00,262,10,252,13.900090096773878,315,10,305,17.275310260978717,23,1014,0.1,8
2020-09-20 21:00:00+02:00,255,10,245,13.80583098758932,326,13,313,17.62714820570872,23,1014,0.1,8
2020-09-20 22:00:00+02:00,199,8,191,19.11274068140836,238,8,230,14.411005913654613,23,1014,0.1,8
2020-09-20 23:00:00+02:00,94,3,91,10.166272350500234,115,4,111,14.522258078721798,23,1014,0.1,8
2020-09-21 00:00:00+02:00,156,14,142,23.175119746499636,152,19,133,20.188330220444417,25,1015,0.1,4
2020-09-21 01:00:00+02:00,102,9,93,13.093305626972347,107,10,97,12.156196464705383,25,1015,0.1,4
2020-09-21 02:00:00+02:00,102,11,91,13.093305626972347,107,10,97,12.156196464705383,25,1015,0.1,4
2020-09-21 03:00:00+02:00,152,16,136,20.188330220444417,156,15,141,23.175119746499636,25,1015,0.1,4
2020-09-21 04:00:00+02:00,251,27,224,19.570183352800104,263,31,232,18.706444640225143,25,1015,0.1,4
2020-09-21 05:00:00+02:00,489,52,437,13.901530333723658,477,54,423,19.637502490728593,25,1015,0.1,4
2020-09-21 06:00:00+02:00,601,60,541,18.215943661240285,576,67,509,19.54878368039628,25,1015,0.1,4
2020-09-21 07:00:00+02:00,905,87,818,26.04340494897988,901,104,797,22.78945543194896,25,1015,0.1,4
2020-09-21 08:00:00+02:00,955,91,864,20.539635785693793,930,110,820,21.44314754027183,25,1015,0.1,4
2020-09-21 09:00:00+02:00,605,55,550,20.803493067467333,625,73,552,15.009840959849136,25,1015,0.1,4
2020-09-21 10:00:00+02:00,502,45,457,11.735836537408174,526,62,464,21.343558174072673,25,1015,0.1,4
2020-09-21 11:00:00+02:00,613,64,549,18.08041903389946,646,70,576,22.66748986971251,25,1015,0.1,4
2020-09-21 12:00:00+02:00,502,50,452,11.735836537408174,526,62,464,21.343558174072673,25,1015,0.1,4
2020-09-21 13:00:00+02:00,510,53,457,19.94640789038923,543,52,491,23.469937738067248,25,1015,0.1,4
2020-09-21 14:00:00+02:00,498,46,452,21.292954399658242,526,62,464,21.343558174072673,25,1015,0.1,4
2020-09-21 15:00:00+02:00,564,59,505,17.15459670775402,576,59,517,19.54878368039628,25,1015,0.1,4
2020-09-21 16:00:00+02:00,638,61,577,19.261703644868717,638,63,575,19.261703644868717,25,1015,0.1,4
2020-09-21 17:00:00+02:00,901,83,818,22.78945543194896,901,93,808,22.78945543194896,25,1015,0.1,4
2020-09-21 18:00:00+02:00,955,91,864,20.539635785693793,930,110,820,21.44314754027183,25,1015,0.1,4
2020-09-21 19:00:00+02:00,654,59,595,19.20246702812759,666,74,592,22.508045587926215,25,1015,0.1,4
2020-09-21 20:00:00+02:00,671,63,608,27.854694529575074,699,70,629,25.275934758615588,25,1015,0.1,4
2020-09-21 21:00:00+02:00,498,46,452,21.292954399658242,526,62,464,21.343558174072673,25,1015,0.1,4
2020-09-21 22:00:00+02:00,358,37,321,18.044939279580262,366,43,323,21.40807985369936,25,1015,0.1,4
2020-09-21 23:00:00+02:00,259,28,231,22.988395045636892,259,26,233,22.988395045636892,25,1015,0.1,4
2020-09-22 00:00:00+02:00,129,11,118,17.995114557081255,148,12,136,18.058884943386857,23,1014,0.0,6
2020-09-22 01:00:00+02:00,95,8,87,11.735389228725284,98,9,89,10.878679660088993,23,1014,0.0,6
2020-09-22 02:00:00+02:00,87,7,80,17.896548892855574,98,8,90,10.878679660088993,23,1014,0.0,6
2020-09-22 03:00:00+02:00,129,11,118,17.995114557081255,148,12,136,18.058884943386857,23,1014,0.0,6
2020-09-22 04:00:00+02:00,243,22,221,18.936896488437778,247,26,221,18.30797612224211,23,1014,0.0,6
2020-09-22 05:00:00+02:00,388,31,357,23.106523601706122,468,45,423,19.71650853762924,23,1014,0.0,6
2020-09-22 06:00:00+02:00,479,39,440,24.037051458292083,540,54,486,16.578820343867154,23,1014,0.0,6
2020-09-22 07:00:00+02:00,783,65,718,22.386866745743653,841,89,752,20.63744972669111,23,1014,0.0,6
2020-09-22 08:00:00+02:00,799,65,734,24.543008417981625,886,90,796,23.23618592812827,23,1014,0.0,6
2020-09-22 09:00:00+02:00,582,54,528,18.1879449408186,586,51,535,18.247067316767854,23,1014,0.0,6
2020-09-22 10:00:00+02:00,487,41,446,15.627714583030805,509,52,457,12.20192288247499,23,1014,0.0,6
2020-09-22 11:00:00+02:00,586,48,538,18.247067316767854,582,60,522,18.1879449408186,23,1014,0.0,6
2020-09-22 12:00:00+02:00,441,36,405,21.65218956350676,490,44,446,20.189989846505636,23,1014,0.0,6
2020-09-22 13:00:00+02:00,468,41,427,19.71650853762924,483,42,441,21.366599546374843,23,1014,0.0,6
2020-09-22 14:00:00+02:00,441,40,401,21.65218956350676,490,44,446,20.189989846505636,23,1014,0.0,6
2020-09-22 15:00:00+02:00,513,45,468,24.12103157612141,528,52,476,18.074163042875583,23,1014,0.0,6
2020-09-22 16:00:00+02:00,544,53,491,25.1241889325097,578,56,522,21.67658958953823,23,1014,0.0,6
2020-09-22 17:00:00+02:00,768,75,693,19.17235077337456,818,92,726,17.64150156665966,23,1014,0.0,6
2020-09-22 18:00:00+02:00,810,69,741,22.708324160653998,856,87,769,22.873350706035236,23,1014,0.0,6
2020-09-22 19:00:00+02:00,555,50,505,17.57269749774077,669,70,599,21.432133936827082,23,1014,0.0,6
2020-09-22 20:00:00+02:00,589,52,537,24.4118965594369,631,65,566,19.637448203371804,23,1014,0.0,6
2020-09-22 21:00:00+02:00,430,35,395,19.32256414396262,490,43,447,20.189989846505636,23,1014,0.0,6
2020-09-22 22:00:00+02:00,327,29,298,17.492932564197055,342,30,312,17.147818156889407,23,1014,0.0,6
2020-09-22 23:00:00+02:00,213,20,193,20.488166305452438,258,26,232,21.93153719781745,23,1014,0.0,6
2020-09-23 00:00:00+02:00,113,13,100,17.24351217151361,113,14,99,17.24351217151361,19,1008,0.0,9
2020-09-23 01:00:00+02:00,76,10,66,20.954075500954353,70,7,63,13.723178013454,19,1008,0.0,9
2020-09-23 02:00:00+02:00,76,9,67,20.954075500954353,70,7,63,13.723178013454,19,1008,0.0,9
2020-09-23 03:00:00+02:00,113,13,100,17.24351217151361,113,14,99,17.24351217151361,19,1008,0.0,9
2020-09-23 04:00:00+02:00,193,26,167,18.658224506029875,178,18,160,13.537284957794041,19,1008,0.0,9
2020-09-23 05:00:00+02:00,350,47,303,22.47956536478983,332,40,292,19.089795695646295,19,1008,0.0,9
2020-09-23 06:00:00+02:00,434,59,375,20.9227488499813,394,38,356,22.05126282448999,19,1008,0.0,9
2020-09-23 07:00:00+02:00,658,76,582,15.999136717904042,588,56,532,22.390563440455406,19,1008,0.0,9
2020-09-23 08:00:00+02:00,714,85,629,21.081745806887525,624,74,550,23.272673786137588,19,1008,0.0,9
2020-09-23 09:00:00+02:00,461,54,407,22.135518273089986,424,50,374,17.28621876263119,19,1008,0.0,9
2020-09-23 10:00:00+02:00,387,52,335,17.47876613578263,354,44,310,23.46295366080014,19,1008,0.0,9
2020-09-23 11:00:00+02:00,461,58,403,22.135518273089986,424,50,374,17.28621876263119,19,1008,0.0,9
2020-09-23 12:00:00+02:00,387,52,335,17.47876613578263,354,44,310,23.46295366080014,19,1008,0.0,9
2020-09-23 13:00:00+02:00,384,48,336,24.017668618470122,381,40,341,20.33707664399945,19,1008,0.0,9
2020-09-23 14:00:00+02:00,387,46,341,17.47876613578263,354,44,310,23.46295366080014,19,1008,0.0,9
2020-09-23 15:00:00+02:00,424,53,371,17.28621876263119,397,50,347,17.68183590028467,19,1008,0.0,9
2020-09-23 16:00:00+02:00,461,57,404,22.135518273089986,424,50,374,17.28621876263119,19,1008,0.0,9
2020-09-23 17:00:00+02:00,658,90,568,15.999136717904042,588,56,532,22.390563440455406,19,1008,0.0,9
2020-09-23 18:00:00+02:00,714,85,629,21.081745806887525,624,74,550,23.272673786137588,19,1008,0.0,9
2020-09-23 19:00:00+02:00,501,59,442,18.049817333307605,474,55,419,19.4414848715995,19,1008,0.0,9
2020-09-23 20:00:00+02:00,501,57,444,18.049817333307605,474,55,419,19.4414848715995,19,1008,0.0,9
2020-09-23 21:00:00+02:00,384,43,341,24.017668618470122,381,40,341,20.33707664399945,19,1008,0.0,9
2020-09-23 22:00:00+02:00,270,32,238,21.935045846470036,273,30,243,26.59294853191911,19,1008,0.0,9
2020-09-23 23:00:00+02:00,197,24,173,16.840472953316162,184,19,165,11.126916077945086,19,1008,0.0,9
2020-09-24 00:00:00+02:00,40,3,37,5.275608835029151,43,5,38,8.573704494863009,15,1004,0.3,21
2020-09-24 01:00:00+02:00,26,2,24,1.5382661455122164,27,3,24,1.9016023008994223,15,1004,0.3,21
2020-09-24 02:00:00+02:00,27,2,25,1.9016023008994223,27,3,24,1.9016023008994223,15,1004,0.3,21
2020-09-24 03:00:00+02:00,41,3,38,8.457036189746331,43,5,38,8.573704494863009,15,1004,0.3,21
2020-09-24 04:00:00+02:00,66,5,61,13.86002207659952,72,11,61,19.53768091870668,15,1004,0.3,21
2020-09-24 05:00:00+02:00,124,9,115,17.53992981591413,122,18,104,20.245567873519157,15,1004,0.3,21
2020-09-24 06:00:00+02:00,152,13,139,20.188330220444417,158,20,138,21.67102174389251,15,1004,0.3,21
2020-09-24 07:00:00+02:00,223,18,205,21.320656431140716,231,32,199,16.702836426900134,15,1004,0.3,21
2020-09-24 08:00:00+02:00,243,18,225,18.936896488437778,252,38,214,18.51064847889223,15,1004,0.3,21
2020-09-24 09:00:00+02:00,158,13,145,21.67102174389251,169,24,145,18.567569965901342,15,1004,0.3,21
2020-09-24 10:00:00+02:00,145,11,134,18.85528596371164,147,20,127,20.208056467665056,15,1004,0.3,21
2020-09-24 11:00:00+02:00,177,15,162,20.028957588616944,176,25,151,20.324791671108635,15,1004,0.3,21
2020-09-24 12:00:00+02:00,132,11,121,19.37004764296085,141,22,119,21.00935462418931,15,1004,0.3,21
2020-09-24 13:00:00+02:00,147,13,134,20.208056467665056,146,17,129,20.98788244482569,15,1004,0.3,21
2020-09-24 14:00:00+02:00,141,12,129,21.00935462418931,147,20,127,20.208056467665056,15,1004,0.3,21
2020-09-24 15:00:00+02:00,162,14,148,19.08849102929865,154,18,136,23.457384968254527,15,1004,0.3,21
2020-09-24 16:00:00+02:00,152,13,139,20.188330220444417,171,22,149,22.137070929890193,15,1004,0.3,21
2020-09-24 17:00:00+02:00,220,17,203,16.758079648934128,239,30,209,13.74553452780325,15,1004,0.3,21
2020-09-24 18:00:00+02:00,267,22,245,13.385499595100717,257,34,223,24.369710124951805,15,1004,0.3,21
2020-09-24 19:00:00+02:00,192,15,177,21.295822766447603,185,25,160,20.160625004949942,15,1004,0.3,21
2020-09-24 20:00:00+02:00,167,12,155,21.39117903937357,185,25,160,20.160625004949942,15,1004,0.3,21
2020-09-24 21:00:00+02:00,128,9,119,19.601953989978306,141,17,124,21.00935462418931,15,1004,0.3,21
2020-09-24 22:00:00+02:00,103,9,94,12.113442962320551,100,15,85,11.502705756568044,15,1004,0.3,21
2020-09-24 23:00:00+02:00,68,5,63,14.701855472363336,72,11,61,19.53768091870668,15,1004,0.3,21
2020-09-25 00:00:00+02:00,38,3,35,11.101073107969722,38,4,34,11.101073107969722,12,1000,0.7,22
2020-09-25 01:00:00+02:00,25,2,23,1.1875344360364632,25,2,23,1.1875344360364632,12,1000,0.7,22
2020-09-25 02:00:00+02:00,25,2,23,1.1875344360364632,25,2,23,1.1875344360364632,12,1000,0.7,22
2020-09-25 03:00:00+02:00,37,3,34,2.066086063070793,38,4,34,11.101073107969722,12,1000,0.7,22
2020-09-25 04:00:00+02:00,63,6,57,14.929801273937542,58,5,53,10.505136369992313,12,1000,0.7,22
2020-09-25 05:00:00+02:00,113,12,101,20.093188266697116,113,11,102,20.093188266697116,12,1000,0.7,22
2020-09-25 06:00:00+02:00,140,13,127,15.331768592489755,129,13,116,17.995114557081255,12,1000,0.7,22
2020-09-25 07:00:00+02:00,210,19,191,16.3212742992447,212,18,194,18.597605283865732,12,1000,0.7,22
2020-09-25 08:00:00+02:00,228,23,205,15.818609956751573,211,19,192,18.759232281731908,12,1000,0.7,22
2020-09-25 09:00:00+02:00,147,14,133,20.208056467665056,153,13,140,14.915022999208679,12,1000,0.7,22
2020-09-25 10:00:00+02:00,124,11,113,17.53992981591413,117,12,105,21.891304075969387,12,1000,0.7,22
2020-09-25 11:00:00+02:00,153,15,138,14.915022999208679,148,13,135,18.058884943386857,12,1000,0.7,22
2020-09-25 12:00:00+02:00,129,13,116,17.995114557081255,123,10,113,19.074654696202938,12,1000,0.7,22
2020-09-25 13:00:00+02:00,124,12,112,17.53992981591413,117,12,105,21.891304075969387,12,1000,0.7,22
2020-09-25 14:00:00+02:00,128,12,116,19.601953989978306,123,10,113,19.074654696202938,12,1000,0.7,22
2020-09-25 15:00:00+02:00,136,14,122,16.594078125250377,138,14,124,20.21600799483387,12,1000,0.7,22
2020-09-25 16:00:00+02:00,145,14,131,18.85528596371164,154,15,139,23.457384968254527,12,1000,0.7,22
2020-09-25 17:00:00+02:00,207,22,185,21.877297854955202,202,19,183,22.500350864850866,12,1000,0.7,22
2020-09-25 18:00:00+02:00,218,21,197,22.57742359713229,227,25,202,19.269071808142694,12,1000,0.7,22
2020-09-25 19:00:00+02:00,158,15,143,21.67102174389251,159,15,144,17.78748005044877,12,1000,0.7,22
2020-09-25 20:00:00+02:00,160,14,146,19.89239402952506,159,13,146,17.78748005044877,12,1000,0.7,22
2020-09-25 21:00:00+02:00,123,11,112,19.074654696202938,123,12,111,19.074654696202938,12,1000,0.7,22
2020-09-25 22:00:00+02:00,86,8,78,21.204994436842384,85,7,78,19.289671453475872,12,1000,0.7,22
2020-09-25 23:00:00+02:00,61,6,55,12.362973378192347,58,5,53,10.505136369992313,12,1000,0.7,22
2020-09-26 00:00:00+02:00,37,2,35,3.5125252112896685,39,2,37,6.913338666308079,12,1008,0.0,24
2020-09-26 01:00:00+02:00,24,1,23,0.16633697306049489,26,1,25,0.13434729751860394,12,1008,0.0,24
2020-09-26 02:00:00+02:00,25,1,24,0.10677168789919293,26,1,25,0.13434729751860394,12,1008,0.0,24
2020-09-26 03:00:00+02:00,38,2,36,5.960450042509954,39,2,37,6.913338666308079,12,1008,0.0,24
2020-09-26 04:00:00+02:00,48,3,45,9.964553643509852,52,2,50,14.472017643602554,12,1008,0.0,24
2020-09-26 05:00:00+02:00,62,4,58,14.019247608895405,65,4,61,10.13470849860639,12,1008,0.0,24
2020-09-26 06:00:00+02:00,101,6,95,14.022694861996197,105,6,99,16.343560716114418,12,1008,0.0,24
2020-09-26 07:00:00+02:00,147,9,138,16.306492316544293,159,10,149,19.89258263570152,12,1008,0.0,24
2020-09-26 08:00:00+02:00,206,11,195,20.90053052788098,208,12,196,18.807092053665322,12,1008,0.0,24
2020-09-26 09:00:00+02:00,213,14,199,20.238518600536185,223,14,209,18.802339292525456,12,1008,0.0,24
2020-09-26 10:00:00+02:00,187,12,175,15.611538170802525,198,12,186,20.173795644408123,12,1008,0.0,24
2020-09-26 11:00:00+02:00,152,10,142,18.686880121910534,155,8,147,18.708796369633056,12,1008,0.0,24
2020-09-26 12:00:00+02:00,145,8,137,19.922746131926434,158,8,150,19.40470350916573,12,1008,0.0,24
2020-09-26 13:00:00+02:00,167,9,158,19.047083059371815,172,10,162,18.863206387348974,12,1008,0.0,24
2020-09-26 14:00:00+02:00,154,8,146,19.868163821621103,155,8,147,18.708796369633056,12,1008,0.0,24
2020-09-26 15:00:00+02:00,169,9,160,20.526675282456768,185,10,175,20.88033942284811,12,1008,0.0,24
2020-09-26 16:00:00+02:00,172,10,162,18.863206387348974,186,9,177,20.400698976924794,12,1008,0.0,24
2020-09-26 17:00:00+02:00,199,12,187,19.11274068140836,209,10,199,16.60419034744366,12,1008,0.0,24
2020-09-26 18:00:00+02:00,190,11,179,20.182913119811044,197,10,187,19.118279085736297,12,1008,0.0,24
2020-09-26 19:00:00+02:00,146,9,137,19.4340926707284,157,8,149,19.700921436065542,12,1008,0.0,24
2020-09-26 20:00:00+02:00,142,8,134,19.57947604189084,146,8,138,19.4340926707284,12,1008,0.0,24
2020-09-26 21:00:00+02:00,124,7,117,14.467255533674502,129,7,122,12.81298343964759,12,1008,0.0,24
2020-09-26 22:00:00+02:00,100,6,94,12.129363492765288,105,7,98,16.343560716114418,12,1008,0.0,24
2020-09-26 23:00:00+02:00,49,3,46,12.126419816698254,52,2,50,14.472017643602554,12,1008,0.0,24
2020-09-27 00:00:00+02:00,21,0,21,0.0727095127790566,25,0,25,0.10677168789919293,12,1008,2.0,24
2020-09-27 01:00:00+02:00,14,0,14,0.0,18,0,18,0.014449312499738909,12,1008,2.0,24
2020-09-27 02:00:00+02:00,13,0,13,0.0,18,0,18,0.014449312499738909,12,1008,2.0,24
2020-09-27 03:00:00+02:00,20,0,20,0.04910283862897408,25,0,25,0.10677168789919293,12,1008,2.0,24
2020-09-27 04:00:00+02:00,29,1,28,0.5419439371488394,36,1,35,2.727177547566476,12,1008,2.0,24
2020-09-27 05:00:00+02:00,36,1,35,2.727177547566476,48,1,47,9.964553643509852,12,1008,2.0,24
2020-09-27 06:00:00+02:00,57,2,55,11.247345675463038,74,3,71,9.886934519670994,12,1008,2.0,24
2020-09-27 07:00:00+02:00,87,3,84,9.504121716770046,119,3,116,9.275729661817119,12,1008,2.0,24
2020-09-27 08:00:00+02:00,110,4,106,20.964248322238312,128,4,124,16.268122259148125,12,1008,2.0,24
2020-09-27 09:00:00+02:00,118,4,114,16.65435568776215,166,6,160,16.094287115128708,12,1008,2.0,24
2020-09-27 10:00:00+02:00,106,4,102,19.560878716092326,149,5,144,17.937448228249327,12,1008,2.0,24
2020-09-27 11:00:00+02:00,82,3,79,8.6962433625344,98,3,95,9.366341704429512,12,1008,2.0,24
2020-09-27 12:00:00+02:00,86,3,83,9.565861223121674,119,3,116,9.275729661817119,12,1008,2.0,24
2020-09-27 13:00:00+02:00,89,3,86,10.527801976587284,98,4,94,9.366341704429512,12,1008,2.0,24
2020-09-27 14:00:00+02:00,86,3,83,9.565861223121674,119,3,116,9.275729661817119,12,1008,2.0,24
2020-09-27 15:00:00+02:00,96,4,92,10.792244903732447,127,4,123,18.022773693841014,12,1008,2.0,24
2020-09-27 16:00:00+02:00,97,4,93,12.91170780960746,118,4,114,16.65435568776215,12,1008,2.0,24
2020-09-27 17:00:00+02:00,117,4,113,13.539944397802945,135,5,130,20.27811899595658,12,1008,2.0,24
2020-09-27 18:00:00+02:00,109,4,105,18.214376818550008,139,5,134,19.408576933840735,12,1008,2.0,24
2020-09-27 19:00:00+02:00,89,3,86,10.527801976587284,90,3,87,10.477669283936715,12,1008,2.0,24
2020-09-27 20:00:00+02:00,74,3,71,9.886934519670994,107,4,103,12.742346635562697,12,1008,2.0,24
2020-09-27 21:00:00+02:00,73,2,71,10.015349835153332,86,3,83,9.565861223121674,12,1008,2.0,24
2020-09-27 22:00:00+02:00,59,2,57,11.512224289105106,74,3,71,9.886934519670994,12,1008,2.0,24
2020-09-27 23:00:00+02:00,29,1,28,0.5419439371488394,36,1,35,2.727177547566476,12,1008,2.0,24
2020-09-28 00:00:00+02:00,111,10,101,12.909820125967427,105,10,95,15.778065052313549,13,1010,0.0,5
2020-09-28 01:00:00+02:00,74,8,66,19.513800836509724,74,8,66,19.513800836509724,13,1010,0.0,5
2020-09-28 02:00:00+02:00,74,7,67,19.513800836509724,74,8,66,19.513800836509724,13,1010,0.0,5
2020-09-28 03:00:00+02:00,111,11,100,12.909820125967427,105,10,95,15.778065052313549,13,1010,0.0,5
2020-09-28 04:00:00+02:00,185,20,165,20.160625004949942,179,17,162,19.18236787964663,13,1010,0.0,5
2020-09-28 05:00:00+02:00,336,35,301,23.28683107716768,330,37,293,16.43301680059058,13,1010,0.0,5
2020-09-28 06:00:00+02:00,390,37,353,23.204029211730827,398,50,348,15.798181076462747,13,1010,0.0,5
2020-09-28 07:00:00+02:00,586,58,528,18.247067316767854,641,63,578,15.726028078936805,13,1010,0.0,5
2020-09-28 08:00:00+02:00,635,67,568,19.585358081724554,658,81,577,21.97385875439763,13,1010,0.0,5
2020-09-28 09:00:00+02:00,424,43,381,20.771564063368263,441,47,394,21.65218956350676,13,1010,0.0,5
2020-09-28 10:00:00+02:00,356,33,323,20.092398613710877,361,37,324,19.1870055662437,13,1010,0.0,5
2020-09-28 11:00:00+02:00,433,47,386,15.756615810687446,430,46,384,19.32256414396262,13,1010,0.0,5
2020-09-28 12:00:00+02:00,356,32,324,20.092398613710877,361,37,324,19.1870055662437,13,1010,0.0,5
2020-09-28 13:00:00+02:00,358,39,319,18.044939279580262,361,42,319,19.1870055662437,13,1010,0.0,5
2020-09-28 14:00:00+02:00,358,39,319,18.044939279580262,361,42,319,19.1870055662437,13,1010,0.0,5
2020-09-28 15:00:00+02:00,396,43,353,20.199948477295223,390,43,347,23.204029211730827,13,1010,0.0,5
2020-09-28 16:00:00+02:00,427,46,381,18.502781357559265,433,54,379,15.756615810687446,13,1010,0.0,5
2020-09-28 17:00:00+02:00,595,58,537,20.68405691160685,615,60,555,21.061338820559666,13,1010,0.0,5
2020-09-28 18:00:00+02:00,629,59,570,19.562414399045025,641,60,581,15.726028078936805,13,1010,0.0,5
2020-09-28 19:00:00+02:00,458,48,410,24.591159780297854,484,59,425,17.863314460235074,13,1010,0.0,5
2020-09-28 20:00:00+02:00,487,45,442,15.627714583030805,478,54,424,19.93054974447541,13,1010,0.0,5
2020-09-28 21:00:00+02:00,364,35,329,19.12804198058144,361,45,316,19.1870055662437,13,1010,0.0,5
2020-09-28 22:00:00+02:00,250,27,223,14.642007731534619,253,30,223,24.084070139549794,13,1010,0.0,5
2020-09-28 23:00:00+02:00,179,18,161,19.18236787964663,185,22,163,20.160625004949942,13,1010,0.0,5
2020-09-29 00:00:00+02:00,90,7,83,13.960700117154147,104,8,96,11.935148455597123,16,1016,0.0,10
2020-09-29 01:00:00+02:00,64,6,58,14.414592943793718,72,7,65,19.53768091870668,16,1016,0.0,10
2020-09-29 02:00:00+02:00,64,5,59,14.414592943793718,72,7,65,19.53768091870668,16,1016,0.0,10
2020-09-29 03:00:00+02:00,98,8,90,10.878679660088993,101,9,92,11.280950715811313,16,1016,0.0,10
2020-09-29 04:00:00+02:00,162,15,147,19.08849102929865,173,14,159,20.37647841384157,16,1016,0.0,10
2020-09-29 05:00:00+02:00,288,28,260,22.858888837585067,304,28,276,22.339067945756394,16,1016,0.0,10
2020-09-29 06:00:00+02:00,376,31,345,15.920759199358614,389,34,355,21.37920911023894,16,1016,0.0,10
2020-09-29 07:00:00+02:00,526,44,482,21.343558174072673,582,62,520,18.1879449408186,16,1016,0.0,10
2020-09-29 08:00:00+02:00,558,46,512,21.887504875695765,603,54,549,20.350290442155355,16,1016,0.0,10
2020-09-29 09:00:00+02:00,365,31,334,18.717967350040688,419,47,372,22.446709242047174,16,1016,0.0,10
2020-09-29 10:00:00+02:00,320,31,289,21.04137400974582,363,40,323,20.037936765942277,16,1016,0.0,10
2020-09-29 11:00:00+02:00,379,37,342,18.713391269845218,429,44,385,21.355504409446556,16,1016,0.0,10
2020-09-29 12:00:00+02:00,312,26,286,18.640393178431868,349,32,317,16.300891984453436,16,1016,0.0,10
2020-09-29 13:00:00+02:00,323,27,296,19.17862862818099,363,40,323,20.037936765942277,16,1016,0.0,10
2020-09-29 14:00:00+02:00,315,31,284,16.084372336057935,341,34,307,14.480776847696712,16,1016,0.0,10
2020-09-29 15:00:00+02:00,357,29,328,21.912097396672888,379,34,345,18.713391269845218,16,1016,0.0,10
2020-09-29 16:00:00+02:00,405,38,367,18.172278090342537,405,46,359,18.172278090342537,16,1016,0.0,10
2020-09-29 17:00:00+02:00,518,51,467,22.68283075592232,606,64,542,24.38243055199842,16,1016,0.0,10
2020-09-29 18:00:00+02:00,614,60,554,16.05349448397906,611,63,548,19.45228913824497,16,1016,0.0,10
2020-09-29 19:00:00+02:00,435,39,396,21.80027200191571,445,44,401,19.037524313009598,16,1016,0.0,10
2020-09-29 20:00:00+02:00,400,36,364,22.17455177589486,440,40,400,19.57754243382943,16,1016,0.0,10
2020-09-29 21:00:00+02:00,312,30,282,18.640393178431868,349,32,317,16.300891984453436,16,1016,0.0,10
2020-09-29 22:00:00+02:00,224,19,205,16.30248157536985,243,20,223,18.936896488437778,16,1016,0.0,10
2020-09-29 23:00:00+02:00,154,14,140,23.457384968254527,168,19,149,20.304807772345505,16,1016,0.0,10
2020-09-30 00:00:00+02:00,105,12,93,16.064586492970292,97,11,86,13.44369084549097,17,1017,0.2,8
2020-09-30 01:00:00+02:00,69,7,62,8.03614801962393,61,6,55,12.120017072784945,17,1017,0.2,8
2020-09-30 02:00:00+02:00,69,8,61,8.03614801962393,61,6,55,12.120017072784945,17,1017,0.2,8
2020-09-30 03:00:00+02:00,102,12,90,15.767603823718561,91,10,81,15.918010409358821,17,1017,0.2,8
2020-09-30 04:00:00+02:00,174,23,151,15.22838843742414,177,17,160,13.379779811948204,17,1017,0.2,8
2020-09-30 05:00:00+02:00,322,37,285,23.67757984571023,294,29,265,24.118136039782872,17,1017,0.2,8
2020-09-30 06:00:00+02:00,385,45,340,22.594345401183464,366,36,330,18.901447571833554,17,1017,0.2,8
2020-09-30 07:00:00+02:00,602,76,526,18.665297214327193,566,59,507,26.89046731312439,17,1017,0.2,8
2020-09-30 08:00:00+02:00,630,76,554,18.08859787789587,597,66,531,27.42561338780647,17,1017,0.2,8
2020-09-30 09:00:00+02:00,427,49,378,20.04761786859743,399,50,349,22.794880337876126,17,1017,0.2,8
2020-09-30 10:00:00+02:00,349,42,307,17.290559234581835,344,37,307,27.169680099906476,17,1017,0.2,8
2020-09-30 11:00:00+02:00,424,50,374,17.28621876263119,391,49,342,19.080298090167734,17,1017,0.2,8
2020-09-30 12:00:00+02:00,355,48,307,20.819485457974345,335,33,302,22.25380340127623,17,1017,0.2,8
2020-09-30 13:00:00+02:00,347,39,308,19.054171185340035,341,37,304,19.23827651297557,17,1017,0.2,8
2020-09-30 14:00:00+02:00,352,44,308,22.013609081992854,330,33,297,22.0130860795424,17,1017,0.2,8
2020-09-30 15:00:00+02:00,391,53,338,19.080298090167734,380,48,332,21.43528591263335,17,1017,0.2,8
2020-09-30 16:00:00+02:00,419,50,369,14.863975805015587,419,49,370,14.863975805015587,17,1017,0.2,8
2020-09-30 17:00:00+02:00,605,78,527,24.70813035887608,602,60,542,18.665297214327193,17,1017,0.2,8
2020-09-30 18:00:00+02:00,633,76,557,24.21139950328766,583,74,509,21.84216843782984,17,1017,0.2,8
2020-09-30 19:00:00+02:00,460,56,404,18.80828405121806,447,47,400,19.00138648619854,17,1017,0.2,8
2020-09-30 20:00:00+02:00,452,52,400,20.80640156505403,416,46,370,18.869548080226345,17,1017,0.2,8
2020-09-30 21:00:00+02:00,347,47,300,19.054171185340035,341,37,304,19.23827651297557,17,1017,0.2,8
2020-09-30 22:00:00+02:00,247,31,216,22.66625775717105,230,25,205,17.60723498396665,17,1017,0.2,8
2020-09-30 23:00:00+02:00,174,19,155,15.22838843742414,177,17,160,13.379779811948204,17,1017,0.2,8
2020-10-01 00:00:00+02:00,76,5,71,16.686685835236233,74,11,63,19.513800836509724,16,1006,0.0,16
2020-10-01 01:00:00+02:00,49,4,45,13.911731041947528,49,7,42,13.911731041947528,16,1006,0.0,16
2020-10-01 02:00:00+02:00,49,3,46,13.911731041947528,49,7,42,13.911731041947528,16,1006,0.0,16
2020-10-01 03:00:00+02:00,76,5,71,16.686685835236233,74,11,63,19.513800836509724,16,1006,0.0,16
2020-10-01 04:00:00+02:00,123,10,113,19.074654696202938,125,18,107,23.026828253397017,16,1006,0.0,16
2020-10-01 05:00:00+02:00,212,16,196,18.597605283865732,237,34,203,15.922060682410839,16,1006,0.0,16
2020-10-01 06:00:00+02:00,290,24,266,18.088844908617002,278,42,236,17.988889489265482,16,1006,0.0,16
2020-10-01 07:00:00+02:00,449,35,414,18.601165629732545,420,60,360,20.41205404512006,16,1006,0.0,16
2020-10-01 08:00:00+02:00,430,38,392,19.32256414396262,449,56,393,18.601165629732545,16,1006,0.0,16
2020-10-01 09:00:00+02:00,317,24,293,23.692514426518255,294,42,252,18.98421464015195,16,1006,0.0,16
2020-10-01 10:00:00+02:00,257,20,237,24.369710124951805,259,32,227,22.988395045636892,16,1006,0.0,16
2020-10-01 11:00:00+02:00,272,21,251,23.2664106640069,305,49,256,19.342371998402466,16,1006,0.0,16
2020-10-01 12:00:00+02:00,230,17,213,17.120376816836934,257,32,225,24.369710124951805,16,1006,0.0,16
2020-10-01 13:00:00+02:00,265,21,244,24.143057918667047,249,34,215,20.976233072746222,16,1006,0.0,16
2020-10-01 14:00:00+02:00,249,20,229,20.976233072746222,253,35,218,24.084070139549794,16,1006,0.0,16
2020-10-01 15:00:00+02:00,259,22,237,22.988395045636892,267,35,232,13.385499595100717,16,1006,0.0,16
2020-10-01 16:00:00+02:00,300,24,276,19.621479548992166,290,41,249,18.088844908617002,16,1006,0.0,16
2020-10-01 17:00:00+02:00,399,34,365,20.89817652151005,426,63,363,20.8097346735364,16,1006,0.0,16
2020-10-01 18:00:00+02:00,410,35,375,20.532450928302634,443,72,371,13.62175880122913,16,1006,0.0,16
2020-10-01 19:00:00+02:00,333,29,304,26.7685298712925,325,50,275,19.331050121665143,16,1006,0.0,16
2020-10-01 20:00:00+02:00,340,28,312,18.92958933704513,337,41,296,21.494538760895587,16,1006,0.0,16
2020-10-01 21:00:00+02:00,247,19,228,18.30797612224211,241,29,212,21.076687701702674,16,1006,0.0,16
2020-10-01 22:00:00+02:00,183,16,167,16.4856647978058,168,21,147,20.304807772345505,16,1006,0.0,16
2020-10-01 23:00:00+02:00,117,9,108,21.891304075969387,129,18,111,17.995114557081255,16,1006,0.0,16
2020-10-02 00:00:00+02:00,79,7,72,16.382916607013883,79,7,72,16.382916607013883,14,998,0.0,13
2020-10-02 01:00:00+02:00,51,5,46,7.252205043556333,51,4,47,7.252205043556333,14,998,0.0,13
2020-10-02 02:00:00+02:00,51,5,46,7.252205043556333,51,4,47,7.252205043556333,14,998,0.0,13
2020-10-02 03:00:00+02:00,77,7,70,16.632320143368542,81,8,73,16.076626545182606,14,998,0.0,13
2020-10-02 04:00:00+02:00,134,12,122,14.701306049248211,130,14,116,15.65660051079879,14,998,0.0,13
2020-10-02 05:00:00+02:00,237,21,216,15.922060682410839,246,27,219,17.57126233227549,14,998,0.0,13
2020-10-02 06:00:00+02:00,289,30,259,20.14984129628082,278,25,253,17.988889489265482,14,998,0.0,13
2020-10-02 07:00:00+02:00,447,43,404,16.685974257079213,437,44,393,22.67431624563715,14,998,0.0,13
2020-10-02 08:00:00+02:00,490,46,444,20.189989846505636,490,47,443,20.189989846505636,14,998,0.0,13
2020-10-02 09:00:00+02:00,323,31,292,19.17862862818099,329,36,293,19.339935066365534,14,998,0.0,13
2020-10-02 10:00:00+02:00,267,26,241,13.385499595100717,265,24,241,24.143057918667047,14,998,0.0,13
2020-10-02 11:00:00+02:00,317,30,287,23.692514426518255,306,31,275,17.3472177808044,14,998,0.0,13
2020-10-02 12:00:00+02:00,261,27,234,21.270868579361668,259,28,231,22.988395045636892,14,998,0.0,13
2020-10-02 13:00:00+02:00,261,24,237,21.270868579361668,259,28,231,22.988395045636892,14,998,0.0,13
2020-10-02 14:00:00+02:00,261,24,237,21.270868579361668,259,28,231,22.988395045636892,14,998,0.0,13
2020-10-02 15:00:00+02:00,287,27,260,21.927304089805975,289,26,263,20.14984129628082,14,998,0.0,13
2020-10-02 16:00:00+02:00,325,29,296,19.331050121665143,329,36,293,19.339935066365534,14,998,0.0,13
2020-10-02 17:00:00+02:00,456,45,411,14.42236972784694,439,44,395,18.965638166337634,14,998,0.0,13
2020-10-02 18:00:00+02:00,464,42,422,21.884111394069308,460,40,420,18.198266997149677,14,998,0.0,13
2020-10-02 19:00:00+02:00,338,34,304,21.115663704400472,355,32,323,23.18890281037911,14,998,0.0,13
2020-10-02 20:00:00+02:00,355,36,319,23.18890281037911,336,30,306,23.28683107716768,14,998,0.0,13
2020-10-02 21:00:00+02:00,267,26,241,13.385499595100717,265,24,241,24.143057918667047,14,998,0.0,13
2020-10-02 22:00:00+02:00,184,17,167,20.655558446800804,182,15,167,17.128604685093855,14,998,0.0,13
2020-10-02 23:00:00+02:00,130,11,119,15.65660051079879,130,11,119,15.65660051079879,14,998,0.0,13
2020-10-03 00:00:00+02:00,45,2,43,8.150223537761923,47,2,45,8.734704942588355,13,989,0.9,12
2020-10-03 01:00:00+02:00,30,1,29,0.6316761612788789,31,2,29,0.3699528216625179,13,989,0.9,12
2020-10-03 02:00:00+02:00,30,1,29,0.6316761612788789,31,2,29,0.3699528216625179,13,989,0.9,12
2020-10-03 03:00:00+02:00,45,2,43,8.150223537761923,47,2,45,8.734704942588355,13,989,0.9,12
2020-10-03 04:00:00+02:00,61,3,58,13.45123014142322,62,3,59,14.019247608895405,13,989,0.9,12
2020-10-03 05:00:00+02:00,77,5,72,11.693765322784895,81,5,76,13.380409900215524,13,989,0.9,12
2020-10-03 06:00:00+02:00,120,6,114,15.329119598546,126,6,120,13.391954395859463,13,989,0.9,12
2020-10-03 07:00:00+02:00,181,12,169,16.606730094694083,191,10,181,21.61132830766016,13,989,0.9,12
2020-10-03 08:00:00+02:00,251,16,235,17.440368481170164,259,16,243,22.975221531884507,13,989,0.9,12
2020-10-03 09:00:00+02:00,266,16,250,15.200054248100818,276,16,260,15.542213852127956,13,989,0.9,12
2020-10-03 10:00:00+02:00,228,13,215,19.28787791304013,240,15,225,19.372323114313716,13,989,0.9,12
2020-10-03 11:00:00+02:00,178,10,168,18.00585359354758,190,9,181,20.182913119811044,13,989,0.9,12
2020-10-03 12:00:00+02:00,185,10,175,20.88033942284811,191,10,181,21.61132830766016,13,989,0.9,12
2020-10-03 13:00:00+02:00,203,13,190,16.97445579481889,208,10,198,18.807092053665322,13,989,0.9,12
2020-10-03 14:00:00+02:00,184,12,172,19.759138180971462,192,9,183,17.31696395349906,13,989,0.9,12
2020-10-03 15:00:00+02:00,217,14,203,18.791759657796693,228,11,217,19.28787791304013,13,989,0.9,12
2020-10-03 16:00:00+02:00,213,14,199,20.238518600536185,226,14,212,15.467390071610119,13,989,0.9,12
2020-10-03 17:00:00+02:00,239,14,225,18.056937917326703,253,16,237,17.73107046839405,13,989,0.9,12
2020-10-03 18:00:00+02:00,234,15,219,18.523045519331724,240,14,226,19.372323114313716,13,989,0.9,12
2020-10-03 19:00:00+02:00,178,10,168,18.00585359354758,190,9,181,20.182913119811044,13,989,0.9,12
2020-10-03 20:00:00+02:00,169,9,160,20.526675282456768,179,10,169,21.74229179161351,13,989,0.9,12
2020-10-03 21:00:00+02:00,151,8,143,19.14578123638998,159,8,151,19.89258263570152,13,989,0.9,12
2020-10-03 22:00:00+02:00,126,7,119,13.391954395859463,127,8,119,18.022773693841014,13,989,0.9,12
2020-10-03 23:00:00+02:00,60,4,56,12.98342242386016,65,3,62,10.13470849860639,13,989,0.9,12
2020-10-04 00:00:00+02:00,36,1,35,2.727177547566476,50,1,49,13.833131991765365,13,987,0.2,14
2020-10-04 01:00:00+02:00,24,0,24,0.16633697306049489,29,1,28,0.5419439371488394,13,987,0.2,14
2020-10-04 02:00:00+02:00,24,0,24,0.16633697306049489,29,1,28,0.5419439371488394,13,987,0.2,14
2020-10-04 03:00:00+02:00,36,1,35,2.727177547566476,50,1,49,13.833131991765365,13,987,0.2,14
2020-10-04 04:00:00+02:00,50,1,49,13.833131991765365,65,2,63,10.13470849860639,13,987,0.2,14
2020-10-04 05:00:00+02:00,62,2,60,14.019247608895405,79,3,76,13.473204105951462,13,987,0.2,14
2020-10-04 06:00:00+02:00,93,3,90,7.996959659096201,124,5,119,14.467255533674502,13,987,0.2,14
2020-10-04 07:00:00+02:00,138,5,133,15.03091255444847,196,7,189,22.483124652822625,13,987,0.2,14
2020-10-04 08:00:00+02:00,186,7,179,20.400698976924794,238,8,230,14.411005913654613,13,987,0.2,14
2020-10-04 09:00:00+02:00,203,8,195,16.97445579481889,253,8,245,17.73107046839405,13,987,0.2,14
2020-10-04 10:00:00+02:00,188,7,181,19.664617237016223,214,7,207,18.026924150727908,13,987,0.2,14
2020-10-04 11:00:00+02:00,143,5,138,15.49985590484046,200,7,193,21.668114478408352,13,987,0.2,14
2020-10-04 12:00:00+02:00,145,5,140,19.922746131926434,191,6,185,21.61132830766016,13,987,0.2,14
2020-10-04 13:00:00+02:00,165,7,158,20.19240679449499,210,7,203,17.488096079787415,13,987,0.2,14
2020-10-04 14:00:00+02:00,143,5,138,15.49985590484046,200,7,193,21.668114478408352,13,987,0.2,14
2020-10-04 15:00:00+02:00,169,6,163,20.526675282456768,226,8,218,15.467390071610119,13,987,0.2,14
2020-10-04 16:00:00+02:00,164,6,158,18.874121315806054,226,8,218,15.467390071610119,13,987,0.2,14
2020-10-04 17:00:00+02:00,186,7,179,20.400698976924794,238,8,230,14.411005913654613,13,987,0.2,14
2020-10-04 18:00:00+02:00,179,7,172,21.74229179161351,205,7,198,22.456574383830734,13,987,0.2,14
2020-10-04 19:00:00+02:00,145,5,140,19.922746131926434,191,6,185,21.61132830766016,13,987,0.2,14
2020-10-04 20:00:00+02:00,139,5,134,19.408576933840735,184,7,177,19.759138180971462,13,987,0.2,14
2020-10-04 21:00:00+02:00,120,4,116,15.329119598546,124,4,120,14.467255533674502,13,987,0.2,14
2020-10-04 22:00:00+02:00,91,3,88,8.844154374326946,117,4,113,13.539944397802945,13,987,0.2,14
2020-10-04 23:00:00+02:00,48,1,47,9.964553643509852,63,2,61,11.83290839187245,13,987,0.2,14
2020-10-05 00:00:00+02:00,37,3,34,2.066086063070793,39,4,35,6.782457974710225,12,996,0.3,27
2020-10-05 01:00:00+02:00,24,2,22,1.5004308879154395,26,2,24,1.5382661455122164,12,996,0.3,27
2020-10-05 02:00:00+02:00,24,2,22,1.5004308879154395,26,2,24,1.5382661455122164,12,996,0.3,27
2020-10-05 03:00:00+02:00,37,3,34,2.066086063070793,39,4,35,6.782457974710225,12,996,0.3,27
2020-10-05 04:00:00+02:00,60,5,55,10.583722413773145,62,6,56,14.48690450543278,12,996,0.3,27
2020-10-05 05:00:00+02:00,108,10,98,14.813734676069407,112,11,101,14.898852003445265,12,996,0.3,27
2020-10-05 06:00:00+02:00,136,13,123,16.594078125250377,142,16,126,21.623487252479663,12,996,0.3,27
2020-10-05 07:00:00+02:00,226,22,204,20.308697708911414,214,23,191,18.560318290748608,12,996,0.3,27
2020-10-05 08:00:00+02:00,239,24,215,13.74553452780325,235,29,206,20.674840106170866,12,996,0.3,27
2020-10-05 09:00:00+02:00,154,16,138,23.457384968254527,151,18,133,19.408157188048275,12,996,0.3,27
2020-10-05 10:00:00+02:00,128,11,117,19.601953989978306,128,12,116,19.601953989978306,12,996,0.3,27
2020-10-05 11:00:00+02:00,152,13,139,20.188330220444417,154,15,139,23.457384968254527,12,996,0.3,27
2020-10-05 12:00:00+02:00,123,13,110,19.074654696202938,128,14,114,19.601953989978306,12,996,0.3,27
2020-10-05 13:00:00+02:00,127,11,116,19.116953333289125,125,13,112,23.026828253397017,12,996,0.3,27
2020-10-05 14:00:00+02:00,127,11,116,19.116953333289125,125,13,112,23.026828253397017,12,996,0.3,27
2020-10-05 15:00:00+02:00,139,12,127,18.732486269107348,137,15,122,18.928795118329443,12,996,0.3,27
2020-10-05 16:00:00+02:00,145,14,131,18.85528596371164,157,17,140,23.857880119976507,12,996,0.3,27
2020-10-05 17:00:00+02:00,216,21,195,21.273439412003903,220,27,193,16.758079648934128,12,996,0.3,27
2020-10-05 18:00:00+02:00,228,21,207,15.818609956751573,225,22,203,17.07968654570721,12,996,0.3,27
2020-10-05 19:00:00+02:00,168,15,153,20.304807772345505,167,18,149,21.39117903937357,12,996,0.3,27
2020-10-05 20:00:00+02:00,166,16,150,18.57114730689396,170,20,150,19.775542485132945,12,996,0.3,27
2020-10-05 21:00:00+02:00,122,13,109,20.245567873519157,131,15,116,14.183230975852695,12,996,0.3,27
2020-10-05 22:00:00+02:00,89,8,81,17.562315027840828,89,8,81,17.562315027840828,12,996,0.3,27
2020-10-05 23:00:00+02:00,63,5,58,14.929801273937542,62,6,56,14.48690450543278,12,996,0.3,27
2020-10-06 00:00:00+02:00,34,3,31,5.3950651883530085,42,4,38,5.988628884327601,14,1007,0.1,23
2020-10-06 01:00:00+02:00,26,2,24,1.5382661455122164,26,2,24,1.5382661455122164,14,1007,0.1,23
2020-10-06 02:00:00+02:00,26,2,24,1.5382661455122164,26,2,24,1.5382661455122164,14,1007,0.1,23
2020-10-06 03:00:00+02:00,39,3,36,6.782457974710225,38,3,35,11.101073107969722,14,1007,0.1,23
2020-10-06 04:00:00+02:00,64,6,58,14.414592943793718,70,7,63,13.53852946044019,14,1007,0.1,23
2020-10-06 05:00:00+02:00,117,10,107,21.891304075969387,128,12,116,19.601953989978306,14,1007,0.1,23
2020-10-06 06:00:00+02:00,136,11,125,16.594078125250377,154,15,139,23.457384968254527,14,1007,0.1,23
2020-10-06 07:00:00+02:00,205,20,185,13.47116079711613,235,20,215,20.674840106170866,14,1007,0.1,23
2020-10-06 08:00:00+02:00,227,21,206,19.269071808142694,239,23,216,13.74553452780325,14,1007,0.1,23
2020-10-06 09:00:00+02:00,155,15,140,19.469409355748308,159,17,142,17.78748005044877,14,1007,0.1,23
2020-10-06 10:00:00+02:00,124,10,114,17.53992981591413,132,14,118,19.37004764296085,14,1007,0.1,23
2020-10-06 11:00:00+02:00,149,14,135,20.003285796587473,171,14,157,22.137070929890193,14,1007,0.1,23
2020-10-06 12:00:00+02:00,123,10,113,19.074654696202938,137,14,123,18.928795118329443,14,1007,0.1,23
2020-10-06 13:00:00+02:00,118,10,108,23.272574380346793,142,13,129,21.623487252479663,14,1007,0.1,23
2020-10-06 14:00:00+02:00,130,11,119,15.65660051079879,137,11,126,18.928795118329443,14,1007,0.1,23
2020-10-06 15:00:00+02:00,130,12,118,15.65660051079879,151,13,138,19.408157188048275,14,1007,0.1,23
2020-10-06 16:00:00+02:00,150,12,138,17.939622434692456,171,14,157,22.137070929890193,14,1007,0.1,23
2020-10-06 17:00:00+02:00,208,18,190,17.851758798784658,237,20,217,15.922060682410839,14,1007,0.1,23
2020-10-06 18:00:00+02:00,234,23,211,19.754580108435302,239,23,216,13.74553452780325,14,1007,0.1,23
2020-10-06 19:00:00+02:00,169,16,153,18.567569965901342,181,20,161,20.051163259817507,14,1007,0.1,23
2020-10-06 20:00:00+02:00,159,13,146,17.78748005044877,178,15,163,19.804789777436813,14,1007,0.1,23
2020-10-06 21:00:00+02:00,123,10,113,19.074654696202938,137,14,123,18.928795118329443,14,1007,0.1,23
2020-10-06 22:00:00+02:00,83,7,76,18.699193296190067,94,9,85,13.172779715339633,14,1007,0.1,23
2020-10-06 23:00:00+02:00,59,5,54,10.572210467564378,65,6,59,15.361527134905547,14,1007,0.1,23
2020-10-07 00:00:00+02:00,38,4,34,7.590795833711637,34,3,31,11.019687492562438,14,1008,0.4,25
2020-10-07 01:00:00+02:00,25,3,22,4.851536786659508,25,2,23,4.851536786659508,14,1008,0.4,25
2020-10-07 02:00:00+02:00,25,2,23,4.851536786659508,25,2,23,4.851536786659508,14,1008,0.4,25
2020-10-07 03:00:00+02:00,38,4,34,7.590795833711637,34,3,31,11.019687492562438,14,1008,0.4,25
2020-10-07 04:00:00+02:00,63,7,56,13.630126271531418,62,6,56,12.779859753427614,14,1008,0.4,25
2020-10-07 05:00:00+02:00,114,13,101,17.516346710171707,112,12,100,16.537505199847164,14,1008,0.4,25
2020-10-07 06:00:00+02:00,140,19,121,17.88117043007633,141,14,127,16.082921323202,14,1008,0.4,25
2020-10-07 07:00:00+02:00,214,24,190,24.48806340301503,203,19,184,21.5050173548228,14,1008,0.4,25
2020-10-07 08:00:00+02:00,226,28,198,20.105295377891462,220,27,193,18.729640796362187,14,1008,0.4,25
2020-10-07 09:00:00+02:00,153,19,134,18.89706115395996,139,16,123,21.474746575274906,14,1008,0.4,25
2020-10-07 10:00:00+02:00,126,17,109,16.250667590352332,123,13,110,15.262138605096247,14,1008,0.4,25
2020-10-07 11:00:00+02:00,153,18,135,18.89706115395996,139,16,123,21.474746575274906,14,1008,0.4,25
2020-10-07 12:00:00+02:00,126,17,109,16.250667590352332,123,13,110,15.262138605096247,14,1008,0.4,25
2020-10-07 13:00:00+02:00,127,15,112,19.95892802947898,120,14,106,10.291257377501918,14,1008,0.4,25
2020-10-07 14:00:00+02:00,127,16,111,19.95892802947898,120,14,106,10.291257377501918,14,1008,0.4,25
2020-10-07 15:00:00+02:00,140,18,122,17.88117043007633,141,14,127,16.082921323202,14,1008,0.4,25
2020-10-07 16:00:00+02:00,151,17,134,19.198981193831877,149,16,133,18.476483571588744,14,1008,0.4,25
2020-10-07 17:00:00+02:00,217,26,191,20.47500927792046,213,24,189,16.70464389525102,14,1008,0.4,25
2020-10-07 18:00:00+02:00,232,26,206,24.606618615768106,205,22,183,18.29833304368066,14,1008,0.4,25
2020-10-07 19:00:00+02:00,167,22,145,16.493575022686013,154,14,140,25.102227050596255,14,1008,0.4,25
2020-10-07 20:00:00+02:00,167,21,146,16.493575022686013,154,14,140,25.102227050596255,14,1008,0.4,25
2020-10-07 21:00:00+02:00,129,16,113,12.321757402623772,125,13,112,14.698947587184879,14,1008,0.4,25
2020-10-07 22:00:00+02:00,89,11,78,16.127888447212325,79,9,70,16.621554061874914,14,1008,0.4,25
2020-10-07 23:00:00+02:00,63,8,55,13.630126271531418,62,6,56,12.779859753427614,14,1008,0.4,25
2020-10-08 00:00:00+02:00,86,6,80,21.204994436842384,89,10,79,17.562315027840828,17,1020,0.0,13
2020-10-08 01:00:00+02:00,61,5,56,12.362973378192347,57,7,50,10.480552878481939,17,1020,0.0,13
2020-10-08 02:00:00+02:00,59,4,55,10.572210467564378,57,7,50,10.480552878481939,17,1020,0.0,13
2020-10-08 03:00:00+02:00,89,7,82,17.562315027840828,89,10,79,17.562315027840828,17,1020,0.0,13
2020-10-08 04:00:00+02:00,153,13,140,14.915022999208679,153,19,134,14.915022999208679,17,1020,0.0,13
2020-10-08 05:00:00+02:00,257,19,238,24.369710124951805,280,35,245,25.91177046818179,17,1020,0.0,13
2020-10-08 06:00:00+02:00,312,27,285,18.640393178431868,334,44,290,23.256671102053218,17,1020,0.0,13
2020-10-08 07:00:00+02:00,528,43,485,18.074163042875583,520,83,437,21.447261472760864,17,1020,0.0,13
2020-10-08 08:00:00+02:00,557,44,513,19.98095345665478,555,78,477,17.57269749774077,17,1020,0.0,13
2020-10-08 09:00:00+02:00,354,30,324,21.22371738501729,359,47,312,21.41163694321985,17,1020,0.0,13
2020-10-08 10:00:00+02:00,280,24,256,25.91177046818179,305,47,258,19.342371998402466,17,1020,0.0,13
2020-10-08 11:00:00+02:00,332,25,307,21.454526645627976,362,47,315,18.208767664177746,17,1020,0.0,13
2020-10-08 12:00:00+02:00,314,27,287,19.381500590217087,302,38,264,17.71336274061634,17,1020,0.0,13
2020-10-08 13:00:00+02:00,270,22,248,23.920073269237992,312,39,273,18.640393178431868,17,1020,0.0,13
2020-10-08 14:00:00+02:00,309,27,282,17.68578168988432,305,41,264,19.342371998402466,17,1020,0.0,13
2020-10-08 15:00:00+02:00,305,23,282,19.342371998402466,327,42,285,17.492932564197055,17,1020,0.0,13
2020-10-08 16:00:00+02:00,369,33,336,22.180217499440115,357,51,306,21.912097396672888,17,1020,0.0,13
2020-10-08 17:00:00+02:00,520,40,480,21.447261472760864,515,81,434,22.56064635427968,17,1020,0.0,13
2020-10-08 18:00:00+02:00,543,49,494,23.469937738067248,520,66,454,21.447261472760864,17,1020,0.0,13
2020-10-08 19:00:00+02:00,401,31,370,26.708807440790352,391,58,333,20.019115852021912,17,1020,0.0,13
2020-10-08 20:00:00+02:00,359,27,332,21.41163694321985,389,59,330,21.37920911023894,17,1020,0.0,13
2020-10-08 21:00:00+02:00,277,21,256,24.920160895876304,317,47,270,23.692514426518255,17,1020,0.0,13
2020-10-08 22:00:00+02:00,190,15,175,20.51689583562818,210,28,182,16.3212742992447,17,1020,0.0,13
2020-10-08 23:00:00+02:00,143,10,133,22.510370466296816,148,23,125,18.058884943386857,17,1020,0.0,13
2020-10-09 00:00:00+02:00,38,3,35,11.101073107969722,38,4,34,11.101073107969722,16,1019,1.1,17
2020-10-09 01:00:00+02:00,25,2,23,1.1875344360364632,25,2,23,1.1875344360364632,16,1019,1.1,17
2020-10-09 02:00:00+02:00,25,2,23,1.1875344360364632,25,2,23,1.1875344360364632,16,1019,1.1,17
2020-10-09 03:00:00+02:00,37,3,34,2.066086063070793,38,4,34,11.101073107969722,16,1019,1.1,17
2020-10-09 04:00:00+02:00,63,6,57,14.929801273937542,58,5,53,10.505136369992313,16,1019,1.1,17
2020-10-09 05:00:00+02:00,113,12,101,20.093188266697116,113,11,102,20.093188266697116,16,1019,1.1,17
2020-10-09 06:00:00+02:00,140,13,127,15.331768592489755,129,13,116,17.995114557081255,16,1019,1.1,17
2020-10-09 07:00:00+02:00,210,19,191,16.3212742992447,212,18,194,18.597605283865732,16,1019,1.1,17
2020-10-09 08:00:00+02:00,228,23,205,15.818609956751573,211,19,192,18.759232281731908,16,1019,1.1,17
2020-10-09 09:00:00+02:00,147,14,133,20.208056467665056,153,13,140,14.915022999208679,16,1019,1.1,17
2020-10-09 10:00:00+02:00,124,11,113,17.53992981591413,117,12,105,21.891304075969387,16,1019,1.1,17
2020-10-09 11:00:00+02:00,153,15,138,14.915022999208679,148,13,135,18.058884943386857,16,1019,1.1,17
2020-10-09 12:00:00+02:00,129,13,116,17.995114557081255,123,10,113,19.074654696202938,16,1019,1.1,17
2020-10-09 13:00:00+02:00,124,12,112,17.53992981591413,117,12,105,21.891304075969387,16,1019,1.1,17
2020-10-09 14:00:00+02:00,128,12,116,19.601953989978306,123,10,113,19.074654696202938,16,1019,1.1,17
2020-10-09 15:00:00+02:00,136,14,122,16.594078125250377,138,14,124,20.21600799483387,16,1019,1.1,17
2020-10-09 16:00:00+02:00,145,14,131,18.85528596371164,154,15,139,23.457384968254527,16,1019,1.1,17
2020-10-09 17:00:00+02:00,207,22,185,21.877297854955202,202,19,183,22.500350864850866,16,1019,1.1,17
2020-10-09 18:00:00+02:00,218,21,197,22.57742359713229,227,25,202,19.269071808142694,16,1019,1.1,17
2020-10-09 19:00:00+02:00,158,15,143,21.67102174389251,159,15,144,17.78748005044877,16,1019,1.1,17
2020-10-09 20:00:00+02:00,160,14,146,19.89239402952506,159,13,146,17.78748005044877,16,1019,1.1,17
2020-10-09 21:00:00+02:00,123,11,112,19.074654696202938,123,12,111,19.074654696202938,16,1019,1.1,17
2020-10-09 22:00:00+02:00,86,8,78,21.204994436842384,85,7,78,19.289671453475872,16,1019,1.1,17
2020-10-09 23:00:00+02:00,61,6,55,12.362973378192347,58,5,53,10.505136369992313,16,1019,1.1,17
2020-10-10 00:00:00+02:00,83,5,78,9.333357558089729,88,4,84,8.437594054986977,13,1021,0.0,11
2020-10-10 01:00:00+02:00,54,3,51,11.483713237443984,58,3,55,11.561797090249616,13,1021,0.0,11
2020-10-10 02:00:00+02:00,54,3,51,11.483713237443984,58,3,55,11.561797090249616,13,1021,0.0,11
2020-10-10 03:00:00+02:00,81,4,77,13.380409900215524,88,4,84,8.437594054986977,13,1021,0.0,11
2020-10-10 04:00:00+02:00,108,6,102,15.795702759121413,117,7,110,13.539944397802945,13,1021,0.0,11
2020-10-10 05:00:00+02:00,140,9,131,15.157104538016958,149,9,140,17.937448228249327,13,1021,0.0,11
2020-10-10 06:00:00+02:00,221,13,208,21.310706623471727,232,12,220,19.09590246733257,13,1021,0.0,11
2020-10-10 07:00:00+02:00,334,21,313,17.139636433234756,354,17,337,22.475031570210557,13,1021,0.0,11
2020-10-10 08:00:00+02:00,460,27,433,21.56348705434536,474,29,445,22.587368250433876,13,1021,0.0,11
2020-10-10 09:00:00+02:00,492,30,462,23.51531207195642,506,27,479,16.816277078158848,13,1021,0.0,11
2020-10-10 10:00:00+02:00,431,29,402,19.594917580038825,436,29,407,17.144177199139556,13,1021,0.0,11
2020-10-10 11:00:00+02:00,332,19,313,20.862138293674573,357,20,337,16.579219218063535,13,1021,0.0,11
2020-10-10 12:00:00+02:00,345,20,325,21.567585441367726,354,23,331,22.475031570210557,13,1021,0.0,11
2020-10-10 13:00:00+02:00,375,22,353,21.145699806578275,379,24,355,19.424797748224545,13,1021,0.0,11
2020-10-10 14:00:00+02:00,341,21,320,18.927558745642923,354,21,333,22.475031570210557,13,1021,0.0,11
2020-10-10 15:00:00+02:00,402,23,379,13.628611178524041,409,27,382,21.901781937406163,13,1021,0.0,11
2020-10-10 16:00:00+02:00,393,26,367,17.925669706725596,411,25,386,17.61880175865933,13,1021,0.0,11
2020-10-10 17:00:00+02:00,451,30,421,21.269750099500666,467,30,437,16.282567715081857,13,1021,0.0,11
2020-10-10 18:00:00+02:00,420,27,393,19.34293358515217,440,29,411,20.915500855429855,13,1021,0.0,11
2020-10-10 19:00:00+02:00,332,20,312,20.862138293674573,357,20,337,16.579219218063535,13,1021,0.0,11
2020-10-10 20:00:00+02:00,316,18,298,17.068110656006358,327,21,306,19.796623391570257,13,1021,0.0,11
2020-10-10 21:00:00+02:00,286,16,270,20.747694740560487,296,17,279,18.406113827007673,13,1021,0.0,11
2020-10-10 22:00:00+02:00,221,12,209,21.310706623471727,232,12,220,19.09590246733257,13,1021,0.0,11
2020-10-10 23:00:00+02:00,110,6,104,20.964248322238312,117,6,111,13.539944397802945,13,1021,0.0,11
2020-10-11 00:00:00+02:00,43,1,42,8.357669380798958,43,1,42,8.357669380798958,12,1023,0.0,12
2020-10-11 01:00:00+02:00,26,1,25,0.13434729751860394,39,1,38,6.913338666308079,12,1023,0.0,12
2020-10-11 02:00:00+02:00,26,1,25,0.13434729751860394,39,1,38,6.913338666308079,12,1023,0.0,12
2020-10-11 03:00:00+02:00,41,1,40,7.51149883575918,55,1,54,10.027044718132117,12,1023,0.0,12
2020-10-11 04:00:00+02:00,53,2,51,12.671576687621188,57,2,55,11.247345675463038,12,1023,0.0,12
2020-10-11 05:00:00+02:00,76,3,73,13.279950485691732,98,4,94,9.366341704429512,12,1023,0.0,12
2020-10-11 06:00:00+02:00,117,5,112,13.539944397802945,137,5,132,15.965917364236809,12,1023,0.0,12
2020-10-11 07:00:00+02:00,178,7,171,18.00585359354758,183,6,177,15.872019474492381,12,1023,0.0,12
2020-10-11 08:00:00+02:00,228,8,220,19.28787791304013,285,11,274,19.95607218889837,12,1023,0.0,12
2020-10-11 09:00:00+02:00,250,9,241,19.251014174910523,263,9,254,18.06193495748254,12,1023,0.0,12
2020-10-11 10:00:00+02:00,213,7,206,20.238518600536185,277,11,266,19.768862676933345,12,1023,0.0,12
2020-10-11 11:00:00+02:00,170,6,164,18.89757152881458,209,9,200,16.60419034744366,12,1023,0.0,12
2020-10-11 12:00:00+02:00,178,7,171,18.00585359354758,183,6,177,15.872019474492381,12,1023,0.0,12
2020-10-11 13:00:00+02:00,185,7,178,20.88033942284811,217,8,209,18.791759657796693,12,1023,0.0,12
2020-10-11 14:00:00+02:00,164,6,158,18.874121315806054,232,8,224,19.09590246733257,12,1023,0.0,12
2020-10-11 15:00:00+02:00,199,8,191,19.11274068140836,244,8,236,18.556057346091794,12,1023,0.0,12
2020-10-11 16:00:00+02:00,205,8,197,22.456574383830734,248,8,240,17.022549227170337,12,1023,0.0,12
2020-10-11 17:00:00+02:00,234,8,226,18.523045519331724,273,10,263,23.139691796211615,12,1023,0.0,12
2020-10-11 18:00:00+02:00,217,9,208,18.791759657796693,222,7,215,17.594973015311762,12,1023,0.0,12
2020-10-11 19:00:00+02:00,170,7,163,18.89757152881458,209,9,200,16.60419034744366,12,1023,0.0,12
2020-10-11 20:00:00+02:00,162,6,156,18.435104799511247,191,7,184,21.61132830766016,12,1023,0.0,12
2020-10-11 21:00:00+02:00,152,6,146,18.686880121910534,146,5,141,19.4340926707284,12,1023,0.0,12
2020-10-11 22:00:00+02:00,115,4,111,14.522258078721798,160,6,154,18.858823274894117,12,1023,0.0,12
2020-10-11 23:00:00+02:00,57,2,55,11.247345675463038,76,3,73,13.279950485691732,12,1023,0.0,12
2020-10-12 00:00:00+02:00,85,8,77,19.289671453475872,85,9,76,19.289671453475872,12,1025,0.0,10
2020-10-12 01:00:00+02:00,54,5,49,10.37826089518735,56,6,50,10.152150256689218,12,1025,0.0,10
2020-10-12 02:00:00+02:00,58,5,53,10.505136369992313,56,6,50,10.152150256689218,12,1025,0.0,10
2020-10-12 03:00:00+02:00,88,8,80,17.756927742208592,88,10,78,17.756927742208592,12,1025,0.0,10
2020-10-12 04:00:00+02:00,149,15,134,20.003285796587473,146,13,133,20.98788244482569,12,1025,0.0,10
2020-10-12 05:00:00+02:00,266,24,242,24.416240816629376,257,27,230,24.369710124951805,12,1025,0.0,10
2020-10-12 06:00:00+02:00,322,29,293,22.976009334024873,327,40,287,17.492932564197055,12,1025,0.0,10
2020-10-12 07:00:00+02:00,478,44,434,19.93054974447541,505,63,442,18.43415123810773,12,1025,0.0,10
2020-10-12 08:00:00+02:00,526,57,469,21.343558174072673,514,61,453,17.018673574730677,12,1025,0.0,10
2020-10-12 09:00:00+02:00,343,35,308,18.604951737824955,350,33,317,21.39774246689966,12,1025,0.0,10
2020-10-12 10:00:00+02:00,291,29,262,17.50237418524224,286,29,257,20.398524223626136,12,1025,0.0,10
2020-10-12 11:00:00+02:00,359,38,321,21.41163694321985,343,40,303,18.604951737824955,12,1025,0.0,10
2020-10-12 12:00:00+02:00,293,26,267,19.851789935750844,293,32,261,19.851789935750844,12,1025,0.0,10
2020-10-12 13:00:00+02:00,295,29,266,20.557446011766526,284,27,257,21.60666647068217,12,1025,0.0,10
2020-10-12 14:00:00+02:00,286,25,261,20.398524223626136,295,35,260,20.557446011766526,12,1025,0.0,10
2020-10-12 15:00:00+02:00,307,28,279,19.62844127124222,313,38,275,23.332837891570005,12,1025,0.0,10
2020-10-12 16:00:00+02:00,343,31,312,18.604951737824955,350,33,317,21.39774246689966,12,1025,0.0,10
2020-10-12 17:00:00+02:00,494,50,444,22.10454361750988,494,62,432,22.10454361750988,12,1025,0.0,10
2020-10-12 18:00:00+02:00,526,57,469,21.343558174072673,514,61,453,17.018673574730677,12,1025,0.0,10
2020-10-12 19:00:00+02:00,372,38,334,17.388398109436665,374,39,335,18.17629135420491,12,1025,0.0,10
2020-10-12 20:00:00+02:00,372,35,337,17.388398109436665,374,39,335,18.17629135420491,12,1025,0.0,10
2020-10-12 21:00:00+02:00,286,27,259,20.398524223626136,295,35,260,20.557446011766526,12,1025,0.0,10
2020-10-12 22:00:00+02:00,194,17,177,21.593451125557873,205,24,181,13.47116079711613,12,1025,0.0,10
2020-10-12 23:00:00+02:00,144,13,131,22.91915418498221,142,17,125,21.623487252479663,12,1025,0.0,10
2020-10-13 00:00:00+02:00,60,5,55,10.583722413773145,60,5,55,10.583722413773145,11,1015,0.2,13
2020-10-13 01:00:00+02:00,36,3,33,3.0873599992209124,44,3,41,6.744796902616623,11,1015,0.2,13
2020-10-13 02:00:00+02:00,41,3,38,8.457036189746331,44,4,40,6.744796902616623,11,1015,0.2,13
2020-10-13 03:00:00+02:00,60,5,55,10.583722413773145,60,5,55,10.583722413773145,11,1015,0.2,13
2020-10-13 04:00:00+02:00,92,8,84,10.404364071122256,103,9,94,12.113442962320551,11,1015,0.2,13
2020-10-13 05:00:00+02:00,179,17,162,19.18236787964663,198,21,177,18.14522738171017,11,1015,0.2,13
2020-10-13 06:00:00+02:00,221,18,203,20.34114880306217,236,20,216,19.106111918840778,11,1015,0.2,13
2020-10-13 07:00:00+02:00,335,32,303,21.419812345615075,351,37,314,16.04918751558848,11,1015,0.2,13
2020-10-13 08:00:00+02:00,346,31,315,20.434066589603663,394,45,349,21.238013248853637,11,1015,0.2,13
2020-10-13 09:00:00+02:00,234,20,214,19.754580108435302,249,24,225,20.976233072746222,11,1015,0.2,13
2020-10-13 10:00:00+02:00,205,17,188,13.47116079711613,216,19,197,21.273439412003903,11,1015,0.2,13
2020-10-13 11:00:00+02:00,239,23,216,13.74553452780325,267,29,238,13.385499595100717,11,1015,0.2,13
2020-10-13 12:00:00+02:00,207,18,189,21.877297854955202,208,19,189,17.851758798784658,11,1015,0.2,13
2020-10-13 13:00:00+02:00,197,16,181,19.020846849172088,221,19,202,20.34114880306217,11,1015,0.2,13
2020-10-13 14:00:00+02:00,193,15,178,21.558071117560736,216,20,196,21.273439412003903,11,1015,0.2,13
2020-10-13 15:00:00+02:00,220,21,199,16.758079648934128,234,20,214,19.754580108435302,11,1015,0.2,13
2020-10-13 16:00:00+02:00,225,20,205,17.07968654570721,262,23,239,18.255168653975332,11,1015,0.2,13
2020-10-13 17:00:00+02:00,345,33,312,18.48984602659702,373,42,331,20.02368697341565,11,1015,0.2,13
2020-10-13 18:00:00+02:00,351,30,321,16.04918751558848,382,38,344,19.255057171585772,11,1015,0.2,13
2020-10-13 19:00:00+02:00,244,23,221,17.108671526861457,279,28,251,23.809963875172556,11,1015,0.2,13
2020-10-13 20:00:00+02:00,258,25,233,21.93153719781745,271,25,246,24.814459053724722,11,1015,0.2,13
2020-10-13 21:00:00+02:00,200,16,184,19.256012935412965,208,21,187,17.851758798784658,11,1015,0.2,13
2020-10-13 22:00:00+02:00,138,11,127,20.21600799483387,144,14,130,22.91915418498221,11,1015,0.2,13
2020-10-13 23:00:00+02:00,95,9,86,11.735389228725284,106,9,97,12.94750706735717,11,1015,0.2,13
2020-10-14 00:00:00+02:00,100,13,87,17.894290172585407,87,9,78,17.188718365321975,11,1010,0.0,5
2020-10-14 01:00:00+02:00,65,7,58,10.373259911317103,65,6,59,10.373259911317103,11,1010,0.0,5
2020-10-14 02:00:00+02:00,65,7,58,10.373259911317103,65,6,59,10.373259911317103,11,1010,0.0,5
2020-10-14 03:00:00+02:00,100,11,89,17.894290172585407,87,9,78,17.188718365321975,11,1010,0.0,5
2020-10-14 04:00:00+02:00,168,20,148,18.818575971293154,155,14,141,20.64602175207135,11,1010,0.0,5
2020-10-14 05:00:00+02:00,303,38,265,23.70503562215664,274,26,248,27.25802623834161,11,1010,0.0,5
2020-10-14 06:00:00+02:00,366,42,324,18.901447571833554,358,41,317,18.812448071137492,11,1010,0.0,5
2020-10-14 07:00:00+02:00,572,77,495,16.900703125946286,556,59,497,24.52295551948352,11,1010,0.0,5
2020-10-14 08:00:00+02:00,596,74,522,27.829573384996415,606,60,546,17.760423192087483,11,1010,0.0,5
2020-10-14 09:00:00+02:00,398,45,353,17.528461730035602,406,48,358,23.347397986470767,11,1010,0.0,5
2020-10-14 10:00:00+02:00,332,42,290,19.089795695646295,337,42,295,13.20715492745961,11,1010,0.0,5
2020-10-14 11:00:00+02:00,398,45,353,17.528461730035602,406,48,358,23.347397986470767,11,1010,0.0,5
2020-10-14 12:00:00+02:00,332,42,290,19.089795695646295,337,42,295,13.20715492745961,11,1010,0.0,5
2020-10-14 13:00:00+02:00,329,37,292,21.918140153112233,327,40,287,23.363012540914273,11,1010,0.0,5
2020-10-14 14:00:00+02:00,329,43,286,21.918140153112233,327,40,287,23.363012540914273,11,1010,0.0,5
2020-10-14 15:00:00+02:00,361,47,314,18.620400096098233,364,45,319,21.051236699694496,11,1010,0.0,5
2020-10-14 16:00:00+02:00,403,52,351,13.914029524281172,377,40,337,22.934146173926393,11,1010,0.0,5
2020-10-14 17:00:00+02:00,561,70,491,25.011004908764136,554,64,490,25.596672216234026,11,1010,0.0,5
2020-10-14 18:00:00+02:00,601,77,524,18.769354690301,585,58,527,19.751804156270225,11,1010,0.0,5
2020-10-14 19:00:00+02:00,432,58,374,14.46688954027777,416,44,372,18.869548080226345,11,1010,0.0,5
2020-10-14 20:00:00+02:00,430,58,372,22.816352618482806,411,51,360,23.42311543355913,11,1010,0.0,5
2020-10-14 21:00:00+02:00,332,43,289,19.089795695646295,337,42,295,13.20715492745961,11,1010,0.0,5
2020-10-14 22:00:00+02:00,232,26,206,24.606618615768106,211,22,189,18.135422908593412,11,1010,0.0,5
2020-10-14 23:00:00+02:00,168,19,149,18.818575971293154,155,14,141,20.64602175207135,11,1010,0.0,5
2020-10-15 00:00:00+02:00,45,3,42,8.16653528554085,45,6,39,8.16653528554085,9,1018,0.1,16
2020-10-15 01:00:00+02:00,28,2,26,4.026144260024548,28,3,25,4.026144260024548,9,1018,0.1,16
2020-10-15 02:00:00+02:00,25,2,23,1.1875344360364632,30,4,26,3.420694029650136,9,1018,0.1,16
2020-10-15 03:00:00+02:00,43,3,40,8.573704494863009,45,6,39,8.16653528554085,9,1018,0.1,16
2020-10-15 04:00:00+02:00,71,6,65,15.50461576454985,76,12,64,16.686685835236233,9,1018,0.1,16
2020-10-15 05:00:00+02:00,124,11,113,17.53992981591413,130,19,111,15.65660051079879,9,1018,0.1,16
2020-10-15 06:00:00+02:00,155,11,144,19.469409355748308,160,25,135,19.89239402952506,9,1018,0.1,16
2020-10-15 07:00:00+02:00,266,21,245,24.416240816629376,255,34,221,21.41944964647189,9,1018,0.1,16
2020-10-15 08:00:00+02:00,286,23,263,20.398524223626136,286,44,242,20.398524223626136,9,1018,0.1,16
2020-10-15 09:00:00+02:00,177,15,162,20.028957588616944,189,26,163,18.951286202533417,9,1018,0.1,16
2020-10-15 10:00:00+02:00,138,10,128,20.21600799483387,144,21,123,22.91915418498221,9,1018,0.1,16
2020-10-15 11:00:00+02:00,165,14,151,20.56038540292619,182,28,154,17.128604685093855,9,1018,0.1,16
2020-10-15 12:00:00+02:00,139,10,129,18.732486269107348,144,21,123,22.91915418498221,9,1018,0.1,16
2020-10-15 13:00:00+02:00,137,12,125,18.928795118329443,144,21,123,22.91915418498221,9,1018,0.1,16
2020-10-15 14:00:00+02:00,137,12,125,18.928795118329443,144,21,123,22.91915418498221,9,1018,0.1,16
2020-10-15 15:00:00+02:00,151,13,138,19.408157188048275,168,21,147,20.304807772345505,9,1018,0.1,16
2020-10-15 16:00:00+02:00,170,13,157,19.775542485132945,175,27,148,17.666202741429842,9,1018,0.1,16
2020-10-15 17:00:00+02:00,266,23,243,24.416240816629376,255,34,221,21.41944964647189,9,1018,0.1,16
2020-10-15 18:00:00+02:00,286,23,263,20.398524223626136,286,44,242,20.398524223626136,9,1018,0.1,16
2020-10-15 19:00:00+02:00,192,16,176,21.295822766447603,198,26,172,18.14522738171017,9,1018,0.1,16
2020-10-15 20:00:00+02:00,203,16,187,24.82410288636225,191,27,164,20.658016380524305,9,1018,0.1,16
2020-10-15 21:00:00+02:00,149,12,137,20.003285796587473,156,19,137,23.175119746499636,9,1018,0.1,16
2020-10-15 22:00:00+02:00,95,8,87,11.735389228725284,105,13,92,15.778065052313549,9,1018,0.1,16
2020-10-15 23:00:00+02:00,72,6,66,19.53768091870668,79,10,69,16.382916607013883,9,1018,0.1,16
2020-10-16 00:00:00+02:00,68,6,62,14.701855472363336,70,7,63,13.53852946044019,11,1021,0.0,13
2020-10-16 01:00:00+02:00,46,4,42,9.245167395738047,46,4,42,9.245167395738047,11,1021,0.0,13
2020-10-16 02:00:00+02:00,46,4,42,9.245167395738047,46,4,42,9.245167395738047,11,1021,0.0,13
2020-10-16 03:00:00+02:00,68,6,62,14.701855472363336,70,7,63,13.53852946044019,11,1021,0.0,13
2020-10-16 04:00:00+02:00,116,10,106,23.67872830820291,116,11,105,23.67872830820291,11,1021,0.0,13
2020-10-16 05:00:00+02:00,210,22,188,16.3212742992447,207,18,189,21.877297854955202,11,1021,0.0,13
2020-10-16 06:00:00+02:00,247,23,224,18.30797612224211,238,20,218,16.13336525085207,11,1021,0.0,13
2020-10-16 07:00:00+02:00,388,39,349,23.106523601706122,404,38,366,21.094548442403457,11,1021,0.0,13
2020-10-16 08:00:00+02:00,423,38,385,23.290663678046883,414,46,368,21.211929621647883,11,1021,0.0,13
2020-10-16 09:00:00+02:00,282,29,253,14.328617212432716,275,31,244,24.67224255888931,11,1021,0.0,13
2020-10-16 10:00:00+02:00,229,25,204,19.950856030294574,231,20,211,16.702836426900134,11,1021,0.0,13
2020-10-16 11:00:00+02:00,277,25,252,24.920160895876304,284,29,255,21.60666647068217,11,1021,0.0,13
2020-10-16 12:00:00+02:00,229,20,209,19.950856030294574,231,20,211,16.702836426900134,11,1021,0.0,13
2020-10-16 13:00:00+02:00,231,21,210,16.702836426900134,231,20,211,16.702836426900134,11,1021,0.0,13
2020-10-16 14:00:00+02:00,231,21,210,16.702836426900134,231,20,211,16.702836426900134,11,1021,0.0,13
2020-10-16 15:00:00+02:00,253,23,230,24.084070139549794,249,26,223,20.976233072746222,11,1021,0.0,13
2020-10-16 16:00:00+02:00,281,27,254,17.665733770068634,275,31,244,24.67224255888931,11,1021,0.0,13
2020-10-16 17:00:00+02:00,392,42,350,15.515848376438075,388,37,351,23.106523601706122,11,1021,0.0,13
2020-10-16 18:00:00+02:00,421,41,380,22.41212221732918,417,40,377,23.51661645113794,11,1021,0.0,13
2020-10-16 19:00:00+02:00,306,28,278,17.3472177808044,286,31,255,20.398524223626136,11,1021,0.0,13
2020-10-16 20:00:00+02:00,305,32,273,19.342371998402466,288,26,262,22.858888837585067,11,1021,0.0,13
2020-10-16 21:00:00+02:00,234,21,213,19.754580108435302,218,21,197,22.57742359713229,11,1021,0.0,13
2020-10-16 22:00:00+02:00,160,17,143,19.89239402952506,157,13,144,23.857880119976507,11,1021,0.0,13
2020-10-16 23:00:00+02:00,112,11,101,14.898852003445265,110,10,100,16.975871844207738,11,1021,0.0,13
2020-10-17 00:00:00+02:00,77,4,73,11.693765322784895,83,5,78,9.333357558089729,10,1021,0.0,9
2020-10-17 01:00:00+02:00,51,2,49,13.024781207847502,55,3,52,10.027044718132117,10,1021,0.0,9
2020-10-17 02:00:00+02:00,51,3,48,13.024781207847502,55,3,52,10.027044718132117,10,1021,0.0,9
2020-10-17 03:00:00+02:00,77,4,73,11.693765322784895,83,5,78,9.333357558089729,10,1021,0.0,9
2020-10-17 04:00:00+02:00,105,5,100,16.343560716114418,111,6,105,16.60196152330297,10,1021,0.0,9
2020-10-17 05:00:00+02:00,135,8,127,20.27811899595658,141,8,133,17.007652233540448,10,1021,0.0,9
2020-10-17 06:00:00+02:00,218,13,205,17.36015147829793,220,13,207,20.77869221062603,10,1021,0.0,9
2020-10-17 07:00:00+02:00,310,18,292,15.258998808795859,332,19,313,20.862138293674573,10,1021,0.0,9
2020-10-17 08:00:00+02:00,433,26,407,17.57064657679897,445,23,422,21.520045849832552,10,1021,0.0,9
2020-10-17 09:00:00+02:00,460,27,433,21.56348705434536,480,29,451,22.699493069996517,10,1021,0.0,9
2020-10-17 10:00:00+02:00,403,25,378,21.627704849822535,415,27,388,20.29207139621444,10,1021,0.0,9
2020-10-17 11:00:00+02:00,319,21,298,23.232042011552885,334,18,316,17.139636433234756,10,1021,0.0,9
2020-10-17 12:00:00+02:00,321,18,303,17.9619971253537,340,18,322,14.37984208663957,10,1021,0.0,9
2020-10-17 13:00:00+02:00,336,21,315,15.374523455613796,366,18,348,16.269939741661524,10,1021,0.0,9
2020-10-17 14:00:00+02:00,325,19,306,18.163130994775884,334,21,313,17.139636433234756,10,1021,0.0,9
2020-10-17 15:00:00+02:00,375,21,354,21.145699806578275,388,25,363,20.16254491947918,10,1021,0.0,9
2020-10-17 16:00:00+02:00,383,24,359,21.26625994117601,396,22,374,19.03159851440849,10,1021,0.0,9
2020-10-17 17:00:00+02:00,437,25,412,20.40675859398746,452,24,428,22.405685364755907,10,1021,0.0,9
2020-10-17 18:00:00+02:00,413,23,390,15.570830889271724,420,27,393,19.34293358515217,10,1021,0.0,9
2020-10-17 19:00:00+02:00,315,21,294,17.275310260978717,338,21,317,21.621773010719025,10,1021,0.0,9
2020-10-17 20:00:00+02:00,293,20,273,17.329297501722674,306,16,290,16.19476586954662,10,1021,0.0,9
2020-10-17 21:00:00+02:00,261,16,245,17.831444140197515,282,15,267,20.995138580232226,10,1021,0.0,9
2020-10-17 22:00:00+02:00,210,12,198,17.488096079787415,222,11,211,17.594973015311762,10,1021,0.0,9
2020-10-17 23:00:00+02:00,105,6,99,16.343560716114418,111,6,105,16.60196152330297,10,1021,0.0,9
2020-10-18 00:00:00+02:00,60,2,58,12.98342242386016,77,3,74,11.693765322784895,13,1023,0.0,5
2020-10-18 01:00:00+02:00,40,1,39,6.907029621336792,51,1,50,13.024781207847502,13,1023,0.0,5
2020-10-18 02:00:00+02:00,40,1,39,6.907029621336792,51,1,50,13.024781207847502,13,1023,0.0,5
2020-10-18 03:00:00+02:00,60,2,58,12.98342242386016,77,3,74,11.693765322784895,13,1023,0.0,5
2020-10-18 04:00:00+02:00,82,3,79,8.6962433625344,91,3,88,8.844154374326946,13,1023,0.0,5
2020-10-18 05:00:00+02:00,100,3,97,12.129363492765288,131,5,126,17.703689985975256,13,1023,0.0,5
2020-10-18 06:00:00+02:00,151,6,145,19.14578123638998,188,6,182,19.664617237016223,13,1023,0.0,5
2020-10-18 07:00:00+02:00,237,8,229,17.058494417352218,257,9,248,18.99808160477331,13,1023,0.0,5
2020-10-18 08:00:00+02:00,337,13,324,20.189680789887703,389,13,376,18.813833392506616,13,1023,0.0,5
2020-10-18 09:00:00+02:00,340,13,327,14.37984208663957,354,14,340,22.475031570210557,13,1023,0.0,5
2020-10-18 10:00:00+02:00,314,11,303,19.77016372636934,426,18,408,21.709897607590275,13,1023,0.0,5
2020-10-18 11:00:00+02:00,231,9,222,18.808415660395674,320,13,307,21.84611391715035,13,1023,0.0,5
2020-10-18 12:00:00+02:00,254,11,243,20.69602346457387,320,13,307,21.84611391715035,13,1023,0.0,5
2020-10-18 13:00:00+02:00,277,12,265,19.768862676933345,309,10,299,20.22531439412751,13,1023,0.0,5
2020-10-18 14:00:00+02:00,237,8,229,17.058494417352218,257,9,248,18.99808160477331,13,1023,0.0,5
2020-10-18 15:00:00+02:00,294,11,283,17.632695676481745,311,10,301,18.777054340822975,13,1023,0.0,5
2020-10-18 16:00:00+02:00,271,10,261,22.542411999396236,334,11,323,17.139636433234756,13,1023,0.0,5
2020-10-18 17:00:00+02:00,326,11,315,17.62714820570872,406,15,391,14.646774291249367,13,1023,0.0,5
2020-10-18 18:00:00+02:00,314,13,301,19.77016372636934,426,18,408,21.709897607590275,13,1023,0.0,5
2020-10-18 19:00:00+02:00,231,9,222,18.808415660395674,320,13,307,21.84611391715035,13,1023,0.0,5
2020-10-18 20:00:00+02:00,234,10,224,18.523045519331724,260,10,250,14.992506001947714,13,1023,0.0,5
2020-10-18 21:00:00+02:00,206,8,198,20.90053052788098,228,8,220,19.28787791304013,13,1023,0.0,5
2020-10-18 22:00:00+02:00,160,6,154,18.858823274894117,194,7,187,19.241214114048436,13,1023,0.0,5
2020-10-18 23:00:00+02:00,80,2,78,12.9514806028411,105,4,101,16.343560716114418,13,1023,0.0,5
2020-10-19 00:00:00+02:00,113,11,102,20.093188266697116,119,12,107,22.46945513312648,12,1024,0.0,2
2020-10-19 01:00:00+02:00,76,7,69,16.686685835236233,76,9,67,16.686685835236233,12,1024,0.0,2
2020-10-19 02:00:00+02:00,76,8,68,16.686685835236233,76,9,67,16.686685835236233,12,1024,0.0,2
2020-10-19 03:00:00+02:00,113,12,101,20.093188266697116,119,12,107,22.46945513312648,12,1024,0.0,2
2020-10-19 04:00:00+02:00,189,18,171,18.951286202533417,192,19,173,21.295822766447603,12,1024,0.0,2
2020-10-19 05:00:00+02:00,351,33,318,16.04918751558848,348,38,310,20.566317862558048,12,1024,0.0,2
2020-10-19 06:00:00+02:00,421,41,380,22.41212221732918,434,46,388,17.25970681294468,12,1024,0.0,2
2020-10-19 07:00:00+02:00,687,61,626,22.327338468557514,657,63,594,15.746859620588204,12,1024,0.0,2
2020-10-19 08:00:00+02:00,684,70,614,20.84390966871112,694,66,628,22.754417186068682,12,1024,0.0,2
2020-10-19 09:00:00+02:00,480,48,432,21.905802263169644,483,60,423,21.366599546374843,12,1024,0.0,2
2020-10-19 10:00:00+02:00,382,38,344,19.255057171585772,385,47,338,23.62167138094536,12,1024,0.0,2
2020-10-19 11:00:00+02:00,483,48,435,21.366599546374843,464,52,412,21.884111394069308,12,1024,0.0,2
2020-10-19 12:00:00+02:00,376,34,342,15.920759199358614,391,39,352,20.019115852021912,12,1024,0.0,2
2020-10-19 13:00:00+02:00,379,35,344,18.713391269845218,403,47,356,24.744299394136338,12,1024,0.0,2
2020-10-19 14:00:00+02:00,372,35,337,17.388398109436665,391,40,351,20.019115852021912,12,1024,0.0,2
2020-10-19 15:00:00+02:00,418,38,380,19.740254716385955,431,54,377,17.591114272986506,12,1024,0.0,2
2020-10-19 16:00:00+02:00,473,51,422,22.543653481241357,467,50,417,22.874976747697783,12,1024,0.0,2
2020-10-19 17:00:00+02:00,642,58,584,13.904185180931925,669,66,603,21.432133936827082,12,1024,0.0,2
2020-10-19 18:00:00+02:00,703,69,634,24.207712214005344,687,67,620,22.327338468557514,12,1024,0.0,2
2020-10-19 19:00:00+02:00,492,44,448,19.891083729909596,516,55,461,23.45871840478751,12,1024,0.0,2
2020-10-19 20:00:00+02:00,480,47,433,21.905802263169644,522,65,457,19.599053099291446,12,1024,0.0,2
2020-10-19 21:00:00+02:00,385,41,344,23.62167138094536,397,45,352,20.240119954252663,12,1024,0.0,2
2020-10-19 22:00:00+02:00,269,27,242,17.49919499982951,272,26,246,23.2664106640069,12,1024,0.0,2
2020-10-19 23:00:00+02:00,195,21,174,23.83440770251287,201,24,177,22.51450761920508,12,1024,0.0,2
2020-10-20 00:00:00+02:00,70,6,64,13.53852946044019,84,7,77,14.398269762880606,15,1012,0.0,15
2020-10-20 01:00:00+02:00,49,4,45,13.911731041947528,51,5,46,7.252205043556333,15,1012,0.0,15
2020-10-20 02:00:00+02:00,47,4,43,10.718407092962304,51,4,47,7.252205043556333,15,1012,0.0,15
2020-10-20 03:00:00+02:00,72,6,66,19.53768091870668,84,7,77,14.398269762880606,15,1012,0.0,15
2020-10-20 04:00:00+02:00,127,12,115,19.116953333289125,129,12,117,17.995114557081255,15,1012,0.0,15
2020-10-20 05:00:00+02:00,220,18,202,16.758079648934128,241,21,220,21.076687701702674,15,1012,0.0,15
2020-10-20 06:00:00+02:00,267,24,243,13.385499595100717,298,27,271,18.335119688608,15,1012,0.0,15
2020-10-20 07:00:00+02:00,404,33,371,21.094548442403457,445,41,404,19.037524313009598,15,1012,0.0,15
2020-10-20 08:00:00+02:00,428,39,389,17.985011931135546,480,42,438,21.905802263169644,15,1012,0.0,15
2020-10-20 09:00:00+02:00,311,30,281,16.325599187415413,325,30,295,19.331050121665143,15,1012,0.0,15
2020-10-20 10:00:00+02:00,255,24,231,21.41944964647189,276,24,252,21.646913060128323,15,1012,0.0,15
2020-10-20 11:00:00+02:00,288,25,263,22.858888837585067,313,28,285,23.332837891570005,15,1012,0.0,15
2020-10-20 12:00:00+02:00,243,20,223,18.936896488437778,267,28,239,13.385499595100717,15,1012,0.0,15
2020-10-20 13:00:00+02:00,259,22,237,22.988395045636892,261,24,237,21.270868579361668,15,1012,0.0,15
2020-10-20 14:00:00+02:00,241,23,218,21.076687701702674,270,27,243,23.920073269237992,15,1012,0.0,15
2020-10-20 15:00:00+02:00,276,23,253,21.646913060128323,292,28,264,18.509650933155072,15,1012,0.0,15
2020-10-20 16:00:00+02:00,280,26,254,25.91177046818179,325,35,290,19.331050121665143,15,1012,0.0,15
2020-10-20 17:00:00+02:00,434,42,392,17.25970681294468,478,40,438,19.93054974447541,15,1012,0.0,15
2020-10-20 18:00:00+02:00,467,46,421,22.874976747697783,474,41,433,24.663345069259766,15,1012,0.0,15
2020-10-20 19:00:00+02:00,317,28,289,23.692514426518255,342,34,308,17.147818156889407,15,1012,0.0,15
2020-10-20 20:00:00+02:00,300,28,272,19.621479548992166,338,33,305,21.115663704400472,15,1012,0.0,15
2020-10-20 21:00:00+02:00,255,22,233,21.41944964647189,276,24,252,21.646913060128323,15,1012,0.0,15
2020-10-20 22:00:00+02:00,169,15,154,18.567569965901342,191,21,170,20.658016380524305,15,1012,0.0,15
2020-10-20 23:00:00+02:00,127,11,116,19.116953333289125,129,12,117,17.995114557081255,15,1012,0.0,15
2020-10-21 00:00:00+02:00,54,6,48,10.817024136428179,55,5,50,10.403440874465877,18,1006,0.5,19
2020-10-21 01:00:00+02:00,36,4,32,6.926188930365992,33,3,30,11.465261513985924,18,1006,0.5,19
2020-10-21 02:00:00+02:00,36,4,32,6.926188930365992,33,3,30,11.465261513985924,18,1006,0.5,19
2020-10-21 03:00:00+02:00,55,7,48,10.403440874465877,54,6,48,10.817024136428179,18,1006,0.5,19
2020-10-21 04:00:00+02:00,94,11,83,15.983412444109252,85,8,77,11.338371679676618,18,1006,0.5,19
2020-10-21 05:00:00+02:00,169,21,148,17.772634846256242,148,14,134,16.32552078684666,18,1006,0.5,19
2020-10-21 06:00:00+02:00,206,25,181,26.316276075539704,185,21,164,13.724989686195345,18,1006,0.5,19
2020-10-21 07:00:00+02:00,314,35,279,21.9520333605989,288,35,253,22.276563937053467,18,1006,0.5,19
2020-10-21 08:00:00+02:00,335,45,290,22.25380340127623,306,29,277,26.454632237997544,18,1006,0.5,19
2020-10-21 09:00:00+02:00,225,29,196,24.523176463388204,214,26,188,24.48806340301503,18,1006,0.5,19
2020-10-21 10:00:00+02:00,185,21,164,13.724989686195345,172,16,156,17.460918955055337,18,1006,0.5,19
2020-10-21 11:00:00+02:00,226,26,200,20.105295377891462,214,26,188,24.48806340301503,18,1006,0.5,19
2020-10-21 12:00:00+02:00,185,21,164,13.724989686195345,172,16,156,17.460918955055337,18,1006,0.5,19
2020-10-21 13:00:00+02:00,189,21,168,20.757394093308463,167,16,151,16.493575022686013,18,1006,0.5,19
2020-10-21 14:00:00+02:00,185,20,165,13.724989686195345,172,16,156,17.460918955055337,18,1006,0.5,19
2020-10-21 15:00:00+02:00,208,24,184,20.206401668793205,185,19,166,13.724989686195345,18,1006,0.5,19
2020-10-21 16:00:00+02:00,222,25,197,23.940731731626443,219,24,195,24.028704787177322,18,1006,0.5,19
2020-10-21 17:00:00+02:00,319,40,279,24.01334617415068,295,29,266,15.580078135965431,18,1006,0.5,19
2020-10-21 18:00:00+02:00,338,38,300,25.380150029874855,306,29,277,26.454632237997544,18,1006,0.5,19
2020-10-21 19:00:00+02:00,242,31,211,18.29710618225889,244,29,215,19.94485885962816,18,1006,0.5,19
2020-10-21 20:00:00+02:00,241,30,211,22.882071172466965,219,23,196,24.028704787177322,18,1006,0.5,19
2020-10-21 21:00:00+02:00,188,23,165,14.437637058086816,172,16,156,17.460918955055337,18,1006,0.5,19
2020-10-21 22:00:00+02:00,132,15,117,19.805771941259717,116,12,104,18.218284224266565,18,1006,0.5,19
2020-10-21 23:00:00+02:00,91,10,81,15.918010409358821,91,11,80,15.918010409358821,18,1006,0.5,19
2020-10-22 00:00:00+02:00,87,7,80,17.896548892855574,85,10,75,19.289671453475872,18,1011,0.0,15
2020-10-22 01:00:00+02:00,52,4,48,6.894026658963235,57,7,50,10.480552878481939,18,1011,0.0,15
2020-10-22 02:00:00+02:00,57,4,53,10.480552878481939,59,8,51,10.572210467564378,18,1011,0.0,15
2020-10-22 03:00:00+02:00,90,7,83,13.960700117154147,85,10,75,19.289671453475872,18,1011,0.0,15
2020-10-22 04:00:00+02:00,133,11,122,22.07413438879217,142,19,123,21.623487252479663,18,1011,0.0,15
2020-10-22 05:00:00+02:00,256,21,235,20.451990100158973,268,33,235,16.114987230113258,18,1011,0.0,15
2020-10-22 06:00:00+02:00,297,23,274,18.348417493587977,311,39,272,16.325599187415413,18,1011,0.0,15
2020-10-22 07:00:00+02:00,463,37,426,21.06469305151698,482,60,422,19.903175971447034,18,1011,0.0,15
2020-10-22 08:00:00+02:00,537,46,491,17.709537334724534,541,69,472,22.694770826128472,18,1011,0.0,15
2020-10-22 09:00:00+02:00,308,23,285,20.24805474367896,349,44,305,16.300891984453436,18,1011,0.0,15
2020-10-22 10:00:00+02:00,275,21,254,24.67224255888931,294,47,247,18.98421464015195,18,1011,0.0,15
2020-10-22 11:00:00+02:00,356,28,328,20.092398613710877,346,46,300,20.434066589603663,18,1011,0.0,15
2020-10-22 12:00:00+02:00,278,25,253,17.988889489265482,287,39,248,21.927304089805975,18,1011,0.0,15
2020-10-22 13:00:00+02:00,270,21,249,23.920073269237992,299,37,262,15.06368464327721,18,1011,0.0,15
2020-10-22 14:00:00+02:00,259,21,238,22.988395045636892,282,37,245,14.328617212432716,18,1011,0.0,15
2020-10-22 15:00:00+02:00,304,27,277,22.339067945756394,311,50,261,16.325599187415413,18,1011,0.0,15
2020-10-22 16:00:00+02:00,327,26,301,17.492932564197055,344,44,300,17.416933285982235,18,1011,0.0,15
2020-10-22 17:00:00+02:00,472,43,429,21.284214830242632,520,81,439,21.447261472760864,18,1011,0.0,15
2020-10-22 18:00:00+02:00,534,42,492,22.13831863455401,510,72,438,19.94640789038923,18,1011,0.0,15
2020-10-22 19:00:00+02:00,382,29,353,19.255057171585772,368,58,310,19.722641588533307,18,1011,0.0,15
2020-10-22 20:00:00+02:00,344,28,316,17.416933285982235,387,63,324,22.869757461740583,18,1011,0.0,15
2020-10-22 21:00:00+02:00,266,24,242,24.416240816629376,287,39,248,21.927304089805975,18,1011,0.0,15
2020-10-22 22:00:00+02:00,190,15,175,20.51689583562818,201,27,174,22.51450761920508,18,1011,0.0,15
2020-10-22 23:00:00+02:00,130,11,119,15.65660051079879,144,17,127,22.91915418498221,18,1011,0.0,15
2020-10-23 00:00:00+02:00,182,13,169,16.329362148305133,179,11,168,21.74229179161351,16,1013,0.5,10
2020-10-23 01:00:00+02:00,121,8,113,11.617438248542046,117,7,110,13.539944397802945,16,1013,0.5,10
2020-10-23 02:00:00+02:00,121,8,113,11.617438248542046,117,7,110,13.539944397802945,16,1013,0.5,10
2020-10-23 03:00:00+02:00,184,13,171,19.759138180971462,182,11,171,16.329362148305133,16,1013,0.5,10
2020-10-23 04:00:00+02:00,305,20,285,21.145143787586594,303,19,284,21.350092399480108,16,1013,0.5,10
2020-10-23 05:00:00+02:00,554,37,517,14.24598637599239,567,36,531,21.02460829557805,16,1013,0.5,10
2020-10-23 06:00:00+02:00,698,46,652,17.759863122235235,641,48,593,20.968994853354097,16,1013,0.5,10
2020-10-23 07:00:00+02:00,1023,69,954,17.29561903502687,1070,67,1003,19.801545875700253,16,1013,0.5,10
2020-10-23 08:00:00+02:00,1116,71,1045,20.72088832543462,1153,71,1082,15.25443608552089,16,1013,0.5,10
2020-10-23 09:00:00+02:00,734,47,687,19.444507338162655,728,54,674,21.816579970320596,16,1013,0.5,10
2020-10-23 10:00:00+02:00,639,45,594,16.504785418830313,583,34,549,18.96316821109991,16,1013,0.5,10
2020-10-23 11:00:00+02:00,763,49,714,23.69479180203274,760,58,702,25.52985553899572,16,1013,0.5,10
2020-10-23 12:00:00+02:00,639,48,591,16.504785418830313,583,34,549,18.96316821109991,16,1013,0.5,10
2020-10-23 13:00:00+02:00,635,41,594,14.00526989171057,639,40,599,16.504785418830313,16,1013,0.5,10
2020-10-23 14:00:00+02:00,602,38,564,17.424831150133677,637,43,594,18.70777261267793,16,1013,0.5,10
2020-10-23 15:00:00+02:00,700,50,650,15.894154355642218,648,42,606,19.0250543670476,16,1013,0.5,10
2020-10-23 16:00:00+02:00,737,54,683,17.90360165887529,760,46,714,25.52985553899572,16,1013,0.5,10
2020-10-23 17:00:00+02:00,1086,81,1005,21.86368444184842,994,71,923,21.687137620192154,16,1013,0.5,10
2020-10-23 18:00:00+02:00,1105,70,1035,17.35749112676968,1101,73,1028,22.83604306649294,16,1013,0.5,10
2020-10-23 19:00:00+02:00,795,55,740,17.523699863050823,830,50,780,17.951196173681055,16,1013,0.5,10
2020-10-23 20:00:00+02:00,797,54,743,21.3786953113849,760,58,702,25.52985553899572,16,1013,0.5,10
2020-10-23 21:00:00+02:00,639,48,591,16.504785418830313,583,34,549,18.96316821109991,16,1013,0.5,10
2020-10-23 22:00:00+02:00,444,28,416,21.75090257606931,416,29,387,20.665581485173448,16,1013,0.5,10
2020-10-23 23:00:00+02:00,318,24,294,22.522150292755875,314,24,290,19.77016372636934,16,1013,0.5,10
2020-10-24 00:00:00+02:00,155,7,148,15.790225708214793,160,6,154,13.382513931001592,14,1018,0.0,17
2020-10-24 01:00:00+02:00,102,4,98,17.16228969519664,105,4,101,17.275457667249523,14,1018,0.0,17
2020-10-24 02:00:00+02:00,102,4,98,17.16228969519664,105,4,101,17.275457667249523,14,1018,0.0,17
2020-10-24 03:00:00+02:00,155,7,148,15.790225708214793,160,6,154,13.382513931001592,14,1018,0.0,17
2020-10-24 04:00:00+02:00,206,9,197,16.841693952319364,211,9,202,18.709764859587775,14,1018,0.0,17
2020-10-24 05:00:00+02:00,244,10,234,21.645479919989064,262,9,253,15.758252944344887,14,1018,0.0,17
2020-10-24 06:00:00+02:00,410,18,392,20.181667077415888,421,15,406,17.020475847067946,14,1018,0.0,17
2020-10-24 07:00:00+02:00,586,27,559,15.95701591247249,643,27,616,20.176497439347298,14,1018,0.0,17
2020-10-24 08:00:00+02:00,828,34,794,21.320795158524785,844,33,811,20.823822589254252,14,1018,0.0,17
2020-10-24 09:00:00+02:00,831,36,795,17.811779303498707,912,36,876,18.725325172560677,14,1018,0.0,17
2020-10-24 10:00:00+02:00,747,34,713,22.710027488493914,798,32,766,23.341881309507272,14,1018,0.0,17
2020-10-24 11:00:00+02:00,602,28,574,14.48243267179175,636,28,608,18.93496792452342,14,1018,0.0,17
2020-10-24 12:00:00+02:00,586,23,563,15.95701591247249,643,27,616,20.176497439347298,14,1018,0.0,17
2020-10-24 13:00:00+02:00,671,28,643,17.312767296997286,697,32,665,20.811959753983317,14,1018,0.0,17
2020-10-24 14:00:00+02:00,590,24,566,20.788652210476105,629,29,600,22.84443636479464,14,1018,0.0,17
2020-10-24 15:00:00+02:00,724,32,692,23.304825007248606,754,35,719,21.880340217922853,14,1018,0.0,17
2020-10-24 16:00:00+02:00,727,34,693,22.606507322491233,754,35,719,21.880340217922853,14,1018,0.0,17
2020-10-24 17:00:00+02:00,831,39,792,17.811779303498707,859,34,825,22.525462487919526,14,1018,0.0,17
2020-10-24 18:00:00+02:00,750,30,720,21.37701927134674,805,37,768,17.88803636298792,14,1018,0.0,17
2020-10-24 19:00:00+02:00,613,26,587,19.97690214137227,639,23,616,19.510414243526764,14,1018,0.0,17
2020-10-24 20:00:00+02:00,537,21,516,14.987091383273496,593,23,570,19.306228131941428,14,1018,0.0,17
2020-10-24 21:00:00+02:00,489,21,468,14.32068527140049,528,21,507,13.75843297666463,14,1018,0.0,17
2020-10-24 22:00:00+02:00,396,17,379,21.767956053046117,419,19,400,16.260754118999643,14,1018,0.0,17
2020-10-24 23:00:00+02:00,197,8,189,14.378838223751064,213,8,205,14.733316442006998,14,1018,0.0,17
2020-10-25 00:00:00+02:00,48,1,47,2.118885624025071,62,1,61,9.933021674487964,13,1006,0.0,28
2020-10-25 01:00:00+02:00,31,0,31,0.09592672504460022,39,1,38,1.033561008980209,13,1006,0.0,28
2020-10-25 02:00:00+02:00,33,0,33,0.14141575834347447,44,1,43,2.806526197564455,13,1006,0.0,28
2020-10-25 03:00:00+01:00,49,1,48,6.860624429398525,67,1,66,8.7820789764259,13,1006,0.0,28
2020-10-25 04:00:00+01:00,66,1,65,9.023232667771104,81,2,79,13.57081910214519,13,1006,0.0,28
2020-10-25 05:00:00+01:00,83,2,81,14.646378896367615,86,2,84,12.26433019639111,13,1006,0.0,28
2020-10-25 06:00:00+01:00,123,3,120,15.194143124406915,158,4,154,15.520682112145103,13,1006,0.0,28
2020-10-25 07:00:00+01:00,203,5,198,14.15515549868705,207,5,202,15.748956490487041,13,1006,0.0,28
2020-10-25 08:00:00+01:00,273,7,266,21.28577278040721,270,7,263,17.22476411837893,13,1006,0.0,28
2020-10-25 09:00:00+01:00,271,7,264,18.609144291774015,320,7,313,16.959865599813572,13,1006,0.0,28
2020-10-25 10:00:00+01:00,231,6,225,23.040251819935676,257,6,251,15.41589678734927,13,1006,0.0,28
2020-10-25 11:00:00+01:00,195,5,190,17.033571067166147,275,8,267,15.101857250184825,13,1006,0.0,28
2020-10-25 12:00:00+01:00,185,5,180,12.907917224661341,268,8,260,18.728976419565118,13,1006,0.0,28
2020-10-25 13:00:00+01:00,207,5,202,15.748956490487041,244,5,239,21.645479919989064,13,1006,0.0,28
2020-10-25 14:00:00+01:00,186,4,182,14.883580611736797,245,5,240,18.743839545838085,13,1006,0.0,28
2020-10-25 15:00:00+01:00,217,5,212,17.475217936101426,278,6,272,18.588750350595824,13,1006,0.0,28
2020-10-25 16:00:00+01:00,223,6,217,14.162371988477169,273,8,265,21.28577278040721,13,1006,0.0,28
2020-10-25 17:00:00+01:00,247,7,240,19.35438042774601,334,9,325,16.121444874138597,13,1006,0.0,28
2020-10-25 18:00:00+01:00,233,6,227,19.131071941994424,257,6,251,15.41589678734927,13,1006,0.0,28
2020-10-25 19:00:00+01:00,195,5,190,17.033571067166147,275,8,267,15.101857250184825,13,1006,0.0,28
2020-10-25 20:00:00+01:00,170,4,166,17.360183949342197,201,4,197,13.923110814237354,13,1006,0.0,28
2020-10-25 21:00:00+01:00,158,4,154,15.520682112145103,229,5,224,17.77127130389445,13,1006,0.0,28
2020-10-25 22:00:00+01:00,124,3,121,16.092127235524575,158,4,154,15.520682112145103,13,1006,0.0,28
2020-10-25 23:00:00+01:00,67,1,66,8.7820789764259,86,2,84,12.26433019639111,13,1006,0.0,28
2020-10-26 00:00:00+01:00,103,6,97,17.210287037863655,112,9,103,19.016823421759323,11,1004,0.3,16
2020-10-26 01:00:00+01:00,72,4,68,10.765287360581397,72,6,66,10.765287360581397,11,1004,0.3,16
2020-10-26 02:00:00+01:00,72,5,67,10.765287360581397,72,6,66,10.765287360581397,11,1004,0.3,16
2020-10-26 03:00:00+01:00,109,8,101,18.214376818550008,109,8,101,18.214376818550008,11,1004,0.3,16
2020-10-26 04:00:00+01:00,183,12,171,15.872019474492381,187,13,174,15.611538170802525,11,1004,0.3,16
2020-10-26 05:00:00+01:00,336,24,312,15.374523455613796,331,22,309,19.942495480727644,11,1004,0.3,16
2020-10-26 06:00:00+01:00,408,27,381,20.872674165192464,408,33,375,20.872674165192464,11,1004,0.3,16
2020-10-26 07:00:00+01:00,640,46,594,19.89133908452712,602,40,562,17.424831150133677,11,1004,0.3,16
2020-10-26 08:00:00+01:00,674,46,628,18.789264429297337,670,48,622,20.295735623024996,11,1004,0.3,16
2020-10-26 09:00:00+01:00,452,28,424,22.405685364755907,448,29,419,19.19628206057244,11,1004,0.3,16
2020-10-26 10:00:00+01:00,352,24,328,18.547693732895546,359,29,330,19.276631617836294,11,1004,0.3,16
2020-10-26 11:00:00+01:00,427,32,395,17.684962245617744,432,32,400,19.977965204645113,11,1004,0.3,16
2020-10-26 12:00:00+01:00,352,23,329,18.547693732895546,359,29,330,19.276631617836294,11,1004,0.3,16
2020-10-26 13:00:00+01:00,356,27,329,20.05958990150746,361,32,329,18.385612781936853,11,1004,0.3,16
2020-10-26 14:00:00+01:00,361,23,338,18.385612781936853,377,28,349,20.61326270709296,11,1004,0.3,16
2020-10-26 15:00:00+01:00,405,28,377,16.41142237268212,412,36,376,17.611789385078108,11,1004,0.3,16
2020-10-26 16:00:00+01:00,435,33,402,17.70683292278672,449,38,411,17.9741178967318,11,1004,0.3,16
2020-10-26 17:00:00+01:00,616,40,576,20.64561882033615,633,45,588,17.390194907794736,11,1004,0.3,16
2020-10-26 18:00:00+01:00,653,42,611,19.852184178371132,668,54,614,14.894863684358564,11,1004,0.3,16
2020-10-26 19:00:00+01:00,473,35,438,14.300214591159298,473,35,438,14.300214591159298,11,1004,0.3,16
2020-10-26 20:00:00+01:00,470,32,438,16.224212326735135,483,38,445,16.739079897917865,11,1004,0.3,16
2020-10-26 21:00:00+01:00,366,26,340,16.269939741661524,375,29,346,21.145699806578275,11,1004,0.3,16
2020-10-26 22:00:00+01:00,244,18,226,18.556057346091794,255,19,236,13.80583098758932,11,1004,0.3,16
2020-10-26 23:00:00+01:00,184,13,171,19.759138180971462,181,12,169,16.606730094694083,11,1004,0.3,16
2020-10-27 00:00:00+01:00,106,6,100,19.560878716092326,121,8,113,11.617438248542046,10,1007,0.0,17
2020-10-27 01:00:00+01:00,78,4,74,10.154730086809042,82,6,76,8.6962433625344,10,1007,0.0,17
2020-10-27 02:00:00+01:00,77,5,72,11.693765322784895,82,6,76,8.6962433625344,10,1007,0.0,17
2020-10-27 03:00:00+01:00,115,7,108,14.522258078721798,125,8,117,11.899638158178501,10,1007,0.0,17
2020-10-27 04:00:00+01:00,179,12,167,21.74229179161351,196,12,184,22.483124652822625,10,1007,0.0,17
2020-10-27 05:00:00+01:00,313,19,294,12.040192542056978,344,26,318,19.49330876116528,10,1007,0.0,17
2020-10-27 06:00:00+01:00,392,24,368,22.18304148250548,436,31,405,17.144177199139556,10,1007,0.0,17
2020-10-27 07:00:00+01:00,603,35,568,14.668520308660124,709,48,661,19.749072253568023,10,1007,0.0,17
2020-10-27 08:00:00+01:00,701,41,660,20.941035743755,690,51,639,24.427983614474908,10,1007,0.0,17
2020-10-27 09:00:00+01:00,416,27,389,20.665581485173448,488,33,455,21.564433597573284,10,1007,0.0,17
2020-10-27 10:00:00+01:00,367,25,342,16.178745311566107,393,25,368,17.925669706725596,10,1007,0.0,17
2020-10-27 11:00:00+01:00,466,28,438,21.82685485689329,478,32,446,18.951044700892695,10,1007,0.0,17
2020-10-27 12:00:00+01:00,391,26,365,20.537782610304173,384,27,357,20.93762948810624,10,1007,0.0,17
2020-10-27 13:00:00+01:00,384,25,359,20.93762948810624,417,27,390,22.354466756658574,10,1007,0.0,17
2020-10-27 14:00:00+01:00,368,22,346,19.848434815045938,403,25,378,21.627704849822535,10,1007,0.0,17
2020-10-27 15:00:00+01:00,387,26,361,20.68470776467254,460,30,430,21.56348705434536,10,1007,0.0,17
2020-10-27 16:00:00+01:00,446,29,417,16.392503795900122,472,33,439,15.966412489673269,10,1007,0.0,17
2020-10-27 17:00:00+01:00,642,42,600,21.972910755183353,662,40,622,21.573583600756407,10,1007,0.0,17
2020-10-27 18:00:00+01:00,678,40,638,20.43985683175368,694,44,650,21.443594821216653,10,1007,0.0,17
2020-10-27 19:00:00+01:00,449,26,423,17.9741178967318,524,33,491,18.41315419537223,10,1007,0.0,17
2020-10-27 20:00:00+01:00,506,33,473,16.816277078158848,544,43,501,23.461065660799314,10,1007,0.0,17
2020-10-27 21:00:00+01:00,359,20,339,19.276631617836294,397,31,366,17.649629378165546,10,1007,0.0,17
2020-10-27 22:00:00+01:00,246,17,229,21.917745613565252,270,16,254,18.31838596155419,10,1007,0.0,17
2020-10-27 23:00:00+01:00,178,11,167,18.00585359354758,192,11,181,17.31696395349906,10,1007,0.0,17
2020-10-28 00:00:00+01:00,87,8,79,17.188718365321975,85,6,79,11.338371679676618,13,1007,1.2,16
2020-10-28 01:00:00+01:00,58,5,53,10.220927905289535,58,4,54,10.220927905289535,13,1007,1.2,16
2020-10-28 02:00:00+01:00,59,5,54,11.41076069350512,56,4,52,12.708841385488384,13,1007,1.2,16
2020-10-28 03:00:00+01:00,87,8,79,17.188718365321975,85,6,79,11.338371679676618,13,1007,1.2,16
2020-10-28 04:00:00+01:00,146,12,134,18.754590489717035,141,10,131,16.082921323202,13,1007,1.2,16
2020-10-28 05:00:00+01:00,261,21,240,22.290397298498814,250,17,233,16.748276094261186,13,1007,1.2,16
2020-10-28 06:00:00+01:00,319,28,291,24.01334617415068,298,20,278,21.055661887973457,13,1007,1.2,16
2020-10-28 07:00:00+01:00,493,45,448,19.413114642597456,476,33,443,21.264665184026093,13,1007,1.2,16
2020-10-28 08:00:00+01:00,519,41,478,17.770207620206634,523,35,488,19.232400876414125,13,1007,1.2,16
2020-10-28 09:00:00+01:00,353,33,320,16.072474715915927,328,26,302,18.98715264551659,13,1007,1.2,16
2020-10-28 10:00:00+01:00,296,26,270,17.230558324905093,269,19,250,18.12289110818214,13,1007,1.2,16
2020-10-28 11:00:00+01:00,351,32,319,21.009303371553763,333,22,311,20.360845500171493,13,1007,1.2,16
2020-10-28 12:00:00+01:00,296,28,268,17.230558324905093,269,19,250,18.12289110818214,13,1007,1.2,16
2020-10-28 13:00:00+01:00,293,27,266,20.77933514509894,281,22,259,16.495274317847883,13,1007,1.2,16
2020-10-28 14:00:00+01:00,294,26,268,24.118136039782872,271,19,252,21.366756148139427,13,1007,1.2,16
2020-10-28 15:00:00+01:00,324,28,296,25.318103431421573,291,22,269,15.818920682290248,13,1007,1.2,16
2020-10-28 16:00:00+01:00,356,33,323,15.115185640587857,323,28,295,20.660649403872643,13,1007,1.2,16
2020-10-28 17:00:00+01:00,493,39,454,19.413114642597456,476,33,443,21.264665184026093,13,1007,1.2,16
2020-10-28 18:00:00+01:00,519,41,478,17.770207620206634,523,35,488,19.232400876414125,13,1007,1.2,16
2020-10-28 19:00:00+01:00,382,36,346,20.636704160930535,356,24,332,15.115185640587857,13,1007,1.2,16
2020-10-28 20:00:00+01:00,377,36,341,22.934146173926393,345,26,319,20.188429732979824,13,1007,1.2,16
2020-10-28 21:00:00+01:00,293,24,269,20.77933514509894,281,22,259,16.495274317847883,13,1007,1.2,16
2020-10-28 22:00:00+01:00,206,18,188,26.316276075539704,185,14,171,13.724989686195345,13,1007,1.2,16
2020-10-28 23:00:00+01:00,144,11,133,16.028123717603865,129,10,119,12.321757402623772,13,1007,1.2,16
2020-10-29 00:00:00+01:00,107,5,102,12.742346635562697,107,10,97,12.742346635562697,14,1016,0.0,22
2020-10-29 01:00:00+01:00,71,4,67,11.584371388309396,69,7,62,11.382640456570568,14,1016,0.0,22
2020-10-29 02:00:00+01:00,74,4,70,9.886934519670994,73,7,66,10.015349835153332,14,1016,0.0,22
2020-10-29 03:00:00+01:00,104,5,99,18.50502851366146,100,9,91,12.129363492765288,14,1016,0.0,22
2020-10-29 04:00:00+01:00,183,11,172,15.872019474492381,175,16,159,18.893708159250245,14,1016,0.0,22
2020-10-29 05:00:00+01:00,328,20,308,18.977288676463566,336,31,305,15.374523455613796,14,1016,0.0,22
2020-10-29 06:00:00+01:00,346,18,328,17.93974987663749,409,43,366,21.901781937406163,14,1016,0.0,22
2020-10-29 07:00:00+01:00,602,38,564,17.424831150133677,630,61,569,13.503006235616843,14,1016,0.0,22
2020-10-29 08:00:00+01:00,619,39,580,17.744936787964466,612,52,560,14.880406360759972,14,1016,0.0,22
2020-10-29 09:00:00+01:00,439,25,414,16.88815045240334,415,42,373,20.29207139621444,14,1016,0.0,22
2020-10-29 10:00:00+01:00,354,22,332,22.475031570210557,372,34,338,20.398072732636447,14,1016,0.0,22
2020-10-29 11:00:00+01:00,386,24,362,22.495942580430874,427,41,386,17.684962245617744,14,1016,0.0,22
2020-10-29 12:00:00+01:00,340,19,321,14.37984208663957,340,35,305,14.37984208663957,14,1016,0.0,22
2020-10-29 13:00:00+01:00,320,19,301,21.84611391715035,349,31,318,19.114918279434413,14,1016,0.0,22
2020-10-29 14:00:00+01:00,337,18,319,20.189680789887703,355,32,323,19.867707600873487,14,1016,0.0,22
2020-10-29 15:00:00+01:00,410,24,386,17.249472070304,410,43,367,17.249472070304,14,1016,0.0,22
2020-10-29 16:00:00+01:00,386,22,364,22.495942580430874,427,41,386,17.684962245617744,14,1016,0.0,22
2020-10-29 17:00:00+01:00,578,32,546,19.016387711485798,614,62,552,14.77194594042829,14,1016,0.0,22
2020-10-29 18:00:00+01:00,628,36,592,16.37597661825236,653,61,592,19.852184178371132,14,1016,0.0,22
2020-10-29 19:00:00+01:00,441,24,417,18.66415998446817,451,45,406,21.269750099500666,14,1016,0.0,22
2020-10-29 20:00:00+01:00,422,26,396,15.562162592523094,453,40,413,19.36046116072621,14,1016,0.0,22
2020-10-29 21:00:00+01:00,371,20,351,18.297011572558848,366,35,331,16.269939741661524,14,1016,0.0,22
2020-10-29 22:00:00+01:00,260,14,246,14.992506001947714,255,28,227,13.80583098758932,14,1016,0.0,22
2020-10-29 23:00:00+01:00,185,11,174,20.88033942284811,175,16,159,18.893708159250245,14,1016,0.0,22
2020-10-30 00:00:00+01:00,160,11,149,18.858823274894117,157,10,147,19.700921436065542,15,1022,0.0,17
2020-10-30 01:00:00+01:00,108,7,101,15.795702759121413,102,8,94,19.007848371684837,15,1022,0.0,17
2020-10-30 02:00:00+01:00,102,6,96,19.007848371684837,99,6,93,10.313624634117142,15,1022,0.0,17
2020-10-30 03:00:00+01:00,160,12,148,18.858823274894117,157,10,147,19.700921436065542,15,1022,0.0,17
2020-10-30 04:00:00+01:00,275,17,258,20.236154766209,265,21,244,17.981103781954623,15,1022,0.0,17
2020-10-30 05:00:00+01:00,482,30,452,21.554128287623442,484,34,450,23.138456707333336,15,1022,0.0,17
2020-10-30 06:00:00+01:00,591,42,549,19.701338578215633,572,35,537,22.727485475993838,15,1022,0.0,17
2020-10-30 07:00:00+01:00,935,62,873,15.915238034176175,877,67,810,20.121901876280898,15,1022,0.0,17
2020-10-30 08:00:00+01:00,987,71,916,18.508101465977145,997,66,931,18.661649024069355,15,1022,0.0,17
2020-10-30 09:00:00+01:00,636,40,596,16.836508189953367,602,40,562,17.424831150133677,15,1022,0.0,17
2020-10-30 10:00:00+01:00,542,37,505,13.442306097339795,533,38,495,18.204577838335723,15,1022,0.0,17
2020-10-30 11:00:00+01:00,658,46,612,20.26440808659782,662,48,614,21.573583600756407,15,1022,0.0,17
2020-10-30 12:00:00+01:00,542,35,507,13.442306097339795,533,38,495,18.204577838335723,15,1022,0.0,17
2020-10-30 13:00:00+01:00,548,39,509,19.206613944955244,542,39,503,13.442306097339795,15,1022,0.0,17
2020-10-30 14:00:00+01:00,535,38,497,22.618224109294086,553,38,515,19.32438306591248,15,1022,0.0,17
2020-10-30 15:00:00+01:00,598,43,555,18.730887083184363,570,42,528,20.82588012119089,15,1022,0.0,17
2020-10-30 16:00:00+01:00,624,46,578,17.938288934541326,606,36,570,21.223883053081224,15,1022,0.0,17
2020-10-30 17:00:00+01:00,890,63,827,21.88264168331129,903,65,838,18.310584157780514,15,1022,0.0,17
2020-10-30 18:00:00+01:00,956,72,884,20.2411253532615,971,74,897,15.265912760392823,15,1022,0.0,17
2020-10-30 19:00:00+01:00,681,44,637,21.795687898236412,668,40,628,14.894863684358564,15,1022,0.0,17
2020-10-30 20:00:00+01:00,696,52,644,17.027923031619004,656,40,616,16.67726320689495,15,1022,0.0,17
2020-10-30 21:00:00+01:00,546,37,509,22.692406056572345,522,31,491,17.418929457126325,15,1022,0.0,17
2020-10-30 22:00:00+01:00,379,23,356,19.424797748224545,379,27,352,19.424797748224545,15,1022,0.0,17
2020-10-30 23:00:00+01:00,269,19,250,22.758175655823944,267,16,251,24.84759596655304,15,1022,0.0,17
2020-10-31 00:00:00+01:00,229,9,220,17.77127130389445,237,8,229,19.639472056784783,15,1023,0.0,9
2020-10-31 01:00:00+01:00,149,6,143,14.408180645471063,157,5,152,15.50141452140169,15,1023,0.0,9
2020-10-31 02:00:00+01:00,149,6,143,14.408180645471063,157,5,152,15.50141452140169,15,1023,0.0,9
2020-10-31 03:00:00+01:00,224,9,215,13.035220281305453,240,10,230,21.48004742484552,15,1023,0.0,9
2020-10-31 04:00:00+01:00,309,14,295,17.873000534247286,326,15,311,16.399261904074198,15,1023,0.0,9
2020-10-31 05:00:00+01:00,382,15,367,20.125902913903722,406,16,390,19.046281960290386,15,1023,0.0,9
2020-10-31 06:00:00+01:00,609,28,581,18.50873235092512,649,24,625,23.57250214705965,15,1023,0.0,9
2020-10-31 07:00:00+01:00,932,41,891,19.003262654741658,953,39,914,17.33503915526209,15,1023,0.0,9
2020-10-31 08:00:00+01:00,1258,51,1207,25.014657640881424,1290,45,1245,25.489670886154155,15,1023,0.0,9
2020-10-31 09:00:00+01:00,1312,58,1254,20.423361916225964,1365,60,1305,23.77196991776294,15,1023,0.0,9
2020-10-31 10:00:00+01:00,1183,55,1128,16.814670352998117,1205,51,1154,18.009034178417348,15,1023,0.0,9
2020-10-31 11:00:00+01:00,908,43,865,19.950580213872602,964,37,927,21.54885981421529,15,1023,0.0,9
2020-10-31 12:00:00+01:00,937,38,899,19.362209137662557,953,42,911,17.33503915526209,15,1023,0.0,9
2020-10-31 13:00:00+01:00,1023,42,981,17.40411919384395,1042,44,998,20.364106174402306,15,1023,0.0,9
2020-10-31 14:00:00+01:00,913,38,875,15.379874010219678,967,36,931,23.344639801874298,15,1023,0.0,9
2020-10-31 15:00:00+01:00,1055,43,1012,21.824561115679543,1124,52,1072,20.59896092278372,15,1023,0.0,9
2020-10-31 16:00:00+01:00,1084,49,1035,21.889040166411583,1138,46,1092,19.4451519943098,15,1023,0.0,9
2020-10-31 17:00:00+01:00,1245,52,1193,16.39692855366147,1298,61,1237,21.22257151829723,15,1023,0.0,9
2020-10-31 18:00:00+01:00,1146,49,1097,22.47510936508871,1205,55,1150,18.009034178417348,15,1023,0.0,9
2020-10-31 19:00:00+01:00,908,43,865,19.950580213872602,964,37,927,21.54885981421529,15,1023,0.0,9
2020-10-31 20:00:00+01:00,860,35,825,20.968338403516736,884,37,847,20.167679151219353,15,1023,0.0,9
2020-10-31 21:00:00+01:00,788,31,757,21.09491205845541,796,29,767,18.991561019459866,15,1023,0.0,9
2020-10-31 22:00:00+01:00,601,26,575,16.274517034940764,635,27,608,21.085641196376056,15,1023,0.0,9
2020-10-31 23:00:00+01:00,309,13,296,17.873000534247286,326,15,311,16.399261904074198,15,1023,0.0,9
2020-11-01 00:00:00+01:00,99,2,97,13.352674322850065,101,2,99,15.722824076028786,16,1017,0.0,16
2020-11-01 01:00:00+01:00,66,1,65,9.023232667771104,82,2,80,11.950143461787906,16,1017,0.0,16
2020-11-01 02:00:00+01:00,64,1,63,10.861502998298342,78,2,76,15.351161243496865,16,1017,0.0,16
2020-11-01 03:00:00+01:00,105,3,102,17.275457667249523,136,3,133,16.439997521399615,16,1017,0.0,16
2020-11-01 04:00:00+01:00,134,3,131,16.937140384775876,188,5,183,14.461891157735705,16,1017,0.0,16
2020-11-01 05:00:00+01:00,178,4,174,19.69962701375053,221,6,215,13.23744060058051,16,1017,0.0,16
2020-11-01 06:00:00+01:00,279,8,271,15.28199041222322,337,8,329,17.267378436340927,16,1017,0.0,16
2020-11-01 07:00:00+01:00,418,11,407,15.779720992459211,428,11,417,16.577822504859213,16,1017,0.0,16
2020-11-01 08:00:00+01:00,524,15,509,14.51787935492523,671,18,653,17.312767296997286,16,1017,0.0,16
2020-11-01 09:00:00+01:00,592,18,574,19.04359843442914,582,15,567,18.61172350970083,16,1017,0.0,16
2020-11-01 10:00:00+01:00,484,14,470,17.77003244566044,586,16,570,15.95701591247249,16,1017,0.0,16
2020-11-01 11:00:00+01:00,418,12,406,15.779720992459211,428,11,417,16.577822504859213,16,1017,0.0,16
2020-11-01 12:00:00+01:00,393,11,382,18.9997609120005,432,13,419,17.905848387955377,16,1017,0.0,16
2020-11-01 13:00:00+01:00,426,12,414,17.1824615006757,484,11,473,17.77003244566044,16,1017,0.0,16
2020-11-01 14:00:00+01:00,395,11,384,22.122661435898713,432,13,419,17.905848387955377,16,1017,0.0,16
2020-11-01 15:00:00+01:00,459,13,446,20.153236018874907,582,14,568,18.61172350970083,16,1017,0.0,16
2020-11-01 16:00:00+01:00,451,13,438,18.26483114220407,505,11,494,14.746046079018628,16,1017,0.0,16
2020-11-01 17:00:00+01:00,536,15,521,17.364646505744318,710,17,693,21.02370409420371,16,1017,0.0,16
2020-11-01 18:00:00+01:00,513,14,499,17.087132975157285,708,16,692,21.39118552809281,16,1017,0.0,16
2020-11-01 19:00:00+01:00,426,12,414,17.1824615006757,447,10,437,20.70189340508245,16,1017,0.0,16
2020-11-01 20:00:00+01:00,354,10,344,15.564128092786257,379,11,368,21.848351584441453,16,1017,0.0,16
2020-11-01 21:00:00+01:00,319,8,311,17.902844208586608,432,10,422,17.905848387955377,16,1017,0.0,16
2020-11-01 22:00:00+01:00,261,7,254,17.415614153312035,331,7,324,17.80556906191039,16,1017,0.0,16
2020-11-01 23:00:00+01:00,128,3,125,16.4960956019319,174,4,170,15.16870194582857,16,1017,0.0,16
2020-11-02 00:00:00+01:00,127,8,119,18.022773693841014,130,11,119,16.267882133132378,18,1013,0.0,24
2020-11-02 01:00:00+01:00,84,5,79,7.6306798135980785,90,7,83,10.477669283936715,18,1013,0.0,24
2020-11-02 02:00:00+01:00,82,6,76,8.6962433625344,88,7,81,8.437594054986977,18,1013,0.0,24
2020-11-02 03:00:00+01:00,122,8,114,15.53082002471091,130,8,122,16.267882133132378,18,1013,0.0,24
2020-11-02 04:00:00+01:00,212,13,199,14.709005856097448,218,18,200,17.36015147829793,18,1013,0.0,24
2020-11-02 05:00:00+01:00,369,26,343,14.559507357779353,405,31,374,16.41142237268212,18,1013,0.0,24
2020-11-02 06:00:00+01:00,496,36,460,17.795906727296867,477,39,438,19.556522486250476,18,1013,0.0,24
2020-11-02 07:00:00+01:00,752,49,703,23.063828869178057,740,64,676,19.906636203135474,18,1013,0.0,24
2020-11-02 08:00:00+01:00,773,52,721,20.560530646571348,808,58,750,22.53459505000842,18,1013,0.0,24
2020-11-02 09:00:00+01:00,512,33,479,16.667622950500245,524,43,481,18.41315419537223,18,1013,0.0,24
2020-11-02 10:00:00+01:00,447,28,419,15.045368860690624,447,31,416,15.045368860690624,18,1013,0.0,24
2020-11-02 11:00:00+01:00,508,36,472,11.879495628294928,533,47,486,18.204577838335723,18,1013,0.0,24
2020-11-02 12:00:00+01:00,447,30,417,15.045368860690624,447,31,416,15.045368860690624,18,1013,0.0,24
2020-11-02 13:00:00+01:00,422,29,393,15.562162592523094,430,29,401,17.047954055769576,18,1013,0.0,24
2020-11-02 14:00:00+01:00,410,26,384,17.249472070304,444,36,408,21.75090257606931,18,1013,0.0,24
2020-11-02 15:00:00+01:00,462,32,430,22.520787209725228,481,35,446,24.07638671243709,18,1013,0.0,24
2020-11-02 16:00:00+01:00,527,37,490,19.476857580866454,529,38,491,16.649089834553955,18,1013,0.0,24
2020-11-02 17:00:00+01:00,749,48,701,21.36988240390843,739,62,677,16.2492981775581,18,1013,0.0,24
2020-11-02 18:00:00+01:00,798,53,745,19.836593484092674,805,64,741,19.67292963911241,18,1013,0.0,24
2020-11-02 19:00:00+01:00,585,43,542,19.18448991524634,580,40,540,14.132327385370614,18,1013,0.0,24
2020-11-02 20:00:00+01:00,569,40,529,19.424344306636577,552,47,505,20.753952450553925,18,1013,0.0,24
2020-11-02 21:00:00+01:00,444,29,415,21.75090257606931,430,33,397,17.047954055769576,18,1013,0.0,24
2020-11-02 22:00:00+01:00,288,18,270,15.693687299637316,316,27,289,17.068110656006358,18,1013,0.0,24
2020-11-02 23:00:00+01:00,221,16,205,21.310706623471727,212,14,198,14.709005856097448,18,1013,0.0,24
2020-11-03 00:00:00+01:00,153,10,143,18.67945251137068,159,9,150,19.89258263570152,11,1023,0.0,13
2020-11-03 01:00:00+01:00,107,6,101,12.742346635562697,112,7,105,19.016823421759323,11,1023,0.0,13
2020-11-03 02:00:00+01:00,103,6,97,17.210287037863655,105,6,99,16.343560716114418,11,1023,0.0,13
2020-11-03 03:00:00+01:00,146,9,137,19.4340926707284,168,10,158,15.312398611458734,11,1023,0.0,13
2020-11-03 04:00:00+01:00,273,18,255,23.139691796211615,281,22,259,18.053311879599764,11,1023,0.0,13
2020-11-03 05:00:00+01:00,431,29,402,19.594917580038825,477,37,440,19.556522486250476,11,1023,0.0,13
2020-11-03 06:00:00+01:00,601,40,561,20.545622325262695,636,43,593,16.836508189953367,11,1023,0.0,13
2020-11-03 07:00:00+01:00,814,50,764,20.606219475334637,984,68,916,20.289071306333206,11,1023,0.0,13
2020-11-03 08:00:00+01:00,908,61,847,17.62497548217333,994,78,916,21.687137620192154,11,1023,0.0,13
2020-11-03 09:00:00+01:00,599,34,565,13.487647988809618,696,47,649,17.027923031619004,11,1023,0.0,13
2020-11-03 10:00:00+01:00,481,28,453,24.07638671243709,568,40,528,17.29878687814385,11,1023,0.0,13
2020-11-03 11:00:00+01:00,653,42,611,19.852184178371132,697,50,647,21.263627005081176,11,1023,0.0,13
2020-11-03 12:00:00+01:00,520,30,490,16.742850474175178,536,41,495,13.147585514482932,11,1023,0.0,13
2020-11-03 13:00:00+01:00,505,29,476,13.420156221106103,536,37,499,13.147585514482932,11,1023,0.0,13
2020-11-03 14:00:00+01:00,505,29,476,13.420156221106103,536,37,499,13.147585514482932,11,1023,0.0,13
2020-11-03 15:00:00+01:00,557,32,525,12.160249077344764,605,40,565,16.706179884848982,11,1023,0.0,13
2020-11-03 16:00:00+01:00,584,38,546,20.69288146543853,651,47,604,18.496340932670986,11,1023,0.0,13
2020-11-03 17:00:00+01:00,866,53,813,20.16525235791292,977,73,904,21.48350462639753,11,1023,0.0,13
2020-11-03 18:00:00+01:00,936,57,879,18.721885228912292,969,66,903,15.510128567925909,11,1023,0.0,13
2020-11-03 19:00:00+01:00,633,41,592,17.390194907794736,731,45,686,23.293833102965074,11,1023,0.0,13
2020-11-03 20:00:00+01:00,694,44,650,21.443594821216653,694,43,651,21.443594821216653,11,1023,0.0,13
2020-11-03 21:00:00+01:00,481,28,453,24.07638671243709,568,40,528,17.29878687814385,11,1023,0.0,13
2020-11-03 22:00:00+01:00,381,25,356,20.1963539990622,403,27,376,21.627704849822535,11,1023,0.0,13
2020-11-03 23:00:00+01:00,244,16,228,18.556057346091794,283,19,264,18.945435241048195,11,1023,0.0,13
2020-11-04 00:00:00+01:00,187,15,172,11.97608953103999,167,11,156,16.493575022686013,10,1029,0.0,9
2020-11-04 01:00:00+01:00,126,10,116,16.250667590352332,120,9,111,10.291257377501918,10,1029,0.0,9
2020-11-04 02:00:00+01:00,124,11,113,21.01321111404538,120,9,111,10.291257377501918,10,1029,0.0,9
2020-11-04 03:00:00+01:00,187,17,170,11.97608953103999,167,11,156,16.493575022686013,10,1029,0.0,9
2020-11-04 04:00:00+01:00,318,26,292,14.187384224905502,290,20,270,19.21625371183417,10,1029,0.0,9
2020-11-04 05:00:00+01:00,563,53,510,22.589818073805013,529,40,489,15.236255847579951,10,1029,0.0,9
2020-11-04 06:00:00+01:00,699,58,641,14.747796534621509,697,53,644,17.485696800189114,10,1029,0.0,9
2020-11-04 07:00:00+01:00,1058,99,959,24.09017416190494,998,72,926,20.590456819557513,10,1029,0.0,9
2020-11-04 08:00:00+01:00,1112,102,1010,19.655420281006194,1024,83,941,15.647566273817036,10,1029,0.0,9
2020-11-04 09:00:00+01:00,757,71,686,24.38217362687005,701,53,648,20.522903618154327,10,1029,0.0,9
2020-11-04 10:00:00+01:00,619,55,564,16.892006200266465,611,46,565,18.150276040632416,10,1029,0.0,9
2020-11-04 11:00:00+01:00,765,70,695,18.99933458926529,720,55,665,22.48977247010823,10,1029,0.0,9
2020-11-04 12:00:00+01:00,634,54,580,19.862366475510488,563,37,526,22.589818073805013,10,1029,0.0,9
2020-11-04 13:00:00+01:00,626,54,572,22.312867214245525,585,45,540,19.751804156270225,10,1029,0.0,9
2020-11-04 14:00:00+01:00,623,59,564,22.328192751033797,600,45,555,17.05773046632912,10,1029,0.0,9
2020-11-04 15:00:00+01:00,694,66,628,24.68704209951762,626,42,584,22.312867214245525,10,1029,0.0,9
2020-11-04 16:00:00+01:00,750,65,685,24.649332479384487,738,57,681,19.031211420539424,10,1029,0.0,9
2020-11-04 17:00:00+01:00,1077,100,977,22.81377516974052,1000,87,913,20.174292304894557,10,1029,0.0,9
2020-11-04 18:00:00+01:00,1133,107,1026,9.724886857402883,1136,92,1044,17.379240436223952,10,1029,0.0,9
2020-11-04 19:00:00+01:00,821,66,755,13.685613705873852,765,66,699,18.99933458926529,10,1029,0.0,9
2020-11-04 20:00:00+01:00,817,70,747,18.01859248715266,798,68,730,23.900355627840582,10,1029,0.0,9
2020-11-04 21:00:00+01:00,632,53,579,17.72359535613472,585,45,540,19.751804156270225,10,1029,0.0,9
2020-11-04 22:00:00+01:00,436,41,395,16.913107095696443,395,30,365,23.668029988595116,10,1029,0.0,9
2020-11-04 23:00:00+01:00,314,26,288,21.9520333605989,284,24,260,22.019244825239777,10,1029,0.0,9
2020-11-05 00:00:00+01:00,137,8,129,15.965917364236809,144,14,130,20.078554087092446,10,1036,0.0,14
2020-11-05 01:00:00+01:00,96,5,91,10.792244903732447,94,8,86,10.166272350500234,10,1036,0.0,14
2020-11-05 02:00:00+01:00,91,5,86,8.844154374326946,92,8,84,9.485995969760566,10,1036,0.0,14
2020-11-05 03:00:00+01:00,137,7,130,15.965917364236809,144,14,130,20.078554087092446,10,1036,0.0,14
2020-11-05 04:00:00+01:00,242,12,230,18.93135513529779,232,24,208,19.09590246733257,10,1036,0.0,14
2020-11-05 05:00:00+01:00,407,23,384,18.86836233630375,441,46,395,18.66415998446817,10,1036,0.0,14
2020-11-05 06:00:00+01:00,479,28,451,18.854981551601607,524,53,471,18.41315419537223,10,1036,0.0,14
2020-11-05 07:00:00+01:00,703,39,664,18.81247619491939,792,84,708,20.796416316561047,10,1036,0.0,14
2020-11-05 08:00:00+01:00,771,42,729,22.16178811748565,830,88,742,17.951196173681055,10,1036,0.0,14
2020-11-05 09:00:00+01:00,538,30,508,19.746681426359476,540,52,488,17.905003567944703,10,1036,0.0,14
2020-11-05 10:00:00+01:00,456,25,431,20.030973704990842,482,45,437,21.554128287623442,10,1036,0.0,14
2020-11-05 11:00:00+01:00,573,34,539,20.236010926878542,555,50,505,14.748558329276298,10,1036,0.0,14
2020-11-05 12:00:00+01:00,490,27,463,25.075248566874926,466,49,417,21.82685485689329,10,1036,0.0,14
2020-11-05 13:00:00+01:00,456,26,430,20.030973704990842,482,45,437,21.554128287623442,10,1036,0.0,14
2020-11-05 14:00:00+01:00,477,28,449,19.556522486250476,480,43,437,22.699493069996517,10,1036,0.0,14
2020-11-05 15:00:00+01:00,525,31,494,20.014875638820815,530,49,481,19.266675842235646,10,1036,0.0,14
2020-11-05 16:00:00+01:00,577,31,546,17.038371488313466,548,47,501,19.206613944955244,10,1036,0.0,14
2020-11-05 17:00:00+01:00,827,49,778,17.177116167400346,764,83,681,18.261145935184413,10,1036,0.0,14
2020-11-05 18:00:00+01:00,762,48,714,20.70957408294657,809,91,718,21.107922107899956,10,1036,0.0,14
2020-11-05 19:00:00+01:00,626,39,587,20.08797236683494,578,64,514,19.016387711485798,10,1036,0.0,14
2020-11-05 20:00:00+01:00,618,36,582,15.30271481066989,597,68,529,17.1525212658891,10,1036,0.0,14
2020-11-05 21:00:00+01:00,442,26,416,22.71527178577055,456,46,410,20.030973704990842,10,1036,0.0,14
2020-11-05 22:00:00+01:00,341,19,322,18.927558745642923,330,33,297,18.864376108789497,10,1036,0.0,14
2020-11-05 23:00:00+01:00,243,14,229,15.58217691478424,232,24,208,19.09590246733257,10,1036,0.0,14
2020-11-06 00:00:00+01:00,145,9,136,19.922746131926434,144,8,136,20.078554087092446,10,1033,0.0,14
2020-11-06 01:00:00+01:00,94,5,89,10.166272350500234,92,6,86,9.485995969760566,10,1033,0.0,14
2020-11-06 02:00:00+01:00,94,6,88,10.166272350500234,92,6,86,9.485995969760566,10,1033,0.0,14
2020-11-06 03:00:00+01:00,140,9,131,15.157104538016958,145,10,135,19.922746131926434,10,1033,0.0,14
2020-11-06 04:00:00+01:00,238,15,223,14.411005913654613,231,16,215,18.808415660395674,10,1033,0.0,14
2020-11-06 05:00:00+01:00,430,32,398,17.047954055769576,400,24,376,18.964845929792475,10,1033,0.0,14
2020-11-06 06:00:00+01:00,509,38,471,20.085378936033393,519,38,481,19.377864226097874,10,1033,0.0,14
2020-11-06 07:00:00+01:00,827,52,775,17.177116167400346,763,58,705,23.69479180203274,10,1033,0.0,14
2020-11-06 08:00:00+01:00,864,64,800,16.38171057033185,837,57,780,22.344019312766623,10,1033,0.0,14
2020-11-06 09:00:00+01:00,589,41,548,8.723723696629444,562,37,525,20.69762036490505,10,1033,0.0,14
2020-11-06 10:00:00+01:00,483,32,451,16.739079897917865,475,34,441,22.666846653339356,10,1033,0.0,14
2020-11-06 11:00:00+01:00,586,42,544,16.81893103683717,576,36,540,12.499771352819842,10,1033,0.0,14
2020-11-06 12:00:00+01:00,465,34,431,21.293065375383044,443,27,416,17.374921079246555,10,1033,0.0,14
2020-11-06 13:00:00+01:00,478,32,446,18.951044700892695,480,30,450,22.699493069996517,10,1033,0.0,14
2020-11-06 14:00:00+01:00,475,33,442,22.666846653339356,480,30,450,22.699493069996517,10,1033,0.0,14
2020-11-06 15:00:00+01:00,523,37,486,15.86377141768892,529,34,495,16.649089834553955,10,1033,0.0,14
2020-11-06 16:00:00+01:00,571,37,534,16.83012920135047,554,35,519,14.24598637599239,10,1033,0.0,14
2020-11-06 17:00:00+01:00,824,63,761,22.576776497307602,812,60,752,15.689646848811535,10,1033,0.0,14
2020-11-06 18:00:00+01:00,854,59,795,19.967669436189976,867,63,804,22.14111790741986,10,1033,0.0,14
2020-11-06 19:00:00+01:00,604,40,564,16.22401393120668,632,43,589,21.20851016574696,10,1033,0.0,14
2020-11-06 20:00:00+01:00,605,41,564,16.706179884848982,587,42,545,17.903545492966053,10,1033,0.0,14
2020-11-06 21:00:00+01:00,478,31,447,18.951044700892695,480,30,450,22.699493069996517,10,1033,0.0,14
2020-11-06 22:00:00+01:00,332,23,309,20.862138293674573,336,23,313,15.374523455613796,10,1033,0.0,14
2020-11-06 23:00:00+01:00,240,15,225,19.372323114313716,221,13,208,21.310706623471727,10,1033,0.0,14
2020-11-07 00:00:00+01:00,212,8,204,18.34660431423262,227,10,217,16.063661825581253,13,1023,0.0,8
2020-11-07 01:00:00+01:00,151,6,145,16.182186785769932,151,5,146,16.182186785769932,13,1023,0.0,8
2020-11-07 02:00:00+01:00,140,5,135,16.339116563458013,153,5,148,14.855598998768997,13,1023,0.0,8
2020-11-07 03:00:00+01:00,225,9,216,16.661436915864048,230,10,220,14.964272020980927,13,1023,0.0,8
2020-11-07 04:00:00+01:00,286,11,275,17.683792022579453,304,11,293,17.388899925714064,13,1023,0.0,8
2020-11-07 05:00:00+01:00,356,16,340,15.89074445219152,381,15,366,17.62409567148535,13,1023,0.0,8
2020-11-07 06:00:00+01:00,568,24,544,14.65062644971224,617,28,589,20.73345555288903,13,1023,0.0,8
2020-11-07 07:00:00+01:00,855,33,822,20.217093749633058,917,34,883,20.648122791140516,13,1023,0.0,8
2020-11-07 08:00:00+01:00,1157,52,1105,19.17268370741797,1219,51,1168,23.748683945082753,13,1023,0.0,8
2020-11-07 09:00:00+01:00,1209,53,1156,20.061178372862987,1329,48,1281,20.765374658474087,13,1023,0.0,8
2020-11-07 10:00:00+01:00,1116,51,1065,16.293044690950076,1165,42,1123,21.38120199398787,13,1023,0.0,8
2020-11-07 11:00:00+01:00,855,36,819,20.217093749633058,917,34,883,20.648122791140516,13,1023,0.0,8
2020-11-07 12:00:00+01:00,868,39,829,22.15706849502586,917,34,883,20.648122791140516,13,1023,0.0,8
2020-11-07 13:00:00+01:00,940,43,897,21.543395613897008,999,35,964,16.493654439956106,13,1023,0.0,8
2020-11-07 14:00:00+01:00,870,36,834,20.20072901956326,934,40,894,18.740961750655426,13,1023,0.0,8
2020-11-07 15:00:00+01:00,1034,44,990,21.615295207216118,1075,41,1034,20.104075718450684,13,1023,0.0,8
2020-11-07 16:00:00+01:00,1037,42,995,22.308402872589316,1065,41,1024,13.959394586310266,13,1023,0.0,8
2020-11-07 17:00:00+01:00,1173,47,1126,17.312671623656808,1216,49,1167,15.750972665880825,13,1023,0.0,8
2020-11-07 18:00:00+01:00,1068,46,1022,20.025043104554733,1162,47,1115,22.789046153550505,13,1023,0.0,8
2020-11-07 19:00:00+01:00,894,39,855,14.785741954233089,927,41,886,19.449554915335867,13,1023,0.0,8
2020-11-07 20:00:00+01:00,786,33,753,21.516354272354075,840,37,803,23.44770709211459,13,1023,0.0,8
2020-11-07 21:00:00+01:00,758,36,722,20.579839951061928,760,35,725,16.55929568251222,13,1023,0.0,8
2020-11-07 22:00:00+01:00,594,27,567,17.93124687989194,619,25,594,18.57717122163533,13,1023,0.0,8
2020-11-07 23:00:00+01:00,284,11,273,20.213493018717912,304,11,293,17.388899925714064,13,1023,0.0,8
2020-11-08 00:00:00+01:00,55,2,53,10.027044718132117,58,2,56,11.561797090249616,16,1020,0.0,9
2020-11-08 01:00:00+01:00,36,1,35,2.727177547566476,52,2,50,14.472017643602554,16,1020,0.0,9
2020-11-08 02:00:00+01:00,38,1,37,5.960450042509954,52,2,50,14.472017643602554,16,1020,0.0,9
2020-11-08 03:00:00+01:00,58,2,56,11.561797090249616,58,2,56,11.561797090249616,16,1020,0.0,9
2020-11-08 04:00:00+01:00,72,2,70,10.765287360581397,99,4,95,10.313624634117142,16,1020,0.0,9
2020-11-08 05:00:00+01:00,99,4,95,10.313624634117142,127,5,122,18.022773693841014,16,1020,0.0,9
2020-11-08 06:00:00+01:00,152,6,146,18.686880121910534,158,5,153,19.40470350916573,16,1020,0.0,9
2020-11-08 07:00:00+01:00,249,9,240,14.961614479066911,299,10,289,16.471342376610473,16,1020,0.0,9
2020-11-08 08:00:00+01:00,302,12,290,20.352052927472357,374,13,361,18.684901759797462,16,1020,0.0,9
2020-11-08 09:00:00+01:00,349,13,336,19.114918279434413,377,13,364,20.61326270709296,16,1020,0.0,9
2020-11-08 10:00:00+01:00,299,12,287,16.471342376610473,319,13,306,23.232042011552885,16,1020,0.0,9
2020-11-08 11:00:00+01:00,227,8,219,13.349035543905368,288,12,276,15.693687299637316,16,1020,0.0,9
2020-11-08 12:00:00+01:00,224,8,216,19.039166559272836,249,9,240,14.961614479066911,16,1020,0.0,9
2020-11-08 13:00:00+01:00,255,9,246,13.80583098758932,338,14,324,21.621773010719025,16,1020,0.0,9
2020-11-08 14:00:00+01:00,235,10,225,19.654447093292166,302,10,292,20.352052927472357,16,1020,0.0,9
2020-11-08 15:00:00+01:00,271,10,261,22.542411999396236,324,11,313,18.672846971084997,16,1020,0.0,9
2020-11-08 16:00:00+01:00,285,10,275,19.95607218889837,355,13,342,19.867707600873487,16,1020,0.0,9
2020-11-08 17:00:00+01:00,321,13,308,17.9619971253537,352,12,340,18.547693732895546,16,1020,0.0,9
2020-11-08 18:00:00+01:00,285,11,274,19.95607218889837,380,14,366,20.736920018387448,16,1020,0.0,9
2020-11-08 19:00:00+01:00,238,9,229,14.411005913654613,277,10,267,19.768862676933345,16,1020,0.0,9
2020-11-08 20:00:00+01:00,210,7,203,17.488096079787415,249,8,241,14.961614479066911,16,1020,0.0,9
2020-11-08 21:00:00+01:00,196,7,189,22.483124652822625,208,7,201,18.807092053665322,16,1020,0.0,9
2020-11-08 22:00:00+01:00,158,6,152,19.40470350916573,169,6,163,20.526675282456768,16,1020,0.0,9
2020-11-08 23:00:00+01:00,80,3,77,12.9514806028411,102,4,98,19.007848371684837,16,1020,0.0,9
2020-11-09 00:00:00+01:00,99,9,90,10.779955578794215,105,12,93,15.778065052313549,14,1021,0.1,6
2020-11-09 01:00:00+01:00,71,7,64,15.50461576454985,69,8,61,19.29595730158091,14,1021,0.1,6
2020-11-09 02:00:00+01:00,66,6,60,13.86002207659952,71,8,63,15.50461576454985,14,1021,0.1,6
2020-11-09 03:00:00+01:00,105,11,94,15.778065052313549,107,13,94,12.156196464705383,14,1021,0.1,6
2020-11-09 04:00:00+01:00,171,18,153,22.137070929890193,174,17,157,14.257286675630954,14,1021,0.1,6
2020-11-09 05:00:00+01:00,317,34,283,23.692514426518255,312,35,277,18.640393178431868,14,1021,0.1,6
2020-11-09 06:00:00+01:00,387,37,350,22.869757461740583,387,48,339,22.869757461740583,14,1021,0.1,6
2020-11-09 07:00:00+01:00,588,63,525,15.545784204606317,622,61,561,18.821807206946435,14,1021,0.1,6
2020-11-09 08:00:00+01:00,627,60,567,19.204908130853333,622,59,563,18.821807206946435,14,1021,0.1,6
2020-11-09 09:00:00+01:00,417,40,377,23.51661645113794,436,42,394,21.770703310925605,14,1021,0.1,6
2020-11-09 10:00:00+01:00,334,30,304,23.256671102053218,356,40,316,20.092398613710877,14,1021,0.1,6
2020-11-09 11:00:00+01:00,417,40,377,23.51661645113794,436,42,394,21.770703310925605,14,1021,0.1,6
2020-11-09 12:00:00+01:00,334,30,304,23.256671102053218,356,40,316,20.092398613710877,14,1021,0.1,6
2020-11-09 13:00:00+01:00,345,33,312,18.48984602659702,356,45,311,20.092398613710877,14,1021,0.1,6
2020-11-09 14:00:00+01:00,345,33,312,18.48984602659702,356,45,311,20.092398613710877,14,1021,0.1,6
2020-11-09 15:00:00+01:00,381,36,345,21.060383299923174,403,44,359,24.744299394136338,14,1021,0.1,6
2020-11-09 16:00:00+01:00,406,38,368,17.471736216533994,434,42,392,17.25970681294468,14,1021,0.1,6
2020-11-09 17:00:00+01:00,622,56,566,18.821807206946435,622,64,558,18.821807206946435,14,1021,0.1,6
2020-11-09 18:00:00+01:00,627,60,567,19.204908130853333,622,59,563,18.821807206946435,14,1021,0.1,6
2020-11-09 19:00:00+01:00,453,43,410,18.726095790194968,478,48,430,19.93054974447541,14,1021,0.1,6
2020-11-09 20:00:00+01:00,461,45,416,24.16987876504356,475,45,430,26.73035993542065,14,1021,0.1,6
2020-11-09 21:00:00+01:00,356,34,322,20.092398613710877,351,36,315,16.04918751558848,14,1021,0.1,6
2020-11-09 22:00:00+01:00,243,24,219,18.936896488437778,246,29,217,17.57126233227549,14,1021,0.1,6
2020-11-09 23:00:00+01:00,174,18,156,14.257286675630954,176,21,155,20.324791671108635,14,1021,0.1,6
2020-11-10 00:00:00+01:00,100,9,91,11.502705756568044,114,12,102,18.09348958441383,15,1023,0.1,6
2020-11-10 01:00:00+01:00,66,6,60,13.86002207659952,77,8,69,16.632320143368542,15,1023,0.1,6
2020-11-10 02:00:00+01:00,68,6,62,14.701855472363336,77,8,69,16.632320143368542,15,1023,0.1,6
2020-11-10 03:00:00+01:00,103,9,94,12.113442962320551,114,12,102,18.09348958441383,15,1023,0.1,6
2020-11-10 04:00:00+01:00,166,16,150,18.57114730689396,195,21,174,23.83440770251287,15,1023,0.1,6
2020-11-10 05:00:00+01:00,327,32,295,17.492932564197055,333,30,303,26.7685298712925,15,1023,0.1,6
2020-11-10 06:00:00+01:00,370,35,335,20.548579550699223,407,38,369,19.32368199778255,15,1023,0.1,6
2020-11-10 07:00:00+01:00,562,55,507,17.57000312304836,666,61,605,22.508045587926215,15,1023,0.1,6
2020-11-10 08:00:00+01:00,651,60,591,21.210094405241282,649,65,584,15.80047652296909,15,1023,0.1,6
2020-11-10 09:00:00+01:00,387,34,353,22.869757461740583,445,50,395,19.037524313009598,15,1023,0.1,6
2020-11-10 10:00:00+01:00,333,30,303,26.7685298712925,373,40,333,20.02368697341565,15,1023,0.1,6
2020-11-10 11:00:00+01:00,407,35,372,19.32368199778255,439,50,389,18.965638166337634,15,1023,0.1,6
2020-11-10 12:00:00+01:00,321,26,295,23.480156167605287,390,42,348,23.204029211730827,15,1023,0.1,6
2020-11-10 13:00:00+01:00,336,33,303,23.28683107716768,384,38,346,23.18758332904822,15,1023,0.1,6
2020-11-10 14:00:00+01:00,359,35,324,21.41163694321985,370,39,331,20.548579550699223,15,1023,0.1,6
2020-11-10 15:00:00+01:00,367,32,335,20.047055443111752,396,44,352,20.199948477295223,15,1023,0.1,6
2020-11-10 16:00:00+01:00,390,35,355,23.204029211730827,445,50,395,19.037524313009598,15,1023,0.1,6
2020-11-10 17:00:00+01:00,565,51,514,17.51797887308028,643,68,575,17.945088215014433,15,1023,0.1,6
2020-11-10 18:00:00+01:00,597,57,540,20.96302352029361,677,58,619,20.739584517025623,15,1023,0.1,6
2020-11-10 19:00:00+01:00,453,44,409,18.726095790194968,482,49,433,19.903175971447034,15,1023,0.1,6
2020-11-10 20:00:00+01:00,476,43,433,21.50817112871545,511,50,461,22.27774281923901,15,1023,0.1,6
2020-11-10 21:00:00+01:00,367,30,337,20.047055443111752,361,40,321,19.1870055662437,15,1023,0.1,6
2020-11-10 22:00:00+01:00,255,25,230,21.41944964647189,269,23,246,17.49919499982951,15,1023,0.1,6
2020-11-10 23:00:00+01:00,169,14,155,18.567569965901342,189,21,168,18.951286202533417,15,1023,0.1,6
2020-11-11 00:00:00+01:00,94,11,83,15.983412444109252,89,8,81,16.127888447212325,13,1025,0.1,7
2020-11-11 01:00:00+01:00,64,8,56,14.026099803141571,58,6,52,10.220927905289535,13,1025,0.1,7
2020-11-11 02:00:00+01:00,64,7,57,14.026099803141571,58,6,52,10.220927905289535,13,1025,0.1,7
2020-11-11 03:00:00+01:00,97,11,86,13.44369084549097,89,8,81,16.127888447212325,13,1025,0.1,7
2020-11-11 04:00:00+01:00,158,20,138,20.016713756826867,153,15,138,18.89706115395996,13,1025,0.1,7
2020-11-11 05:00:00+01:00,289,38,251,21.030269491813637,274,27,247,27.25802623834161,13,1025,0.1,7
2020-11-11 06:00:00+01:00,356,41,315,15.115185640587857,330,41,289,22.0130860795424,13,1025,0.1,7
2020-11-11 07:00:00+01:00,561,76,485,25.011004908764136,538,62,476,18.031855257535994,13,1025,0.1,7
2020-11-11 08:00:00+01:00,587,68,519,14.285573370820778,561,70,491,25.011004908764136,13,1025,0.1,7
2020-11-11 09:00:00+01:00,392,50,342,15.3731079641605,384,48,336,24.017668618470122,13,1025,0.1,7
2020-11-11 10:00:00+01:00,325,39,286,19.158838106551173,294,33,261,24.118136039782872,13,1025,0.1,7
2020-11-11 11:00:00+01:00,387,45,342,17.47876613578263,353,43,310,16.072474715915927,13,1025,0.1,7
2020-11-11 12:00:00+01:00,323,41,282,20.660649403872643,302,29,273,16.69876077341281,13,1025,0.1,7
2020-11-11 13:00:00+01:00,330,40,290,22.0130860795424,328,41,287,18.98715264551659,13,1025,0.1,7
2020-11-11 14:00:00+01:00,328,44,284,18.98715264551659,323,40,283,20.660649403872643,13,1025,0.1,7
2020-11-11 15:00:00+01:00,356,41,315,15.115185640587857,330,41,289,22.0130860795424,13,1025,0.1,7
2020-11-11 16:00:00+01:00,394,54,340,22.05126282448999,356,35,321,15.115185640587857,13,1025,0.1,7
2020-11-11 17:00:00+01:00,548,75,473,18.51150776261941,528,51,477,22.202095855996042,13,1025,0.1,7
2020-11-11 18:00:00+01:00,584,77,507,19.403324970579884,592,60,532,18.751408237727833,13,1025,0.1,7
2020-11-11 19:00:00+01:00,422,53,369,10.696823458345879,422,41,381,10.696823458345879,13,1025,0.1,7
2020-11-11 20:00:00+01:00,428,49,379,23.45979362673577,384,47,337,24.017668618470122,13,1025,0.1,7
2020-11-11 21:00:00+01:00,325,39,286,19.158838106551173,294,33,261,24.118136039782872,13,1025,0.1,7
2020-11-11 22:00:00+01:00,225,26,199,24.523176463388204,217,26,191,20.47500927792046,13,1025,0.1,7
2020-11-11 23:00:00+01:00,164,20,144,22.782143669494815,151,17,134,19.198981193831877,13,1025,0.1,7
2020-11-12 00:00:00+01:00,67,5,62,12.5039951599288,70,10,60,13.53852946044019,14,1018,0.0,16
2020-11-12 01:00:00+01:00,44,3,41,6.744796902616623,46,6,40,9.245167395738047,14,1018,0.0,16
2020-11-12 02:00:00+01:00,42,3,39,5.988628884327601,46,6,40,9.245167395738047,14,1018,0.0,16
2020-11-12 03:00:00+01:00,65,5,60,15.361527134905547,70,10,60,13.53852946044019,14,1018,0.0,16
2020-11-12 04:00:00+01:00,111,8,103,12.909820125967427,107,14,93,12.156196464705383,14,1018,0.0,16
2020-11-12 05:00:00+01:00,188,17,171,22.908938245974742,212,33,179,18.597605283865732,14,1018,0.0,16
2020-11-12 06:00:00+01:00,245,20,225,18.942213831390788,251,38,213,19.570183352800104,14,1018,0.0,16
2020-11-12 07:00:00+01:00,361,31,330,19.1870055662437,387,63,324,22.869757461740583,14,1018,0.0,16
2020-11-12 08:00:00+01:00,377,34,343,16.83689607567409,430,59,371,19.32256414396262,14,1018,0.0,16
2020-11-12 09:00:00+01:00,286,22,264,20.398524223626136,286,44,242,20.398524223626136,14,1018,0.0,16
2020-11-12 10:00:00+01:00,223,19,204,21.320656431140716,219,30,189,21.009686825041197,14,1018,0.0,16
2020-11-12 11:00:00+01:00,281,22,259,17.665733770068634,277,45,232,24.920160895876304,14,1018,0.0,16
2020-11-12 12:00:00+01:00,227,19,208,19.269071808142694,219,30,189,21.009686825041197,14,1018,0.0,16
2020-11-12 13:00:00+01:00,232,18,214,14.357520231191923,232,29,203,14.357520231191923,14,1018,0.0,16
2020-11-12 14:00:00+01:00,217,16,201,21.833662628048735,221,31,190,20.34114880306217,14,1018,0.0,16
2020-11-12 15:00:00+01:00,256,20,236,20.451990100158973,258,32,226,21.93153719781745,14,1018,0.0,16
2020-11-12 16:00:00+01:00,245,19,226,18.942213831390788,273,41,232,23.61851837889036,14,1018,0.0,16
2020-11-12 17:00:00+01:00,372,28,344,17.388398109436665,389,52,337,21.37920911023894,14,1018,0.0,16
2020-11-12 18:00:00+01:00,374,29,345,18.17629135420491,411,55,356,21.89950881174465,14,1018,0.0,16
2020-11-12 19:00:00+01:00,268,24,244,16.114987230113258,294,38,256,18.98421464015195,14,1018,0.0,16
2020-11-12 20:00:00+01:00,301,24,277,16.897732473063776,290,37,253,18.088844908617002,14,1018,0.0,16
2020-11-12 21:00:00+01:00,212,18,194,18.597605283865732,238,34,204,16.13336525085207,14,1018,0.0,16
2020-11-12 22:00:00+01:00,165,14,151,20.56038540292619,160,24,136,19.89239402952506,14,1018,0.0,16
2020-11-12 23:00:00+01:00,117,9,108,21.891304075969387,117,16,101,21.891304075969387,14,1018,0.0,16
2020-11-13 00:00:00+01:00,93,9,84,12.914854269394333,86,7,79,21.204994436842384,14,1021,0.0,10
2020-11-13 01:00:00+01:00,59,5,54,10.572210467564378,56,5,51,10.152150256689218,14,1021,0.0,10
2020-11-13 02:00:00+01:00,61,5,56,12.362973378192347,56,5,51,10.152150256689218,14,1021,0.0,10
2020-11-13 03:00:00+01:00,93,9,84,12.914854269394333,86,7,79,21.204994436842384,14,1021,0.0,10
2020-11-13 04:00:00+01:00,150,13,137,17.939622434692456,155,13,142,19.469409355748308,14,1021,0.0,10
2020-11-13 05:00:00+01:00,268,29,239,16.114987230113258,268,24,244,16.114987230113258,14,1021,0.0,10
2020-11-13 06:00:00+01:00,332,31,301,21.454526645627976,330,30,300,16.43301680059058,14,1021,0.0,10
2020-11-13 07:00:00+01:00,512,49,463,24.456321505157344,492,49,443,19.891083729909596,14,1021,0.0,10
2020-11-13 08:00:00+01:00,559,54,505,22.603831145806197,532,49,483,22.31530989594808,14,1021,0.0,10
2020-11-13 09:00:00+01:00,372,35,337,17.388398109436665,362,34,328,18.208767664177746,14,1021,0.0,10
2020-11-13 10:00:00+01:00,315,34,281,16.084372336057935,293,29,264,19.851789935750844,14,1021,0.0,10
2020-11-13 11:00:00+01:00,372,36,336,17.388398109436665,362,34,328,18.208767664177746,14,1021,0.0,10
2020-11-13 12:00:00+01:00,315,34,281,16.084372336057935,293,29,264,19.851789935750844,14,1021,0.0,10
2020-11-13 13:00:00+01:00,310,30,280,16.921651532922695,303,28,275,15.98015338859148,14,1021,0.0,10
2020-11-13 14:00:00+01:00,300,28,272,19.621479548992166,290,29,261,18.088844908617002,14,1021,0.0,10
2020-11-13 15:00:00+01:00,335,35,300,21.419812345615075,317,33,284,23.692514426518255,14,1021,0.0,10
2020-11-13 16:00:00+01:00,359,36,323,21.41163694321985,357,37,320,21.912097396672888,14,1021,0.0,10
2020-11-13 17:00:00+01:00,537,50,487,17.709537334724534,529,47,482,16.445273293132438,14,1021,0.0,10
2020-11-13 18:00:00+01:00,564,50,514,17.15459670775402,537,49,488,17.709537334724534,14,1021,0.0,10
2020-11-13 19:00:00+01:00,401,37,364,26.708807440790352,389,40,349,21.37920911023894,14,1021,0.0,10
2020-11-13 20:00:00+01:00,391,36,355,20.019115852021912,384,34,350,23.18758332904822,14,1021,0.0,10
2020-11-13 21:00:00+01:00,313,34,279,23.332837891570005,300,26,274,19.621479548992166,14,1021,0.0,10
2020-11-13 22:00:00+01:00,209,20,189,22.16757043059366,211,18,193,18.759232281731908,14,1021,0.0,10
2020-11-13 23:00:00+01:00,150,15,135,17.939622434692456,155,13,142,19.469409355748308,14,1021,0.0,10
2020-11-14 00:00:00+01:00,81,5,76,13.380409900215524,88,4,84,8.437594054986977,14,1019,0.0,12
2020-11-14 01:00:00+01:00,54,3,51,11.483713237443984,58,3,55,11.561797090249616,14,1019,0.0,12
2020-11-14 02:00:00+01:00,54,3,51,11.483713237443984,58,3,55,11.561797090249616,14,1019,0.0,12
2020-11-14 03:00:00+01:00,81,4,77,13.380409900215524,88,4,84,8.437594054986977,14,1019,0.0,12
2020-11-14 04:00:00+01:00,108,6,102,15.795702759121413,117,7,110,13.539944397802945,14,1019,0.0,12
2020-11-14 05:00:00+01:00,140,9,131,15.157104538016958,149,9,140,17.937448228249327,14,1019,0.0,12
2020-11-14 06:00:00+01:00,221,13,208,21.310706623471727,233,12,221,15.034753042734176,14,1019,0.0,12
2020-11-14 07:00:00+01:00,334,21,313,17.139636433234756,355,17,338,19.867707600873487,14,1019,0.0,12
2020-11-14 08:00:00+01:00,457,29,428,20.01126294383405,479,25,454,18.854981551601607,14,1019,0.0,12
2020-11-14 09:00:00+01:00,482,30,452,21.554128287623442,504,30,474,18.186363959256344,14,1019,0.0,12
2020-11-14 10:00:00+01:00,436,24,412,17.144177199139556,441,23,418,18.66415998446817,14,1019,0.0,12
2020-11-14 11:00:00+01:00,332,20,312,20.862138293674573,357,20,337,16.579219218063535,14,1019,0.0,12
2020-11-14 12:00:00+01:00,346,20,326,17.93974987663749,359,21,338,19.276631617836294,14,1019,0.0,12
2020-11-14 13:00:00+01:00,362,24,338,18.876684992305748,380,25,355,20.736920018387448,14,1019,0.0,12
2020-11-14 14:00:00+01:00,341,21,320,18.927558745642923,355,21,334,19.867707600873487,14,1019,0.0,12
2020-11-14 15:00:00+01:00,400,25,375,18.964845929792475,409,27,382,21.901781937406163,14,1019,0.0,12
2020-11-14 16:00:00+01:00,393,26,367,17.925669706725596,411,25,386,17.61880175865933,14,1019,0.0,12
2020-11-14 17:00:00+01:00,452,30,422,22.405685364755907,482,24,458,21.554128287623442,14,1019,0.0,12
2020-11-14 18:00:00+01:00,425,27,398,17.81110597716838,445,29,416,21.520045849832552,14,1019,0.0,12
2020-11-14 19:00:00+01:00,341,20,321,18.927558745642923,355,21,334,19.867707600873487,14,1019,0.0,12
2020-11-14 20:00:00+01:00,314,20,294,19.77016372636934,330,21,309,18.864376108789497,14,1019,0.0,12
2020-11-14 21:00:00+01:00,285,17,268,19.95607218889837,296,17,279,18.406113827007673,14,1019,0.0,12
2020-11-14 22:00:00+01:00,221,12,209,21.310706623471727,233,12,221,15.034753042734176,14,1019,0.0,12
2020-11-14 23:00:00+01:00,110,6,104,20.964248322238312,117,6,111,13.539944397802945,14,1019,0.0,12
2020-11-15 00:00:00+01:00,30,1,29,0.6316761612788789,40,1,39,6.907029621336792,14,1012,0.0,20
2020-11-15 01:00:00+01:00,20,0,20,0.04910283862897408,23,0,23,0.14362729290738016,14,1012,0.0,20
2020-11-15 02:00:00+01:00,20,0,20,0.04910283862897408,23,0,23,0.14362729290738016,14,1012,0.0,20
2020-11-15 03:00:00+01:00,30,1,29,0.6316761612788789,40,1,39,6.907029621336792,14,1012,0.0,20
2020-11-15 04:00:00+01:00,40,1,39,6.907029621336792,52,1,51,14.472017643602554,14,1012,0.0,20
2020-11-15 05:00:00+01:00,50,2,48,13.833131991765365,68,2,66,8.84385076442631,14,1012,0.0,20
2020-11-15 06:00:00+01:00,83,3,80,9.333357558089729,94,3,91,10.166272350500234,14,1012,0.0,20
2020-11-15 07:00:00+01:00,122,4,118,15.53082002471091,145,4,141,19.922746131926434,14,1012,0.0,20
2020-11-15 08:00:00+01:00,167,6,161,19.047083059371815,216,8,208,17.62117954457743,14,1012,0.0,20
2020-11-15 09:00:00+01:00,164,6,158,18.874121315806054,232,8,224,19.09590246733257,14,1012,0.0,20
2020-11-15 10:00:00+01:00,151,6,145,19.14578123638998,180,5,175,18.453361889556408,14,1012,0.0,20
2020-11-15 11:00:00+01:00,119,4,115,9.275729661817119,138,5,133,15.03091255444847,14,1012,0.0,20
2020-11-15 12:00:00+01:00,126,5,121,13.391954395859463,145,6,139,19.922746131926434,14,1012,0.0,20
2020-11-15 13:00:00+01:00,135,4,131,20.27811899595658,179,6,173,21.74229179161351,14,1012,0.0,20
2020-11-15 14:00:00+01:00,119,4,115,9.275729661817119,138,5,133,15.03091255444847,14,1012,0.0,20
2020-11-15 15:00:00+01:00,147,5,142,16.306492316544293,202,8,194,21.075229783177793,14,1012,0.0,20
2020-11-15 16:00:00+01:00,142,5,137,19.57947604189084,198,7,191,20.173795644408123,14,1012,0.0,20
2020-11-15 17:00:00+01:00,168,7,161,15.312398611458734,216,8,208,17.62117954457743,14,1012,0.0,20
2020-11-15 18:00:00+01:00,145,5,140,19.922746131926434,200,6,194,21.668114478408352,14,1012,0.0,20
2020-11-15 19:00:00+01:00,122,4,118,15.53082002471091,145,4,141,19.922746131926434,14,1012,0.0,20
2020-11-15 20:00:00+01:00,115,4,111,14.522258078721798,155,5,150,18.708796369633056,14,1012,0.0,20
2020-11-15 21:00:00+01:00,96,3,93,10.792244903732447,132,4,128,15.82621260035259,14,1012,0.0,20
2020-11-15 22:00:00+01:00,80,3,77,12.9514806028411,109,4,105,18.214376818550008,14,1012,0.0,20
2020-11-15 23:00:00+01:00,40,1,39,6.907029621336792,52,1,51,14.472017643602554,14,1012,0.0,20
2020-11-16 00:00:00+01:00,39,4,35,6.782457974710225,37,4,33,2.066086063070793,12,1011,0.0,26
2020-11-16 01:00:00+01:00,26,2,24,1.5382661455122164,26,2,24,1.5382661455122164,12,1011,0.0,26
2020-11-16 02:00:00+01:00,24,2,22,1.5004308879154395,26,2,24,1.5382661455122164,12,1011,0.0,26
2020-11-16 03:00:00+01:00,37,3,34,2.066086063070793,39,4,35,6.782457974710225,12,1011,0.0,26
2020-11-16 04:00:00+01:00,60,5,55,10.583722413773145,62,6,56,14.48690450543278,12,1011,0.0,26
2020-11-16 05:00:00+01:00,108,10,98,14.813734676069407,112,11,101,14.898852003445265,12,1011,0.0,26
2020-11-16 06:00:00+01:00,136,13,123,16.594078125250377,142,16,126,21.623487252479663,12,1011,0.0,26
2020-11-16 07:00:00+01:00,226,22,204,20.308697708911414,214,23,191,18.560318290748608,12,1011,0.0,26
2020-11-16 08:00:00+01:00,239,24,215,13.74553452780325,235,29,206,20.674840106170866,12,1011,0.0,26
2020-11-16 09:00:00+01:00,154,16,138,23.457384968254527,151,18,133,19.408157188048275,12,1011,0.0,26
2020-11-16 10:00:00+01:00,128,11,117,19.601953989978306,128,12,116,19.601953989978306,12,1011,0.0,26
2020-11-16 11:00:00+01:00,152,13,139,20.188330220444417,154,15,139,23.457384968254527,12,1011,0.0,26
2020-11-16 12:00:00+01:00,123,13,110,19.074654696202938,128,14,114,19.601953989978306,12,1011,0.0,26
2020-11-16 13:00:00+01:00,127,11,116,19.116953333289125,125,13,112,23.026828253397017,12,1011,0.0,26
2020-11-16 14:00:00+01:00,127,11,116,19.116953333289125,125,13,112,23.026828253397017,12,1011,0.0,26
2020-11-16 15:00:00+01:00,139,12,127,18.732486269107348,137,15,122,18.928795118329443,12,1011,0.0,26
2020-11-16 16:00:00+01:00,145,14,131,18.85528596371164,157,17,140,23.857880119976507,12,1011,0.0,26
2020-11-16 17:00:00+01:00,216,21,195,21.273439412003903,220,27,193,16.758079648934128,12,1011,0.0,26
2020-11-16 18:00:00+01:00,228,21,207,15.818609956751573,225,22,203,17.07968654570721,12,1011,0.0,26
2020-11-16 19:00:00+01:00,168,15,153,20.304807772345505,167,18,149,21.39117903937357,12,1011,0.0,26
2020-11-16 20:00:00+01:00,166,16,150,18.57114730689396,170,20,150,19.775542485132945,12,1011,0.0,26
2020-11-16 21:00:00+01:00,122,13,109,20.245567873519157,131,15,116,14.183230975852695,12,1011,0.0,26
2020-11-16 22:00:00+01:00,89,8,81,17.562315027840828,89,8,81,17.562315027840828,12,1011,0.0,26
2020-11-16 23:00:00+01:00,63,5,58,14.929801273937542,62,6,56,14.48690450543278,12,1011,0.0,26
2020-11-17 00:00:00+01:00,74,6,68,19.513800836509724,92,9,83,10.404364071122256,12,1026,0.0,10
2020-11-17 01:00:00+01:00,56,4,52,10.152150256689218,61,5,56,12.362973378192347,12,1026,0.0,10
2020-11-17 02:00:00+01:00,49,4,45,13.911731041947528,56,5,51,10.152150256689218,12,1026,0.0,10
2020-11-17 03:00:00+01:00,83,7,76,18.699193296190067,85,8,77,19.289671453475872,12,1026,0.0,10
2020-11-17 04:00:00+01:00,131,12,119,14.183230975852695,146,12,134,20.98788244482569,12,1026,0.0,10
2020-11-17 05:00:00+01:00,257,23,234,24.369710124951805,273,24,249,23.61851837889036,12,1026,0.0,10
2020-11-17 06:00:00+01:00,302,25,277,17.71336274061634,314,31,283,19.381500590217087,12,1026,0.0,10
2020-11-17 07:00:00+01:00,454,38,416,21.947231747967304,501,54,447,20.940750692732994,12,1026,0.0,10
2020-11-17 08:00:00+01:00,488,44,444,14.865596092809506,546,56,490,20.84279480803274,12,1026,0.0,10
2020-11-17 09:00:00+01:00,343,28,315,18.604951737824955,363,30,333,20.037936765942277,12,1026,0.0,10
2020-11-17 10:00:00+01:00,266,26,240,24.416240816629376,293,28,265,19.851789935750844,12,1026,0.0,10
2020-11-17 11:00:00+01:00,332,29,303,21.454526645627976,352,32,320,20.33829699034963,12,1026,0.0,10
2020-11-17 12:00:00+01:00,264,23,241,20.665980174270672,293,26,267,19.851789935750844,12,1026,0.0,10
2020-11-17 13:00:00+01:00,277,25,252,24.920160895876304,309,32,277,17.68578168988432,12,1026,0.0,10
2020-11-17 14:00:00+01:00,268,23,245,16.114987230113258,293,26,267,19.851789935750844,12,1026,0.0,10
2020-11-17 15:00:00+01:00,305,27,278,19.342371998402466,318,28,290,21.634505447676812,12,1026,0.0,10
2020-11-17 16:00:00+01:00,311,28,283,16.325599187415413,356,33,323,20.092398613710877,12,1026,0.0,10
2020-11-17 17:00:00+01:00,449,39,410,18.601165629732545,492,49,443,19.891083729909596,12,1026,0.0,10
2020-11-17 18:00:00+01:00,501,44,457,20.940750692732994,537,54,483,17.709537334724534,12,1026,0.0,10
2020-11-17 19:00:00+01:00,359,30,329,21.41163694321985,379,40,339,18.713391269845218,12,1026,0.0,10
2020-11-17 20:00:00+01:00,372,35,337,17.388398109436665,386,36,350,18.304254687443294,12,1026,0.0,10
2020-11-17 21:00:00+01:00,280,24,256,25.91177046818179,295,32,263,20.557446011766526,12,1026,0.0,10
2020-11-17 22:00:00+01:00,183,15,168,16.4856647978058,198,17,181,18.14522738171017,12,1026,0.0,10
2020-11-17 23:00:00+01:00,137,11,126,18.928795118329443,140,14,126,15.331768592489755,12,1026,0.0,10
2020-11-18 00:00:00+01:00,91,11,80,15.918010409358821,91,11,80,15.918010409358821,13,1027,0.0,9
2020-11-18 01:00:00+01:00,61,8,53,12.120017072784945,56,6,50,12.708841385488384,13,1027,0.0,9
2020-11-18 02:00:00+01:00,61,8,53,12.120017072784945,56,6,50,12.708841385488384,13,1027,0.0,9
2020-11-18 03:00:00+01:00,93,12,81,19.729575953685952,91,11,80,15.918010409358821,13,1027,0.0,9
2020-11-18 04:00:00+01:00,155,20,135,20.64602175207135,155,17,138,20.64602175207135,13,1027,0.0,9
2020-11-18 05:00:00+01:00,283,36,247,21.39422350027581,268,26,242,19.54671273578713,13,1027,0.0,9
2020-11-18 06:00:00+01:00,345,46,299,20.188429732979824,335,34,301,22.25380340127623,13,1027,0.0,9
2020-11-18 07:00:00+01:00,525,59,466,21.78819273745725,505,59,446,19.315231425508955,13,1027,0.0,9
2020-11-18 08:00:00+01:00,559,72,487,24.768694505661518,522,50,472,18.0567977332051,13,1027,0.0,9
2020-11-18 09:00:00+01:00,379,44,335,20.059308979444502,350,36,314,22.47956536478983,13,1027,0.0,9
2020-11-18 10:00:00+01:00,313,41,272,22.462732390303422,285,28,257,24.91827111917757,13,1027,0.0,9
2020-11-18 11:00:00+01:00,377,50,327,22.934146173926393,342,38,304,16.804119797749596,13,1027,0.0,9
2020-11-18 12:00:00+01:00,313,39,274,22.462732390303422,285,28,257,24.91827111917757,13,1027,0.0,9
2020-11-18 13:00:00+01:00,315,42,273,19.612228121399696,293,30,263,20.77933514509894,13,1027,0.0,9
2020-11-18 14:00:00+01:00,313,39,274,22.462732390303422,285,28,257,24.91827111917757,13,1027,0.0,9
2020-11-18 15:00:00+01:00,345,46,299,20.188429732979824,335,34,301,22.25380340127623,13,1027,0.0,9
2020-11-18 16:00:00+01:00,372,42,330,22.421394120106562,350,44,306,22.47956536478983,13,1027,0.0,9
2020-11-18 17:00:00+01:00,532,70,462,23.432061751927844,485,58,427,27.620024491981408,13,1027,0.0,9
2020-11-18 18:00:00+01:00,564,65,499,17.34388943609458,567,54,513,23.36809092648519,13,1027,0.0,9
2020-11-18 19:00:00+01:00,409,48,361,24.581033645594804,364,46,318,21.051236699694496,13,1027,0.0,9
2020-11-18 20:00:00+01:00,406,52,354,23.347397986470767,377,43,334,22.934146173926393,13,1027,0.0,9
2020-11-18 21:00:00+01:00,308,38,270,21.08437606059346,285,28,257,24.91827111917757,13,1027,0.0,9
2020-11-18 22:00:00+01:00,219,29,190,24.028704787177322,214,24,190,24.48806340301503,13,1027,0.0,9
2020-11-18 23:00:00+01:00,155,17,138,20.64602175207135,155,17,138,20.64602175207135,13,1027,0.0,9
2020-11-19 00:00:00+01:00,49,4,45,13.911731041947528,48,6,42,12.297077384196717,10,1023,0.0,17
2020-11-19 01:00:00+01:00,33,2,31,5.985660510090718,32,4,28,5.041092888653022,10,1023,0.0,17
2020-11-19 02:00:00+01:00,32,2,30,5.041092888653022,33,5,28,5.985660510090718,10,1023,0.0,17
2020-11-19 03:00:00+01:00,45,3,42,8.16653528554085,49,7,42,13.911731041947528,10,1023,0.0,17
2020-11-19 04:00:00+01:00,83,6,77,18.699193296190067,80,11,69,18.237765354324676,10,1023,0.0,17
2020-11-19 05:00:00+01:00,139,10,129,18.732486269107348,141,20,121,21.00935462418931,10,1023,0.0,17
2020-11-19 06:00:00+01:00,189,17,172,18.951286202533417,178,23,155,19.804789777436813,10,1023,0.0,17
2020-11-19 07:00:00+01:00,258,19,239,21.93153719781745,271,35,236,24.814459053724722,10,1023,0.0,17
2020-11-19 08:00:00+01:00,285,21,264,23.62629721954127,312,48,264,18.640393178431868,10,1023,0.0,17
2020-11-19 09:00:00+01:00,203,18,185,24.82410288636225,192,28,164,21.295822766447603,10,1023,0.0,17
2020-11-19 10:00:00+01:00,156,12,144,23.175119746499636,158,25,133,21.67102174389251,10,1023,0.0,17
2020-11-19 11:00:00+01:00,184,15,169,20.655558446800804,196,24,172,20.04912381427717,10,1023,0.0,17
2020-11-19 12:00:00+01:00,162,14,148,19.08849102929865,164,20,144,22.827361263214527,10,1023,0.0,17
2020-11-19 13:00:00+01:00,168,12,156,20.304807772345505,165,23,142,20.56038540292619,10,1023,0.0,17
2020-11-19 14:00:00+01:00,154,13,141,23.457384968254527,158,25,133,21.67102174389251,10,1023,0.0,17
2020-11-19 15:00:00+01:00,169,14,155,18.567569965901342,184,29,155,20.655558446800804,10,1023,0.0,17
2020-11-19 16:00:00+01:00,183,13,170,16.4856647978058,191,24,167,20.658016380524305,10,1023,0.0,17
2020-11-19 17:00:00+01:00,275,22,253,24.67224255888931,285,46,239,23.62629721954127,10,1023,0.0,17
2020-11-19 18:00:00+01:00,292,25,267,18.509650933155072,285,43,242,23.62629721954127,10,1023,0.0,17
2020-11-19 19:00:00+01:00,209,18,191,22.16757043059366,216,27,189,21.273439412003903,10,1023,0.0,17
2020-11-19 20:00:00+01:00,205,18,187,13.47116079711613,216,27,189,21.273439412003903,10,1023,0.0,17
2020-11-19 21:00:00+01:00,158,14,144,21.67102174389251,164,23,141,22.827361263214527,10,1023,0.0,17
2020-11-19 22:00:00+01:00,117,9,108,21.891304075969387,119,16,103,22.46945513312648,10,1023,0.0,17
2020-11-19 23:00:00+01:00,75,6,69,14.734681497037354,86,12,74,21.204994436842384,10,1023,0.0,17
2020-11-20 00:00:00+01:00,75,6,69,14.734681497037354,77,7,70,16.632320143368542,8,1036,0.0,8
2020-11-20 01:00:00+01:00,51,5,46,7.252205043556333,49,4,45,13.911731041947528,8,1036,0.0,8
2020-11-20 02:00:00+01:00,51,4,47,7.252205043556333,49,4,45,13.911731041947528,8,1036,0.0,8
2020-11-20 03:00:00+01:00,77,7,70,16.632320143368542,77,8,69,16.632320143368542,8,1036,0.0,8
2020-11-20 04:00:00+01:00,129,13,116,17.995114557081255,124,10,114,17.53992981591413,8,1036,0.0,8
2020-11-20 05:00:00+01:00,223,23,200,21.320656431140716,217,21,196,21.833662628048735,8,1036,0.0,8
2020-11-20 06:00:00+01:00,274,27,247,20.56786912693606,280,31,249,25.91177046818179,8,1036,0.0,8
2020-11-20 07:00:00+01:00,432,45,387,18.473076954520703,413,40,373,24.398754434847095,8,1036,0.0,8
2020-11-20 08:00:00+01:00,471,48,423,24.71489709392721,440,38,402,19.57754243382943,8,1036,0.0,8
2020-11-20 09:00:00+01:00,303,32,271,15.98015338859148,294,26,268,18.98421464015195,8,1036,0.0,8
2020-11-20 10:00:00+01:00,253,25,228,24.084070139549794,249,26,223,20.976233072746222,8,1036,0.0,8
2020-11-20 11:00:00+01:00,311,29,282,16.325599187415413,303,28,275,15.98015338859148,8,1036,0.0,8
2020-11-20 12:00:00+01:00,249,23,226,20.976233072746222,251,24,227,19.570183352800104,8,1036,0.0,8
2020-11-20 13:00:00+01:00,251,26,225,19.570183352800104,249,26,223,20.976233072746222,8,1036,0.0,8
2020-11-20 14:00:00+01:00,260,25,235,21.14564444182058,247,26,221,18.30797612224211,8,1036,0.0,8
2020-11-20 15:00:00+01:00,272,24,248,23.2664106640069,278,31,247,17.988889489265482,8,1036,0.0,8
2020-11-20 16:00:00+01:00,301,29,272,16.897732473063776,294,26,268,18.98421464015195,8,1036,0.0,8
2020-11-20 17:00:00+01:00,432,43,389,18.473076954520703,413,40,373,24.398754434847095,8,1036,0.0,8
2020-11-20 18:00:00+01:00,471,48,423,24.71489709392721,440,38,402,19.57754243382943,8,1036,0.0,8
2020-11-20 19:00:00+01:00,327,34,293,17.492932564197055,321,29,292,23.480156167605287,8,1036,0.0,8
2020-11-20 20:00:00+01:00,339,36,303,21.378284288972047,335,28,307,21.419812345615075,8,1036,0.0,8
2020-11-20 21:00:00+01:00,247,25,222,18.30797612224211,239,20,219,13.74553452780325,8,1036,0.0,8
2020-11-20 22:00:00+01:00,180,19,161,20.970253971133605,180,19,161,20.970253971133605,8,1036,0.0,8
2020-11-20 23:00:00+01:00,129,13,116,17.995114557081255,124,10,114,17.53992981591413,8,1036,0.0,8
2020-11-21 00:00:00+01:00,77,5,72,11.693765322784895,83,5,78,9.333357558089729,8,1036,0.0,7
2020-11-21 01:00:00+01:00,51,2,49,13.024781207847502,55,3,52,10.027044718132117,8,1036,0.0,7
2020-11-21 02:00:00+01:00,51,3,48,13.024781207847502,55,3,52,10.027044718132117,8,1036,0.0,7
2020-11-21 03:00:00+01:00,77,4,73,11.693765322784895,83,5,78,9.333357558089729,8,1036,0.0,7
2020-11-21 04:00:00+01:00,105,5,100,16.343560716114418,111,6,105,16.60196152330297,8,1036,0.0,7
2020-11-21 05:00:00+01:00,135,8,127,20.27811899595658,141,8,133,17.007652233540448,8,1036,0.0,7
2020-11-21 06:00:00+01:00,219,14,205,18.74397758884313,221,13,208,21.310706623471727,8,1036,0.0,7
2020-11-21 07:00:00+01:00,311,18,293,18.777054340822975,332,19,313,20.862138293674573,8,1036,0.0,7
2020-11-21 08:00:00+01:00,433,26,407,17.57064657679897,446,23,423,16.392503795900122,8,1036,0.0,7
2020-11-21 09:00:00+01:00,470,27,443,16.224212326735135,483,29,454,16.739079897917865,8,1036,0.0,7
2020-11-21 10:00:00+01:00,403,25,378,21.627704849822535,416,27,389,20.665581485173448,8,1036,0.0,7
2020-11-21 11:00:00+01:00,322,19,303,18.644637808692327,335,18,317,21.63506552863301,8,1036,0.0,7
2020-11-21 12:00:00+01:00,324,20,304,18.672846971084997,341,18,323,18.927558745642923,8,1036,0.0,7
2020-11-21 13:00:00+01:00,347,21,326,19.911580344317716,367,24,343,16.178745311566107,8,1036,0.0,7
2020-11-21 14:00:00+01:00,315,18,297,17.275310260978717,339,21,318,18.9351903306688,8,1036,0.0,7
2020-11-21 15:00:00+01:00,375,25,350,21.145699806578275,388,25,363,20.16254491947918,8,1036,0.0,7
2020-11-21 16:00:00+01:00,384,24,360,20.93762948810624,399,24,375,22.11505355738079,8,1036,0.0,7
2020-11-21 17:00:00+01:00,418,28,390,19.95137004302942,448,25,423,19.19628206057244,8,1036,0.0,7
2020-11-21 18:00:00+01:00,414,24,390,20.92110305719904,420,27,393,19.34293358515217,8,1036,0.0,7
2020-11-21 19:00:00+01:00,315,21,294,17.275310260978717,339,21,318,18.9351903306688,8,1036,0.0,7
2020-11-21 20:00:00+01:00,294,20,274,17.632695676481745,307,16,291,16.74476305242919,8,1036,0.0,7
2020-11-21 21:00:00+01:00,259,17,242,22.975221531884507,283,15,268,18.945435241048195,8,1036,0.0,7
2020-11-21 22:00:00+01:00,210,12,198,17.488096079787415,223,11,212,18.802339292525456,8,1036,0.0,7
2020-11-21 23:00:00+01:00,105,6,99,16.343560716114418,111,6,105,16.60196152330297,8,1036,0.0,7
2020-11-22 00:00:00+01:00,47,1,46,8.734704942588355,62,2,60,14.019247608895405,9,1031,0.0,7
2020-11-22 01:00:00+01:00,31,1,30,0.3699528216625179,38,1,37,5.960450042509954,9,1031,0.0,7
2020-11-22 02:00:00+01:00,31,1,30,0.3699528216625179,38,1,37,5.960450042509954,9,1031,0.0,7
2020-11-22 03:00:00+01:00,47,1,46,8.734704942588355,62,2,60,14.019247608895405,9,1031,0.0,7
2020-11-22 04:00:00+01:00,62,2,60,14.019247608895405,83,3,80,9.333357558089729,9,1031,0.0,7
2020-11-22 05:00:00+01:00,76,2,74,13.279950485691732,107,4,103,12.742346635562697,9,1031,0.0,7
2020-11-22 06:00:00+01:00,132,5,127,15.82621260035259,143,6,137,15.49985590484046,9,1031,0.0,7
2020-11-22 07:00:00+01:00,200,8,192,21.668114478408352,229,7,222,20.858973540615885,9,1031,0.0,7
2020-11-22 08:00:00+01:00,254,10,244,20.69602346457387,337,14,323,20.189680789887703,9,1031,0.0,7
2020-11-22 09:00:00+01:00,267,9,258,24.84759596655304,341,11,330,18.927558745642923,9,1031,0.0,7
2020-11-22 10:00:00+01:00,238,9,229,14.411005913654613,281,10,271,18.053311879599764,9,1031,0.0,7
2020-11-22 11:00:00+01:00,179,7,172,21.74229179161351,213,7,206,20.238518600536185,9,1031,0.0,7
2020-11-22 12:00:00+01:00,191,8,183,21.61132830766016,247,8,239,19.091366395871336,9,1031,0.0,7
2020-11-22 13:00:00+01:00,206,8,198,20.90053052788098,233,9,224,15.034753042734176,9,1031,0.0,7
2020-11-22 14:00:00+01:00,186,7,179,20.400698976924794,231,8,223,18.808415660395674,9,1031,0.0,7
2020-11-22 15:00:00+01:00,227,9,218,13.349035543905368,272,11,261,21.117195423222,9,1031,0.0,7
2020-11-22 16:00:00+01:00,218,8,210,17.36015147829793,222,8,214,17.594973015311762,9,1031,0.0,7
2020-11-22 17:00:00+01:00,247,10,237,19.091366395871336,323,12,311,19.446887597808452,9,1031,0.0,7
2020-11-22 18:00:00+01:00,238,9,229,14.411005913654613,281,10,271,18.053311879599764,9,1031,0.0,7
2020-11-22 19:00:00+01:00,179,7,172,21.74229179161351,213,7,206,20.238518600536185,9,1031,0.0,7
2020-11-22 20:00:00+01:00,175,7,168,18.893708159250245,224,9,215,19.039166559272836,9,1031,0.0,7
2020-11-22 21:00:00+01:00,150,5,145,19.93003466929675,184,6,178,19.759138180971462,9,1031,0.0,7
2020-11-22 22:00:00+01:00,125,4,121,11.899638158178501,150,6,144,19.93003466929675,9,1031,0.0,7
2020-11-22 23:00:00+01:00,60,2,58,12.98342242386016,83,3,80,9.333357558089729,9,1031,0.0,7
2020-11-23 00:00:00+01:00,86,7,79,21.204994436842384,89,8,81,17.562315027840828,9,1029,0.0,6
2020-11-23 01:00:00+01:00,58,5,53,10.505136369992313,58,7,51,10.505136369992313,9,1029,0.0,6
2020-11-23 02:00:00+01:00,61,6,55,12.362973378192347,58,6,52,10.505136369992313,9,1029,0.0,6
2020-11-23 03:00:00+01:00,91,9,82,13.154481673544206,89,8,81,17.562315027840828,9,1029,0.0,6
2020-11-23 04:00:00+01:00,147,13,134,20.208056467665056,154,18,136,23.457384968254527,9,1029,0.0,6
2020-11-23 05:00:00+01:00,258,28,230,21.93153719781745,265,27,238,24.143057918667047,9,1029,0.0,6
2020-11-23 06:00:00+01:00,323,31,292,19.17862862818099,335,41,294,21.419812345615075,9,1029,0.0,6
2020-11-23 07:00:00+01:00,485,50,435,22.091670962118773,527,58,469,18.36347321630945,9,1029,0.0,6
2020-11-23 08:00:00+01:00,509,49,460,12.20192288247499,560,54,506,19.606018509461766,9,1029,0.0,6
2020-11-23 09:00:00+01:00,354,34,320,21.22371738501729,373,38,335,20.02368697341565,9,1029,0.0,6
2020-11-23 10:00:00+01:00,297,28,269,18.348417493587977,295,28,267,20.557446011766526,9,1029,0.0,6
2020-11-23 11:00:00+01:00,347,31,316,19.399384547744187,363,41,322,20.037936765942277,9,1029,0.0,6
2020-11-23 12:00:00+01:00,295,32,263,20.557446011766526,295,28,267,20.557446011766526,9,1029,0.0,6
2020-11-23 13:00:00+01:00,290,26,264,18.088844908617002,300,35,265,19.621479548992166,9,1029,0.0,6
2020-11-23 14:00:00+01:00,286,28,258,20.398524223626136,307,37,270,19.62844127124222,9,1029,0.0,6
2020-11-23 15:00:00+01:00,319,33,286,20.382766877627866,340,42,298,18.92958933704513,9,1029,0.0,6
2020-11-23 16:00:00+01:00,366,33,333,21.40807985369936,358,45,313,18.044939279580262,9,1029,0.0,6
2020-11-23 17:00:00+01:00,499,52,447,21.95846674548548,523,61,462,16.192550011919526,9,1029,0.0,6
2020-11-23 18:00:00+01:00,532,56,476,22.31530989594808,551,57,494,23.574220809021288,9,1029,0.0,6
2020-11-23 19:00:00+01:00,380,36,344,15.070197513038655,384,47,337,23.18758332904822,9,1029,0.0,6
2020-11-23 20:00:00+01:00,401,40,361,26.708807440790352,389,44,345,21.37920911023894,9,1029,0.0,6
2020-11-23 21:00:00+01:00,290,27,263,18.088844908617002,300,35,265,19.621479548992166,9,1029,0.0,6
2020-11-23 22:00:00+01:00,199,19,180,21.764655927821806,213,21,192,20.488166305452438,9,1029,0.0,6
2020-11-23 23:00:00+01:00,154,15,139,23.457384968254527,147,18,129,20.208056467665056,9,1029,0.0,6
2020-11-24 00:00:00+01:00,89,8,81,17.562315027840828,91,7,84,13.154481673544206,9,1028,0.0,6
2020-11-24 01:00:00+01:00,53,4,49,8.976459755768028,63,6,57,14.929801273937542,9,1028,0.0,6
2020-11-24 02:00:00+01:00,51,4,47,7.252205043556333,58,5,53,10.505136369992313,9,1028,0.0,6
2020-11-24 03:00:00+01:00,84,8,76,14.398269762880606,96,10,86,11.83328593996439,9,1028,0.0,6
2020-11-24 04:00:00+01:00,133,12,121,22.07413438879217,150,14,136,17.939622434692456,9,1028,0.0,6
2020-11-24 05:00:00+01:00,260,21,239,21.14564444182058,272,29,243,23.2664106640069,9,1028,0.0,6
2020-11-24 06:00:00+01:00,323,28,295,19.17862862818099,351,38,313,16.04918751558848,9,1028,0.0,6
2020-11-24 07:00:00+01:00,466,42,424,20.265872741633896,508,44,464,22.57591031476529,9,1028,0.0,6
2020-11-24 08:00:00+01:00,539,50,489,14.75171382469777,567,56,511,18.997866913295,9,1028,0.0,6
2020-11-24 09:00:00+01:00,351,30,321,16.04918751558848,363,36,327,20.037936765942277,9,1028,0.0,6
2020-11-24 10:00:00+01:00,276,27,249,21.646913060128323,302,29,273,17.71336274061634,9,1028,0.0,6
2020-11-24 11:00:00+01:00,318,28,290,21.634505447676812,358,36,322,18.044939279580262,9,1028,0.0,6
2020-11-24 12:00:00+01:00,274,25,249,20.56786912693606,311,35,276,16.325599187415413,9,1028,0.0,6
2020-11-24 13:00:00+01:00,279,24,255,23.809963875172556,311,35,276,16.325599187415413,9,1028,0.0,6
2020-11-24 14:00:00+01:00,279,24,255,23.809963875172556,311,35,276,16.325599187415413,9,1028,0.0,6
2020-11-24 15:00:00+01:00,307,26,281,19.62844127124222,328,35,293,17.860857228116767,9,1028,0.0,6
2020-11-24 16:00:00+01:00,361,36,325,19.1870055662437,368,42,326,19.722641588533307,9,1028,0.0,6
2020-11-24 17:00:00+01:00,459,41,418,21.314720332142485,530,48,482,19.57875562009149,9,1028,0.0,6
2020-11-24 18:00:00+01:00,504,49,455,17.785796251967053,558,56,502,21.887504875695765,9,1028,0.0,6
2020-11-24 19:00:00+01:00,389,32,357,21.37920911023894,391,35,356,20.019115852021912,9,1028,0.0,6
2020-11-24 20:00:00+01:00,354,29,325,21.22371738501729,394,36,358,21.238013248853637,9,1028,0.0,6
2020-11-24 21:00:00+01:00,279,24,255,23.809963875172556,311,35,276,16.325599187415413,9,1028,0.0,6
2020-11-24 22:00:00+01:00,194,16,178,21.593451125557873,220,19,201,16.758079648934128,9,1028,0.0,6
2020-11-24 23:00:00+01:00,138,11,127,20.21600799483387,145,14,131,18.85528596371164,9,1028,0.0,6
2020-11-25 00:00:00+01:00,73,9,64,16.437112601261585,73,8,65,16.437112601261585,9,1016,0.0,10
2020-11-25 01:00:00+01:00,48,6,42,9.13890902221218,46,5,41,7.79278142701588,9,1016,0.0,10
2020-11-25 02:00:00+01:00,48,6,42,9.13890902221218,46,5,41,7.79278142701588,9,1016,0.0,10
2020-11-25 03:00:00+01:00,73,9,64,16.437112601261585,73,8,65,16.437112601261585,9,1016,0.0,10
2020-11-25 04:00:00+01:00,123,15,108,15.262138605096247,117,12,105,12.235552510813584,9,1016,0.0,10
2020-11-25 05:00:00+01:00,218,26,192,22.73300845004657,197,24,173,16.840472953316162,9,1016,0.0,10
2020-11-25 06:00:00+01:00,268,32,236,19.54671273578713,262,32,230,22.836816144401386,9,1016,0.0,10
2020-11-25 07:00:00+01:00,417,48,369,19.5232508211744,379,48,331,20.059308979444502,9,1016,0.0,10
2020-11-25 08:00:00+01:00,438,52,386,16.348655609858998,400,43,357,24.218092797619367,9,1016,0.0,10
2020-11-25 09:00:00+01:00,293,35,258,20.77933514509894,286,32,254,22.799042804335677,9,1016,0.0,10
2020-11-25 10:00:00+01:00,245,33,212,21.661045851911695,228,25,203,11.999655172013497,9,1016,0.0,10
2020-11-25 11:00:00+01:00,292,33,259,19.952391837450627,274,28,246,27.25802623834161,9,1016,0.0,10
2020-11-25 12:00:00+01:00,243,28,215,25.380099969640305,232,28,204,24.606618615768106,9,1016,0.0,10
2020-11-25 13:00:00+01:00,241,29,212,22.882071172466965,220,24,196,18.729640796362187,9,1016,0.0,10
2020-11-25 14:00:00+01:00,247,31,216,22.66625775717105,228,25,203,11.999655172013497,9,1016,0.0,10
2020-11-25 15:00:00+01:00,268,30,238,19.54671273578713,262,32,230,22.836816144401386,9,1016,0.0,10
2020-11-25 16:00:00+01:00,293,33,260,20.77933514509894,286,32,254,22.799042804335677,9,1016,0.0,10
2020-11-25 17:00:00+01:00,415,56,359,16.256703031864188,379,48,331,20.059308979444502,9,1016,0.0,10
2020-11-25 18:00:00+01:00,438,52,386,16.348655609858998,400,43,357,24.218092797619367,9,1016,0.0,10
2020-11-25 19:00:00+01:00,317,38,279,19.022172849432163,299,31,268,19.217825841133752,9,1016,0.0,10
2020-11-25 20:00:00+01:00,322,39,283,23.67757984571023,297,29,268,19.43137253304159,9,1016,0.0,10
2020-11-25 21:00:00+01:00,243,28,215,25.380099969640305,232,28,204,24.606618615768106,9,1016,0.0,10
2020-11-25 22:00:00+01:00,168,20,148,18.818575971293154,158,15,143,20.016713756826867,9,1016,0.0,10
2020-11-25 23:00:00+01:00,121,14,107,14.174023637152917,112,14,98,16.537505199847164,9,1016,0.0,10
2020-11-26 00:00:00+01:00,85,7,78,19.289671453475872,87,12,75,17.896548892855574,10,1019,0.0,6
2020-11-26 01:00:00+01:00,61,5,56,12.362973378192347,56,7,49,10.152150256689218,10,1019,0.0,6
2020-11-26 02:00:00+01:00,58,4,54,10.505136369992313,61,9,52,12.362973378192347,10,1019,0.0,6
2020-11-26 03:00:00+01:00,78,6,72,16.41986115786707,90,12,78,13.960700117154147,10,1019,0.0,6
2020-11-26 04:00:00+01:00,151,13,138,19.408157188048275,151,18,133,19.408157188048275,10,1019,0.0,6
2020-11-26 05:00:00+01:00,253,19,234,24.084070139549794,268,40,228,16.114987230113258,10,1019,0.0,6
2020-11-26 06:00:00+01:00,305,23,282,19.342371998402466,322,41,281,22.976009334024873,10,1019,0.0,6
2020-11-26 07:00:00+01:00,520,44,476,21.447261472760864,507,79,428,20.732028813124888,10,1019,0.0,6
2020-11-26 08:00:00+01:00,559,50,509,22.603831145806197,527,70,457,18.36347321630945,10,1019,0.0,6
2020-11-26 09:00:00+01:00,366,32,334,21.40807985369936,358,58,300,18.044939279580262,10,1019,0.0,6
2020-11-26 10:00:00+01:00,275,23,252,24.67224255888931,302,49,253,17.71336274061634,10,1019,0.0,6
2020-11-26 11:00:00+01:00,319,26,293,20.382766877627866,376,59,317,15.920759199358614,10,1019,0.0,6
2020-11-26 12:00:00+01:00,283,22,261,21.015453076893927,300,39,261,19.621479548992166,10,1019,0.0,6
2020-11-26 13:00:00+01:00,266,22,244,24.416240816629376,295,40,255,20.557446011766526,10,1019,0.0,6
2020-11-26 14:00:00+01:00,271,20,251,24.814459053724722,307,38,269,19.62844127124222,10,1019,0.0,6
2020-11-26 15:00:00+01:00,297,26,271,18.348417493587977,319,40,279,20.382766877627866,10,1019,0.0,6
2020-11-26 16:00:00+01:00,366,31,335,21.40807985369936,358,58,300,18.044939279580262,10,1019,0.0,6
2020-11-26 17:00:00+01:00,468,40,428,19.71650853762924,495,61,434,22.447345833209692,10,1019,0.0,6
2020-11-26 18:00:00+01:00,503,43,460,18.697693722393225,561,72,489,19.266161028294455,10,1019,0.0,6
2020-11-26 19:00:00+01:00,398,33,365,15.798181076462747,371,53,318,20.767700865402965,10,1019,0.0,6
2020-11-26 20:00:00+01:00,402,31,371,17.230856788696144,388,59,329,23.106523601706122,10,1019,0.0,6
2020-11-26 21:00:00+01:00,293,23,270,19.851789935750844,310,43,267,16.921651532922695,10,1019,0.0,6
2020-11-26 22:00:00+01:00,195,15,180,23.83440770251287,214,27,187,18.560318290748608,10,1019,0.0,6
2020-11-26 23:00:00+01:00,146,12,134,20.98788244482569,153,18,135,14.915022999208679,10,1019,0.0,6
2020-11-27 00:00:00+01:00,93,8,85,12.914854269394333,88,7,81,17.756927742208592,9,1020,0.0,4
2020-11-27 01:00:00+01:00,63,6,57,14.929801273937542,58,5,53,10.505136369992313,9,1020,0.0,4
2020-11-27 02:00:00+01:00,63,6,57,14.929801273937542,58,5,53,10.505136369992313,9,1020,0.0,4
2020-11-27 03:00:00+01:00,93,10,83,12.914854269394333,88,7,81,17.756927742208592,9,1020,0.0,4
2020-11-27 04:00:00+01:00,159,16,143,17.78748005044877,154,13,141,23.457384968254527,9,1020,0.0,4
2020-11-27 05:00:00+01:00,276,30,246,21.646913060128323,276,26,250,21.646913060128323,9,1020,0.0,4
2020-11-27 06:00:00+01:00,342,33,309,17.147818156889407,324,35,289,20.507764200909268,9,1020,0.0,4
2020-11-27 07:00:00+01:00,545,58,487,19.63111833719715,504,45,459,17.785796251967053,9,1020,0.0,4
2020-11-27 08:00:00+01:00,568,57,511,20.442364330592024,563,59,504,20.337981892053655,9,1020,0.0,4
2020-11-27 09:00:00+01:00,375,36,339,22.64494297948435,373,35,338,20.02368697341565,9,1020,0.0,4
2020-11-27 10:00:00+01:00,314,30,284,19.381500590217087,309,27,282,17.68578168988432,9,1020,0.0,4
2020-11-27 11:00:00+01:00,378,36,342,19.765573549462566,378,34,344,19.765573549462566,9,1020,0.0,4
2020-11-27 12:00:00+01:00,314,29,285,19.381500590217087,309,27,282,17.68578168988432,9,1020,0.0,4
2020-11-27 13:00:00+01:00,314,30,284,19.381500590217087,309,27,282,17.68578168988432,9,1020,0.0,4
2020-11-27 14:00:00+01:00,314,30,284,19.381500590217087,309,27,282,17.68578168988432,9,1020,0.0,4
2020-11-27 15:00:00+01:00,345,33,312,18.48984602659702,350,40,310,21.39774246689966,9,1020,0.0,4
2020-11-27 16:00:00+01:00,380,38,342,15.070197513038655,362,40,322,18.208767664177746,9,1020,0.0,4
2020-11-27 17:00:00+01:00,553,59,494,21.584774386830425,548,55,493,21.450998981477422,9,1020,0.0,4
2020-11-27 18:00:00+01:00,565,53,512,17.51797887308028,563,59,504,20.337981892053655,9,1020,0.0,4
2020-11-27 19:00:00+01:00,406,39,367,17.471736216533994,390,36,354,23.204029211730827,9,1020,0.0,4
2020-11-27 20:00:00+01:00,406,44,362,17.471736216533994,390,36,354,23.204029211730827,9,1020,0.0,4
2020-11-27 21:00:00+01:00,312,33,279,18.640393178431868,312,29,283,18.640393178431868,9,1020,0.0,4
2020-11-27 22:00:00+01:00,218,20,198,22.57742359713229,223,24,199,21.320656431140716,9,1020,0.0,4
2020-11-27 23:00:00+01:00,152,14,138,20.188330220444417,157,14,143,23.857880119976507,9,1020,0.0,4
2020-11-28 00:00:00+01:00,86,5,81,9.565861223121674,91,4,87,8.844154374326946,10,1016,0.0,7
2020-11-28 01:00:00+01:00,56,3,53,11.681432660358455,58,3,55,11.561797090249616,10,1016,0.0,7
2020-11-28 02:00:00+01:00,56,3,53,11.681432660358455,58,3,55,11.561797090249616,10,1016,0.0,7
2020-11-28 03:00:00+01:00,84,5,79,7.6306798135980785,91,4,87,8.844154374326946,10,1016,0.0,7
2020-11-28 04:00:00+01:00,114,6,108,16.208309351778738,121,7,114,11.617438248542046,10,1016,0.0,7
2020-11-28 05:00:00+01:00,140,8,132,15.157104538016958,154,9,145,19.868163821621103,10,1016,0.0,7
2020-11-28 06:00:00+01:00,224,13,211,19.039166559272836,240,13,227,19.372323114313716,10,1016,0.0,7
2020-11-28 07:00:00+01:00,339,19,320,18.9351903306688,367,24,343,16.178745311566107,10,1016,0.0,7
2020-11-28 08:00:00+01:00,458,27,431,23.935839893982745,484,24,460,23.138456707333336,10,1016,0.0,7
2020-11-28 09:00:00+01:00,498,31,467,14.222982449555595,523,35,488,15.86377141768892,10,1016,0.0,7
2020-11-28 10:00:00+01:00,442,26,416,22.71527178577055,456,27,429,20.030973704990842,10,1016,0.0,7
2020-11-28 11:00:00+01:00,353,21,332,19.24169978578992,369,24,345,14.559507357779353,10,1016,0.0,7
2020-11-28 12:00:00+01:00,355,21,334,19.867707600873487,369,22,347,14.559507357779353,10,1016,0.0,7
2020-11-28 13:00:00+01:00,383,23,360,21.26625994117601,399,22,377,22.11505355738079,10,1016,0.0,7
2020-11-28 14:00:00+01:00,341,23,318,18.927558745642923,367,22,345,16.178745311566107,10,1016,0.0,7
2020-11-28 15:00:00+01:00,402,24,378,13.628611178524041,423,28,395,16.440651492044253,10,1016,0.0,7
2020-11-28 16:00:00+01:00,397,24,373,17.649629378165546,423,28,395,16.440651492044253,10,1016,0.0,7
2020-11-28 17:00:00+01:00,456,28,428,20.030973704990842,493,27,466,15.790488496822915,10,1016,0.0,7
2020-11-28 18:00:00+01:00,428,26,402,17.257875995493368,456,25,431,20.030973704990842,10,1016,0.0,7
2020-11-28 19:00:00+01:00,353,21,332,19.24169978578992,369,24,345,14.559507357779353,10,1016,0.0,7
2020-11-28 20:00:00+01:00,325,19,306,18.163130994775884,334,21,313,17.139636433234756,10,1016,0.0,7
2020-11-28 21:00:00+01:00,292,16,276,17.87884891495493,301,15,286,20.607812327110423,10,1016,0.0,7
2020-11-28 22:00:00+01:00,231,13,218,18.808415660395674,245,16,229,17.30944248589229,10,1016,0.0,7
2020-11-28 23:00:00+01:00,116,7,109,11.000262455867666,121,7,114,11.617438248542046,10,1016,0.0,7
2020-11-29 00:00:00+01:00,38,1,37,5.960450042509954,54,2,52,11.483713237443984,9,1019,0.0,10
2020-11-29 01:00:00+01:00,25,1,24,0.10677168789919293,36,1,35,2.727177547566476,9,1019,0.0,10
2020-11-29 02:00:00+01:00,27,1,26,0.2711247026271743,36,1,35,2.727177547566476,9,1019,0.0,10
2020-11-29 03:00:00+01:00,40,1,39,6.907029621336792,52,1,51,14.472017643602554,9,1019,0.0,10
2020-11-29 04:00:00+01:00,54,2,52,11.483713237443984,61,2,59,13.45123014142322,9,1019,0.0,10
2020-11-29 05:00:00+01:00,65,2,63,10.13470849860639,91,3,88,8.844154374326946,9,1019,0.0,10
2020-11-29 06:00:00+01:00,108,4,104,15.795702759121413,123,5,118,13.78591137222831,9,1019,0.0,10
2020-11-29 07:00:00+01:00,154,5,149,19.868163821621103,164,5,159,18.874121315806054,9,1019,0.0,10
2020-11-29 08:00:00+01:00,224,8,216,19.039166559272836,234,8,226,18.523045519331724,9,1019,0.0,10
2020-11-29 09:00:00+01:00,228,9,219,19.28787791304013,284,11,273,16.935782048371557,9,1019,0.0,10
2020-11-29 10:00:00+01:00,199,7,192,19.11274068140836,247,8,239,19.091366395871336,9,1019,0.0,10
2020-11-29 11:00:00+01:00,164,6,158,18.874121315806054,218,7,211,17.36015147829793,9,1019,0.0,10
2020-11-29 12:00:00+01:00,154,6,148,19.868163821621103,164,5,159,18.874121315806054,9,1019,0.0,10
2020-11-29 13:00:00+01:00,182,7,175,16.329362148305133,199,7,192,19.11274068140836,9,1019,0.0,10
2020-11-29 14:00:00+01:00,162,5,157,18.435104799511247,197,7,190,19.118279085736297,9,1019,0.0,10
2020-11-29 15:00:00+01:00,183,7,176,15.872019474492381,220,8,212,20.77869221062603,9,1019,0.0,10
2020-11-29 16:00:00+01:00,180,6,174,18.453361889556408,214,7,207,18.026924150727908,9,1019,0.0,10
2020-11-29 17:00:00+01:00,214,7,207,18.026924150727908,257,8,249,18.99808160477331,9,1019,0.0,10
2020-11-29 18:00:00+01:00,214,8,206,18.026924150727908,242,7,235,18.93135513529779,9,1019,0.0,10
2020-11-29 19:00:00+01:00,160,6,154,18.858823274894117,197,7,190,19.118279085736297,9,1019,0.0,10
2020-11-29 20:00:00+01:00,143,5,138,15.49985590484046,207,7,200,18.76558942906742,9,1019,0.0,10
2020-11-29 21:00:00+01:00,139,5,134,19.408576933840735,187,7,180,15.611538170802525,9,1019,0.0,10
2020-11-29 22:00:00+01:00,112,4,108,19.016823421759323,143,5,138,15.49985590484046,9,1019,0.0,10
2020-11-29 23:00:00+01:00,56,2,54,11.681432660358455,54,2,52,11.483713237443984,9,1019,0.0,10
2020-11-30 00:00:00+01:00,78,8,70,16.41986115786707,80,8,72,18.237765354324676,6,1026,0.0,5
2020-11-30 01:00:00+01:00,53,4,49,8.976459755768028,55,5,50,8.909875597117273,6,1026,0.0,5
2020-11-30 02:00:00+01:00,55,5,50,8.909875597117273,55,5,50,8.909875597117273,6,1026,0.0,5
2020-11-30 03:00:00+01:00,82,7,75,16.39179981762634,80,9,71,18.237765354324676,6,1026,0.0,5
2020-11-30 04:00:00+01:00,136,12,124,16.594078125250377,136,15,121,16.594078125250377,6,1026,0.0,5
2020-11-30 05:00:00+01:00,246,24,222,17.57126233227549,242,28,214,20.990360069331732,6,1026,0.0,5
2020-11-30 06:00:00+01:00,295,29,266,20.557446011766526,295,28,267,20.557446011766526,6,1026,0.0,5
2020-11-30 07:00:00+01:00,446,41,405,22.957333740469338,457,51,406,24.393218626777333,6,1026,0.0,5
2020-11-30 08:00:00+01:00,508,54,454,22.57591031476529,508,59,449,22.57591031476529,6,1026,0.0,5
2020-11-30 09:00:00+01:00,310,30,280,16.921651532922695,327,34,293,17.492932564197055,6,1026,0.0,5
2020-11-30 10:00:00+01:00,265,24,241,24.143057918667047,270,28,242,23.920073269237992,6,1026,0.0,5
2020-11-30 11:00:00+01:00,331,30,301,18.08059708638437,323,33,290,19.17862862818099,6,1026,0.0,5
2020-11-30 12:00:00+01:00,280,29,251,25.91177046818179,272,32,240,23.2664106640069,6,1026,0.0,5
2020-11-30 13:00:00+01:00,272,29,243,23.2664106640069,278,29,249,17.988889489265482,6,1026,0.0,5
2020-11-30 14:00:00+01:00,265,25,240,24.143057918667047,270,28,242,23.920073269237992,6,1026,0.0,5
2020-11-30 15:00:00+01:00,304,27,277,22.339067945756394,310,30,280,16.921651532922695,6,1026,0.0,5
2020-11-30 16:00:00+01:00,325,31,294,19.331050121665143,334,40,294,23.256671102053218,6,1026,0.0,5
2020-11-30 17:00:00+01:00,470,47,423,21.98902238846196,463,50,413,21.06469305151698,6,1026,0.0,5
2020-11-30 18:00:00+01:00,472,43,429,21.284214830242632,500,60,440,17.209416446934323,6,1026,0.0,5
2020-11-30 19:00:00+01:00,351,36,315,16.04918751558848,351,38,313,16.04918751558848,6,1026,0.0,5
2020-11-30 20:00:00+01:00,346,34,312,20.434066589603663,357,45,312,21.912097396672888,6,1026,0.0,5
2020-11-30 21:00:00+01:00,265,25,240,24.143057918667047,270,28,242,23.920073269237992,6,1026,0.0,5
2020-11-30 22:00:00+01:00,193,17,176,21.558071117560736,191,20,171,20.658016380524305,6,1026,0.0,5
2020-11-30 23:00:00+01:00,138,14,124,20.21600799483387,131,14,117,14.183230975852695,6,1026,0.0,5
2020-12-01 00:00:00+01:00,39,3,36,6.782457974710225,41,4,37,8.457036189746331,8,1022,0.3,14
2020-12-01 01:00:00+01:00,28,2,26,4.026144260024548,28,2,26,4.026144260024548,8,1022,0.3,14
2020-12-01 02:00:00+01:00,24,2,22,1.5004308879154395,28,2,26,4.026144260024548,8,1022,0.3,14
2020-12-01 03:00:00+01:00,37,3,34,2.066086063070793,45,4,41,8.16653528554085,8,1022,0.3,14
2020-12-01 04:00:00+01:00,68,6,62,14.701855472363336,76,8,68,16.686685835236233,8,1022,0.3,14
2020-12-01 05:00:00+01:00,119,11,108,22.46945513312648,131,13,118,14.183230975852695,8,1022,0.3,14
2020-12-01 06:00:00+01:00,147,12,135,20.208056467665056,169,14,155,18.567569965901342,8,1022,0.3,14
2020-12-01 07:00:00+01:00,231,22,209,16.702836426900134,257,23,234,24.369710124951805,8,1022,0.3,14
2020-12-01 08:00:00+01:00,248,20,228,17.312704307039937,267,28,239,13.385499595100717,8,1022,0.3,14
2020-12-01 09:00:00+01:00,171,15,156,22.137070929890193,175,16,159,17.666202741429842,8,1022,0.3,14
2020-12-01 10:00:00+01:00,144,13,131,22.91915418498221,145,15,130,18.85528596371164,8,1022,0.3,14
2020-12-01 11:00:00+01:00,169,15,154,18.567569965901342,180,20,160,20.970253971133605,8,1022,0.3,14
2020-12-01 12:00:00+01:00,138,13,125,20.21600799483387,141,14,127,21.00935462418931,8,1022,0.3,14
2020-12-01 13:00:00+01:00,140,12,128,15.331768592489755,141,14,127,21.00935462418931,8,1022,0.3,14
2020-12-01 14:00:00+01:00,140,12,128,15.331768592489755,141,14,127,21.00935462418931,8,1022,0.3,14
2020-12-01 15:00:00+01:00,155,13,142,19.469409355748308,157,17,140,23.857880119976507,8,1022,0.3,14
2020-12-01 16:00:00+01:00,161,14,147,19.983041252146048,170,15,155,19.775542485132945,8,1022,0.3,14
2020-12-01 17:00:00+01:00,243,20,223,18.936896488437778,250,26,224,14.642007731534619,8,1022,0.3,14
2020-12-01 18:00:00+01:00,241,22,219,21.076687701702674,267,27,240,13.385499595100717,8,1022,0.3,14
2020-12-01 19:00:00+01:00,186,16,170,22.772295906033783,184,16,168,20.655558446800804,8,1022,0.3,14
2020-12-01 20:00:00+01:00,172,14,158,19.644113972447897,195,21,174,23.83440770251287,8,1022,0.3,14
2020-12-01 21:00:00+01:00,144,14,130,22.91915418498221,145,15,130,18.85528596371164,8,1022,0.3,14
2020-12-01 22:00:00+01:00,98,8,90,10.878679660088993,100,9,91,11.502705756568044,8,1022,0.3,14
2020-12-01 23:00:00+01:00,69,6,63,19.29595730158091,71,7,64,15.50461576454985,8,1022,0.3,14
2020-12-02 00:00:00+01:00,38,5,33,7.590795833711637,34,3,31,11.019687492562438,7,1020,0.0,18
2020-12-02 01:00:00+01:00,25,3,22,4.851536786659508,25,2,23,4.851536786659508,7,1020,0.0,18
2020-12-02 02:00:00+01:00,25,2,23,4.851536786659508,25,2,23,4.851536786659508,7,1020,0.0,18
2020-12-02 03:00:00+01:00,38,4,34,7.590795833711637,34,3,31,11.019687492562438,7,1020,0.0,18
2020-12-02 04:00:00+01:00,63,7,56,13.630126271531418,62,6,56,12.779859753427614,7,1020,0.0,18
2020-12-02 05:00:00+01:00,114,13,101,17.516346710171707,112,12,100,16.537505199847164,7,1020,0.0,18
2020-12-02 06:00:00+01:00,140,19,121,17.88117043007633,141,14,127,16.082921323202,7,1020,0.0,18
2020-12-02 07:00:00+01:00,214,24,190,24.48806340301503,203,19,184,21.5050173548228,7,1020,0.0,18
2020-12-02 08:00:00+01:00,226,28,198,20.105295377891462,220,27,193,18.729640796362187,7,1020,0.0,18
2020-12-02 09:00:00+01:00,153,19,134,18.89706115395996,139,16,123,21.474746575274906,7,1020,0.0,18
2020-12-02 10:00:00+01:00,126,17,109,16.250667590352332,123,13,110,15.262138605096247,7,1020,0.0,18
2020-12-02 11:00:00+01:00,153,18,135,18.89706115395996,139,16,123,21.474746575274906,7,1020,0.0,18
2020-12-02 12:00:00+01:00,126,17,109,16.250667590352332,123,13,110,15.262138605096247,7,1020,0.0,18
2020-12-02 13:00:00+01:00,127,15,112,19.95892802947898,120,14,106,10.291257377501918,7,1020,0.0,18
2020-12-02 14:00:00+01:00,127,16,111,19.95892802947898,120,14,106,10.291257377501918,7,1020,0.0,18
2020-12-02 15:00:00+01:00,140,18,122,17.88117043007633,141,14,127,16.082921323202,7,1020,0.0,18
2020-12-02 16:00:00+01:00,151,17,134,19.198981193831877,149,16,133,18.476483571588744,7,1020,0.0,18
2020-12-02 17:00:00+01:00,217,26,191,20.47500927792046,213,24,189,16.70464389525102,7,1020,0.0,18
2020-12-02 18:00:00+01:00,232,26,206,24.606618615768106,205,22,183,18.29833304368066,7,1020,0.0,18
2020-12-02 19:00:00+01:00,167,22,145,16.493575022686013,154,14,140,25.102227050596255,7,1020,0.0,18
2020-12-02 20:00:00+01:00,167,21,146,16.493575022686013,154,14,140,25.102227050596255,7,1020,0.0,18
2020-12-02 21:00:00+01:00,129,16,113,12.321757402623772,125,13,112,14.698947587184879,7,1020,0.0,18
2020-12-02 22:00:00+01:00,89,11,78,16.127888447212325,79,9,70,16.621554061874914,7,1020,0.0,18
2020-12-02 23:00:00+01:00,63,8,55,13.630126271531418,62,6,56,12.779859753427614,7,1020,0.0,18
2020-12-03 00:00:00+01:00,59,4,55,10.572210467564378,59,8,51,10.572210467564378,6,1012,0.0,9
2020-12-03 01:00:00+01:00,42,3,39,5.988628884327601,42,5,37,5.988628884327601,6,1012,0.0,9
2020-12-03 02:00:00+01:00,41,3,38,8.457036189746331,42,5,37,5.988628884327601,6,1012,0.0,9
2020-12-03 03:00:00+01:00,61,5,56,12.362973378192347,59,8,51,10.572210467564378,6,1012,0.0,9
2020-12-03 04:00:00+01:00,109,9,100,14.645038576883659,99,12,87,10.779955578794215,6,1012,0.0,9
2020-12-03 05:00:00+01:00,174,14,160,14.257286675630954,190,30,160,20.51689583562818,6,1012,0.0,9
2020-12-03 06:00:00+01:00,236,18,218,19.106111918840778,234,36,198,19.754580108435302,6,1012,0.0,9
2020-12-03 07:00:00+01:00,320,26,294,21.04137400974582,373,58,315,20.02368697341565,6,1012,0.0,9
2020-12-03 08:00:00+01:00,353,28,325,20.016393666106563,392,62,330,15.515848376438075,6,1012,0.0,9
2020-12-03 09:00:00+01:00,236,19,217,19.106111918840778,255,39,216,21.41944964647189,6,1012,0.0,9
2020-12-03 10:00:00+01:00,221,18,203,20.34114880306217,209,25,184,22.16757043059366,6,1012,0.0,9
2020-12-03 11:00:00+01:00,236,18,218,19.106111918840778,255,39,216,21.41944964647189,6,1012,0.0,9
2020-12-03 12:00:00+01:00,221,18,203,20.34114880306217,209,25,184,22.16757043059366,6,1012,0.0,9
2020-12-03 13:00:00+01:00,197,15,182,19.020846849172088,217,27,190,21.833662628048735,6,1012,0.0,9
2020-12-03 14:00:00+01:00,219,16,203,21.009686825041197,209,25,184,22.16757043059366,6,1012,0.0,9
2020-12-03 15:00:00+01:00,217,16,201,21.833662628048735,222,31,191,18.77573498601868,6,1012,0.0,9
2020-12-03 16:00:00+01:00,222,18,204,18.77573498601868,239,35,204,13.74553452780325,6,1012,0.0,9
2020-12-03 17:00:00+01:00,375,31,344,22.64494297948435,358,48,310,18.044939279580262,6,1012,0.0,9
2020-12-03 18:00:00+01:00,347,30,317,19.399384547744187,385,56,329,23.62167138094536,6,1012,0.0,9
2020-12-03 19:00:00+01:00,286,23,263,20.398524223626136,286,44,242,20.398524223626136,6,1012,0.0,9
2020-12-03 20:00:00+01:00,267,23,244,13.385499595100717,275,36,239,24.67224255888931,6,1012,0.0,9
2020-12-03 21:00:00+01:00,198,18,180,18.14522738171017,217,27,190,21.833662628048735,6,1012,0.0,9
2020-12-03 22:00:00+01:00,152,11,141,20.188330220444417,149,19,130,20.003285796587473,6,1012,0.0,9
2020-12-03 23:00:00+01:00,101,7,94,11.280950715811313,107,16,91,12.156196464705383,6,1012,0.0,9
2020-12-04 00:00:00+01:00,36,3,33,3.0873599992209124,38,3,35,11.101073107969722,6,982,4.7,16
2020-12-04 01:00:00+01:00,25,2,23,1.1875344360364632,25,2,23,1.1875344360364632,6,982,4.7,16
2020-12-04 02:00:00+01:00,25,2,23,1.1875344360364632,25,2,23,1.1875344360364632,6,982,4.7,16
2020-12-04 03:00:00+01:00,37,3,34,2.066086063070793,38,4,34,11.101073107969722,6,982,4.7,16
2020-12-04 04:00:00+01:00,63,6,57,14.929801273937542,58,5,53,10.505136369992313,6,982,4.7,16
2020-12-04 05:00:00+01:00,113,12,101,20.093188266697116,113,11,102,20.093188266697116,6,982,4.7,16
2020-12-04 06:00:00+01:00,140,13,127,15.331768592489755,129,13,116,17.995114557081255,6,982,4.7,16
2020-12-04 07:00:00+01:00,210,19,191,16.3212742992447,212,18,194,18.597605283865732,6,982,4.7,16
2020-12-04 08:00:00+01:00,228,23,205,15.818609956751573,211,19,192,18.759232281731908,6,982,4.7,16
2020-12-04 09:00:00+01:00,147,14,133,20.208056467665056,153,13,140,14.915022999208679,6,982,4.7,16
2020-12-04 10:00:00+01:00,124,11,113,17.53992981591413,117,12,105,21.891304075969387,6,982,4.7,16
2020-12-04 11:00:00+01:00,153,15,138,14.915022999208679,148,13,135,18.058884943386857,6,982,4.7,16
2020-12-04 12:00:00+01:00,129,13,116,17.995114557081255,123,10,113,19.074654696202938,6,982,4.7,16
2020-12-04 13:00:00+01:00,124,12,112,17.53992981591413,117,12,105,21.891304075969387,6,982,4.7,16
2020-12-04 14:00:00+01:00,128,12,116,19.601953989978306,123,10,113,19.074654696202938,6,982,4.7,16
2020-12-04 15:00:00+01:00,136,14,122,16.594078125250377,138,14,124,20.21600799483387,6,982,4.7,16
2020-12-04 16:00:00+01:00,145,14,131,18.85528596371164,154,15,139,23.457384968254527,6,982,4.7,16
2020-12-04 17:00:00+01:00,207,22,185,21.877297854955202,202,19,183,22.500350864850866,6,982,4.7,16
2020-12-04 18:00:00+01:00,218,21,197,22.57742359713229,227,25,202,19.269071808142694,6,982,4.7,16
2020-12-04 19:00:00+01:00,158,15,143,21.67102174389251,159,15,144,17.78748005044877,6,982,4.7,16
2020-12-04 20:00:00+01:00,160,14,146,19.89239402952506,159,13,146,17.78748005044877,6,982,4.7,16
2020-12-04 21:00:00+01:00,123,11,112,19.074654696202938,123,12,111,19.074654696202938,6,982,4.7,16
2020-12-04 22:00:00+01:00,86,8,78,21.204994436842384,85,7,78,19.289671453475872,6,982,4.7,16
2020-12-04 23:00:00+01:00,61,6,55,12.362973378192347,58,5,53,10.505136369992313,6,982,4.7,16
2020-12-05 00:00:00+01:00,37,2,35,3.5125252112896685,39,2,37,6.913338666308079,5,988,0.8,17
2020-12-05 01:00:00+01:00,24,1,23,0.16633697306049489,26,1,25,0.13434729751860394,5,988,0.8,17
2020-12-05 02:00:00+01:00,25,1,24,0.10677168789919293,26,1,25,0.13434729751860394,5,988,0.8,17
2020-12-05 03:00:00+01:00,38,2,36,5.960450042509954,39,2,37,6.913338666308079,5,988,0.8,17
2020-12-05 04:00:00+01:00,48,3,45,9.964553643509852,52,2,50,14.472017643602554,5,988,0.8,17
2020-12-05 05:00:00+01:00,62,4,58,14.019247608895405,65,4,61,10.13470849860639,5,988,0.8,17
2020-12-05 06:00:00+01:00,101,6,95,14.022694861996197,105,6,99,16.343560716114418,5,988,0.8,17
2020-12-05 07:00:00+01:00,147,9,138,16.306492316544293,159,10,149,19.89258263570152,5,988,0.8,17
2020-12-05 08:00:00+01:00,206,11,195,20.90053052788098,208,12,196,18.807092053665322,5,988,0.8,17
2020-12-05 09:00:00+01:00,213,14,199,20.238518600536185,223,14,209,18.802339292525456,5,988,0.8,17
2020-12-05 10:00:00+01:00,187,12,175,15.611538170802525,198,12,186,20.173795644408123,5,988,0.8,17
2020-12-05 11:00:00+01:00,152,10,142,18.686880121910534,155,8,147,18.708796369633056,5,988,0.8,17
2020-12-05 12:00:00+01:00,145,8,137,19.922746131926434,158,8,150,19.40470350916573,5,988,0.8,17
2020-12-05 13:00:00+01:00,167,9,158,19.047083059371815,172,10,162,18.863206387348974,5,988,0.8,17
2020-12-05 14:00:00+01:00,154,8,146,19.868163821621103,155,8,147,18.708796369633056,5,988,0.8,17
2020-12-05 15:00:00+01:00,169,9,160,20.526675282456768,185,10,175,20.88033942284811,5,988,0.8,17
2020-12-05 16:00:00+01:00,172,10,162,18.863206387348974,186,9,177,20.400698976924794,5,988,0.8,17
2020-12-05 17:00:00+01:00,199,12,187,19.11274068140836,209,10,199,16.60419034744366,5,988,0.8,17
2020-12-05 18:00:00+01:00,190,11,179,20.182913119811044,197,10,187,19.118279085736297,5,988,0.8,17
2020-12-05 19:00:00+01:00,146,9,137,19.4340926707284,157,8,149,19.700921436065542,5,988,0.8,17
2020-12-05 20:00:00+01:00,142,8,134,19.57947604189084,146,8,138,19.4340926707284,5,988,0.8,17
2020-12-05 21:00:00+01:00,124,7,117,14.467255533674502,129,7,122,12.81298343964759,5,988,0.8,17
2020-12-05 22:00:00+01:00,100,6,94,12.129363492765288,105,7,98,16.343560716114418,5,988,0.8,17
2020-12-05 23:00:00+01:00,49,3,46,12.126419816698254,52,2,50,14.472017643602554,5,988,0.8,17
2020-12-06 00:00:00+01:00,21,0,21,0.0727095127790566,25,0,25,0.10677168789919293,5,995,1.6,15
2020-12-06 01:00:00+01:00,14,0,14,0.0,18,0,18,0.014449312499738909,5,995,1.6,15
2020-12-06 02:00:00+01:00,13,0,13,0.0,18,0,18,0.014449312499738909,5,995,1.6,15
2020-12-06 03:00:00+01:00,20,0,20,0.04910283862897408,25,0,25,0.10677168789919293,5,995,1.6,15
2020-12-06 04:00:00+01:00,29,1,28,0.5419439371488394,36,1,35,2.727177547566476,5,995,1.6,15
2020-12-06 05:00:00+01:00,36,1,35,2.727177547566476,48,1,47,9.964553643509852,5,995,1.6,15
2020-12-06 06:00:00+01:00,57,2,55,11.247345675463038,74,3,71,9.886934519670994,5,995,1.6,15
2020-12-06 07:00:00+01:00,87,3,84,9.504121716770046,119,3,116,9.275729661817119,5,995,1.6,15
2020-12-06 08:00:00+01:00,110,4,106,20.964248322238312,128,4,124,16.268122259148125,5,995,1.6,15
2020-12-06 09:00:00+01:00,118,4,114,16.65435568776215,166,6,160,16.094287115128708,5,995,1.6,15
2020-12-06 10:00:00+01:00,106,4,102,19.560878716092326,149,5,144,17.937448228249327,5,995,1.6,15
2020-12-06 11:00:00+01:00,82,3,79,8.6962433625344,98,3,95,9.366341704429512,5,995,1.6,15
2020-12-06 12:00:00+01:00,86,3,83,9.565861223121674,119,3,116,9.275729661817119,5,995,1.6,15
2020-12-06 13:00:00+01:00,89,3,86,10.527801976587284,98,4,94,9.366341704429512,5,995,1.6,15
2020-12-06 14:00:00+01:00,86,3,83,9.565861223121674,119,3,116,9.275729661817119,5,995,1.6,15
2020-12-06 15:00:00+01:00,96,4,92,10.792244903732447,127,4,123,18.022773693841014,5,995,1.6,15
2020-12-06 16:00:00+01:00,97,4,93,12.91170780960746,118,4,114,16.65435568776215,5,995,1.6,15
2020-12-06 17:00:00+01:00,117,4,113,13.539944397802945,135,5,130,20.27811899595658,5,995,1.6,15
2020-12-06 18:00:00+01:00,109,4,105,18.214376818550008,139,5,134,19.408576933840735,5,995,1.6,15
2020-12-06 19:00:00+01:00,89,3,86,10.527801976587284,90,3,87,10.477669283936715,5,995,1.6,15
2020-12-06 20:00:00+01:00,74,3,71,9.886934519670994,107,4,103,12.742346635562697,5,995,1.6,15
2020-12-06 21:00:00+01:00,73,2,71,10.015349835153332,86,3,83,9.565861223121674,5,995,1.6,15
2020-12-06 22:00:00+01:00,59,2,57,11.512224289105106,74,3,71,9.886934519670994,5,995,1.6,15
2020-12-06 23:00:00+01:00,29,1,28,0.5419439371488394,36,1,35,2.727177547566476,5,995,1.6,15
2020-12-07 00:00:00+01:00,46,4,42,9.245167395738047,46,4,42,9.245167395738047,5,1000,0.5,8
2020-12-07 01:00:00+01:00,31,2,29,5.505836547947686,31,3,28,5.505836547947686,5,1000,0.5,8
2020-12-07 02:00:00+01:00,31,3,28,5.505836547947686,31,3,28,5.505836547947686,5,1000,0.5,8
2020-12-07 03:00:00+01:00,46,4,42,9.245167395738047,46,4,42,9.245167395738047,5,1000,0.5,8
2020-12-07 04:00:00+01:00,77,7,70,16.632320143368542,77,9,68,16.632320143368542,5,1000,0.5,8
2020-12-07 05:00:00+01:00,141,14,127,21.00935462418931,140,15,125,15.331768592489755,5,1000,0.5,8
2020-12-07 06:00:00+01:00,159,16,143,17.78748005044877,167,15,152,21.39117903937357,5,1000,0.5,8
2020-12-07 07:00:00+01:00,259,25,234,22.988395045636892,256,26,230,20.451990100158973,5,1000,0.5,8
2020-12-07 08:00:00+01:00,280,25,255,25.91177046818179,276,33,243,21.646913060128323,5,1000,0.5,8
2020-12-07 09:00:00+01:00,179,17,162,19.18236787964663,186,22,164,22.772295906033783,5,1000,0.5,8
2020-12-07 10:00:00+01:00,144,13,131,22.91915418498221,150,18,132,17.939622434692456,5,1000,0.5,8
2020-12-07 11:00:00+01:00,187,16,171,20.5323189366488,180,17,163,20.970253971133605,5,1000,0.5,8
2020-12-07 12:00:00+01:00,156,16,140,23.175119746499636,150,18,132,17.939622434692456,5,1000,0.5,8
2020-12-07 13:00:00+01:00,156,14,142,23.175119746499636,150,18,132,17.939622434692456,5,1000,0.5,8
2020-12-07 14:00:00+01:00,156,14,142,23.175119746499636,150,18,132,17.939622434692456,5,1000,0.5,8
2020-12-07 15:00:00+01:00,172,15,157,19.644113972447897,168,20,148,20.304807772345505,5,1000,0.5,8
2020-12-07 16:00:00+01:00,183,18,165,16.4856647978058,180,17,163,20.970253971133605,5,1000,0.5,8
2020-12-07 17:00:00+01:00,265,27,238,24.143057918667047,258,27,231,21.93153719781745,5,1000,0.5,8
2020-12-07 18:00:00+01:00,264,25,239,20.665980174270672,274,27,247,20.56786912693606,5,1000,0.5,8
2020-12-07 19:00:00+01:00,199,21,178,21.764655927821806,202,19,183,22.500350864850866,5,1000,0.5,8
2020-12-07 20:00:00+01:00,189,18,171,18.951286202533417,197,20,177,19.020846849172088,5,1000,0.5,8
2020-12-07 21:00:00+01:00,156,14,142,23.175119746499636,150,18,132,17.939622434692456,5,1000,0.5,8
2020-12-07 22:00:00+01:00,110,9,101,16.975871844207738,104,11,93,11.935148455597123,5,1000,0.5,8
2020-12-07 23:00:00+01:00,77,8,69,16.632320143368542,77,9,68,16.632320143368542,5,1000,0.5,8
2020-12-08 00:00:00+01:00,46,4,42,9.245167395738047,51,4,47,7.252205043556333,3,999,0.0,10
2020-12-08 01:00:00+01:00,29,2,27,3.1672610972900266,32,3,29,5.041092888653022,3,999,0.0,10
2020-12-08 02:00:00+01:00,30,2,28,3.420694029650136,33,3,30,5.985660510090718,3,999,0.0,10
2020-12-08 03:00:00+01:00,46,3,43,9.245167395738047,51,4,47,7.252205043556333,3,999,0.0,10
2020-12-08 04:00:00+01:00,74,6,68,19.513800836509724,87,8,79,17.896548892855574,3,999,0.0,10
2020-12-08 05:00:00+01:00,136,11,125,16.594078125250377,154,15,139,23.457384968254527,3,999,0.0,10
2020-12-08 06:00:00+01:00,161,15,146,19.983041252146048,176,15,161,20.324791671108635,3,999,0.0,10
2020-12-08 07:00:00+01:00,260,25,235,21.14564444182058,282,30,252,14.328617212432716,3,999,0.0,10
2020-12-08 08:00:00+01:00,278,27,251,17.988889489265482,299,28,271,15.06368464327721,3,999,0.0,10
2020-12-08 09:00:00+01:00,174,15,159,14.257286675630954,203,22,181,24.82410288636225,3,999,0.0,10
2020-12-08 10:00:00+01:00,147,13,134,20.208056467665056,173,14,159,20.37647841384157,3,999,0.0,10
2020-12-08 11:00:00+01:00,185,18,167,20.160625004949942,197,17,180,19.020846849172088,3,999,0.0,10
2020-12-08 12:00:00+01:00,156,13,143,23.175119746499636,163,18,145,20.41127666656249,3,999,0.0,10
2020-12-08 13:00:00+01:00,143,12,131,22.510370466296816,164,18,146,22.827361263214527,3,999,0.0,10
2020-12-08 14:00:00+01:00,165,13,152,20.56038540292619,168,18,150,20.304807772345505,3,999,0.0,10
2020-12-08 15:00:00+01:00,168,15,153,20.304807772345505,186,18,168,22.772295906033783,3,999,0.0,10
2020-12-08 16:00:00+01:00,196,16,180,20.04912381427717,208,18,190,17.851758798784658,3,999,0.0,10
2020-12-08 17:00:00+01:00,262,21,241,18.255168653975332,298,33,265,18.335119688608,3,999,0.0,10
2020-12-08 18:00:00+01:00,267,22,245,13.385499595100717,305,28,277,19.342371998402466,3,999,0.0,10
2020-12-08 19:00:00+01:00,194,16,178,21.593451125557873,226,20,206,20.308697708911414,3,999,0.0,10
2020-12-08 20:00:00+01:00,190,16,174,20.51689583562818,217,20,197,21.833662628048735,3,999,0.0,10
2020-12-08 21:00:00+01:00,146,13,133,20.98788244482569,173,14,159,20.37647841384157,3,999,0.0,10
2020-12-08 22:00:00+01:00,107,10,97,12.156196464705383,115,13,102,27.52702584121565,3,999,0.0,10
2020-12-08 23:00:00+01:00,74,7,67,19.513800836509724,87,8,79,17.896548892855574,3,999,0.0,10
2020-12-09 00:00:00+01:00,74,8,66,17.73542510561878,76,8,68,20.954075500954353,4,1009,0.0,4
2020-12-09 01:00:00+01:00,50,6,44,9.782450713793494,46,4,42,7.79278142701588,4,1009,0.0,4
2020-12-09 02:00:00+01:00,50,6,44,9.782450713793494,46,4,42,7.79278142701588,4,1009,0.0,4
2020-12-09 03:00:00+01:00,76,9,67,20.954075500954353,68,7,61,9.896589042271222,4,1009,0.0,4
2020-12-09 04:00:00+01:00,124,15,109,21.01321111404538,122,13,109,17.130676940975697,4,1009,0.0,4
2020-12-09 05:00:00+01:00,228,28,200,11.999655172013497,212,20,192,22.10484701208199,4,1009,0.0,4
2020-12-09 06:00:00+01:00,278,32,246,21.643694281450568,268,26,242,19.54671273578713,4,1009,0.0,4
2020-12-09 07:00:00+01:00,434,58,376,20.9227488499813,396,38,358,22.018658697036606,4,1009,0.0,4
2020-12-09 08:00:00+01:00,452,52,400,20.80640156505403,416,46,370,18.869548080226345,4,1009,0.0,4
2020-12-09 09:00:00+01:00,300,41,259,17.719869170359154,294,32,262,24.118136039782872,4,1009,0.0,4
2020-12-09 10:00:00+01:00,252,29,223,19.64962099491398,226,21,205,20.105295377891462,4,1009,0.0,4
2020-12-09 11:00:00+01:00,304,41,263,23.926436101503658,276,26,250,17.34974806433115,4,1009,0.0,4
2020-12-09 12:00:00+01:00,252,29,223,19.64962099491398,226,21,205,20.105295377891462,4,1009,0.0,4
2020-12-09 13:00:00+01:00,254,34,220,25.080256727773573,252,26,226,19.64962099491398,4,1009,0.0,4
2020-12-09 14:00:00+01:00,250,28,222,16.748276094261186,236,26,210,11.423053117408324,4,1009,0.0,4
2020-12-09 15:00:00+01:00,278,32,246,21.643694281450568,268,26,242,19.54671273578713,4,1009,0.0,4
2020-12-09 16:00:00+01:00,306,41,265,26.454632237997544,294,35,259,24.118136039782872,4,1009,0.0,4
2020-12-09 17:00:00+01:00,430,51,379,22.816352618482806,410,51,359,11.55444972100336,4,1009,0.0,4
2020-12-09 18:00:00+01:00,462,53,409,21.602707594400176,462,46,416,21.602707594400176,4,1009,0.0,4
2020-12-09 19:00:00+01:00,334,39,295,20.287002205644253,332,42,290,19.089795695646295,4,1009,0.0,4
2020-12-09 20:00:00+01:00,334,45,289,20.287002205644253,332,42,290,19.089795695646295,4,1009,0.0,4
2020-12-09 21:00:00+01:00,256,35,221,24.12744449994244,250,26,224,16.748276094261186,4,1009,0.0,4
2020-12-09 22:00:00+01:00,176,22,154,20.032450650587887,162,16,146,16.65184232996673,4,1009,0.0,4
2020-12-09 23:00:00+01:00,126,16,110,16.250667590352332,122,13,109,17.130676940975697,4,1009,0.0,4
2020-12-10 00:00:00+01:00,42,3,39,5.988628884327601,45,6,39,8.16653528554085,5,1007,0.0,13
2020-12-10 01:00:00+01:00,27,2,25,1.9016023008994223,28,3,25,4.026144260024548,5,1007,0.0,13
2020-12-10 02:00:00+01:00,25,2,23,1.1875344360364632,30,4,26,3.420694029650136,5,1007,0.0,13
2020-12-10 03:00:00+01:00,42,3,39,5.988628884327601,45,6,39,8.16653528554085,5,1007,0.0,13
2020-12-10 04:00:00+01:00,69,5,64,19.29595730158091,71,10,61,15.50461576454985,5,1007,0.0,13
2020-12-10 05:00:00+01:00,126,11,115,21.990298593101397,127,19,108,19.116953333289125,5,1007,0.0,13
2020-12-10 06:00:00+01:00,167,12,155,21.39117903937357,163,22,141,20.41127666656249,5,1007,0.0,13
2020-12-10 07:00:00+01:00,221,17,204,20.34114880306217,251,30,221,19.570183352800104,5,1007,0.0,13
2020-12-10 08:00:00+01:00,248,21,227,17.312704307039937,266,40,226,24.416240816629376,5,1007,0.0,13
2020-12-10 09:00:00+01:00,163,13,150,20.41127666656249,168,21,147,20.304807772345505,5,1007,0.0,13
2020-12-10 10:00:00+01:00,138,11,127,20.21600799483387,140,20,120,15.331768592489755,5,1007,0.0,13
2020-12-10 11:00:00+01:00,156,13,143,23.175119746499636,170,27,143,19.775542485132945,5,1007,0.0,13
2020-12-10 12:00:00+01:00,146,11,135,20.98788244482569,152,18,134,20.188330220444417,5,1007,0.0,13
2020-12-10 13:00:00+01:00,139,10,129,18.732486269107348,140,20,120,15.331768592489755,5,1007,0.0,13
2020-12-10 14:00:00+01:00,131,11,120,14.183230975852695,148,18,130,18.058884943386857,5,1007,0.0,13
2020-12-10 15:00:00+01:00,169,14,155,18.567569965901342,164,26,138,22.827361263214527,5,1007,0.0,13
2020-12-10 16:00:00+01:00,180,13,167,20.970253971133605,183,28,155,16.4856647978058,5,1007,0.0,13
2020-12-10 17:00:00+01:00,225,17,208,17.07968654570721,256,32,224,20.451990100158973,5,1007,0.0,13
2020-12-10 18:00:00+01:00,279,23,256,23.809963875172556,269,43,226,17.49919499982951,5,1007,0.0,13
2020-12-10 19:00:00+01:00,178,13,165,19.804789777436813,190,23,167,20.51689583562818,5,1007,0.0,13
2020-12-10 20:00:00+01:00,197,15,182,19.020846849172088,198,25,173,18.14522738171017,5,1007,0.0,13
2020-12-10 21:00:00+01:00,152,12,140,20.188330220444417,149,19,130,20.003285796587473,5,1007,0.0,13
2020-12-10 22:00:00+01:00,99,7,92,10.779955578794215,102,15,87,13.093305626972347,5,1007,0.0,13
2020-12-10 23:00:00+01:00,71,5,66,15.50461576454985,74,11,63,19.513800836509724,5,1007,0.0,13
2020-12-11 00:00:00+01:00,76,7,69,16.686685835236233,72,8,64,19.53768091870668,9,1000,0.0,9
2020-12-11 01:00:00+01:00,50,4,46,13.688855833793909,50,4,46,13.688855833793909,9,1000,0.0,9
2020-12-11 02:00:00+01:00,50,4,46,13.688855833793909,50,4,46,13.688855833793909,9,1000,0.0,9
2020-12-11 03:00:00+01:00,76,7,69,16.686685835236233,72,8,64,19.53768091870668,9,1000,0.0,9
2020-12-11 04:00:00+01:00,127,11,116,19.116953333289125,117,11,106,21.891304075969387,9,1000,0.0,9
2020-12-11 05:00:00+01:00,232,23,209,14.357520231191923,228,20,208,15.818609956751573,9,1000,0.0,9
2020-12-11 06:00:00+01:00,268,25,243,16.114987230113258,270,24,246,23.920073269237992,9,1000,0.0,9
2020-12-11 07:00:00+01:00,429,39,390,21.355504409446556,413,36,377,24.398754434847095,9,1000,0.0,9
2020-12-11 08:00:00+01:00,464,48,416,21.884111394069308,433,37,396,15.756615810687446,9,1000,0.0,9
2020-12-11 09:00:00+01:00,294,28,266,18.98421464015195,300,29,271,19.621479548992166,9,1000,0.0,9
2020-12-11 10:00:00+01:00,244,24,220,17.108671526861457,246,24,222,17.57126233227549,9,1000,0.0,9
2020-12-11 11:00:00+01:00,298,31,267,18.335119688608,288,25,263,22.858888837585067,9,1000,0.0,9
2020-12-11 12:00:00+01:00,256,23,233,20.451990100158973,254,22,232,21.33413531955627,9,1000,0.0,9
2020-12-11 13:00:00+01:00,250,27,223,14.642007731534619,246,26,220,17.57126233227549,9,1000,0.0,9
2020-12-11 14:00:00+01:00,248,25,223,17.312704307039937,246,26,220,17.57126233227549,9,1000,0.0,9
2020-12-11 15:00:00+01:00,272,28,244,23.2664106640069,274,31,243,20.56786912693606,9,1000,0.0,9
2020-12-11 16:00:00+01:00,300,32,268,19.621479548992166,284,28,256,21.60666647068217,9,1000,0.0,9
2020-12-11 17:00:00+01:00,423,38,385,23.290663678046883,427,48,379,18.502781357559265,9,1000,0.0,9
2020-12-11 18:00:00+01:00,444,48,396,14.679521920211366,435,44,391,21.80027200191571,9,1000,0.0,9
2020-12-11 19:00:00+01:00,320,32,288,21.04137400974582,335,36,299,21.419812345615075,9,1000,0.0,9
2020-12-11 20:00:00+01:00,316,32,284,20.52457281115525,316,28,288,20.52457281115525,9,1000,0.0,9
2020-12-11 21:00:00+01:00,248,23,225,17.312704307039937,246,26,220,17.57126233227549,9,1000,0.0,9
2020-12-11 22:00:00+01:00,173,18,155,20.37647841384157,175,19,156,17.666202741429842,9,1000,0.0,9
2020-12-11 23:00:00+01:00,129,12,117,17.995114557081255,123,10,113,19.074654696202938,9,1000,0.0,9
2020-12-12 00:00:00+01:00,59,3,56,11.512224289105106,62,3,59,14.019247608895405,8,993,0.3,9
2020-12-12 01:00:00+01:00,40,2,38,6.907029621336792,41,2,39,7.51149883575918,8,993,0.3,9
2020-12-12 02:00:00+01:00,40,2,38,6.907029621336792,41,2,39,7.51149883575918,8,993,0.3,9
2020-12-12 03:00:00+01:00,59,3,56,11.512224289105106,62,3,59,14.019247608895405,8,993,0.3,9
2020-12-12 04:00:00+01:00,80,5,75,12.9514806028411,83,5,78,9.333357558089729,8,993,0.3,9
2020-12-12 05:00:00+01:00,97,5,92,12.91170780960746,104,6,98,18.50502851366146,8,993,0.3,9
2020-12-12 06:00:00+01:00,154,9,145,19.868163821621103,165,8,157,20.19240679449499,8,993,0.3,9
2020-12-12 07:00:00+01:00,244,14,230,18.556057346091794,252,14,238,19.00138202247206,8,993,0.3,9
2020-12-12 08:00:00+01:00,316,20,296,17.068110656006358,338,21,317,21.621773010719025,8,993,0.3,9
2020-12-12 09:00:00+01:00,340,23,317,14.37984208663957,353,21,332,19.24169978578992,8,993,0.3,9
2020-12-12 10:00:00+01:00,301,20,281,20.607812327110423,314,17,297,19.77016372636934,8,993,0.3,9
2020-12-12 11:00:00+01:00,245,16,229,17.30944248589229,253,16,237,17.73107046839405,8,993,0.3,9
2020-12-12 12:00:00+01:00,244,16,228,18.556057346091794,252,14,238,19.00138202247206,8,993,0.3,9
2020-12-12 13:00:00+01:00,256,16,240,19.922633354103812,274,17,257,20.52791870989968,8,993,0.3,9
2020-12-12 14:00:00+01:00,237,14,223,17.058494417352218,248,13,235,17.022549227170337,8,993,0.3,9
2020-12-12 15:00:00+01:00,281,16,265,18.053311879599764,289,18,271,18.938144972747136,8,993,0.3,9
2020-12-12 16:00:00+01:00,274,15,259,20.52791870989968,293,15,278,17.329297501722674,8,993,0.3,9
2020-12-12 17:00:00+01:00,314,18,296,19.77016372636934,340,22,318,14.37984208663957,8,993,0.3,9
2020-12-12 18:00:00+01:00,292,18,274,17.87884891495493,311,16,295,18.777054340822975,8,993,0.3,9
2020-12-12 19:00:00+01:00,234,14,220,18.523045519331724,250,14,236,19.251014174910523,8,993,0.3,9
2020-12-12 20:00:00+01:00,215,12,203,14.020699077914754,229,11,218,20.858973540615885,8,993,0.3,9
2020-12-12 21:00:00+01:00,199,13,186,19.11274068140836,208,10,198,18.807092053665322,8,993,0.3,9
2020-12-12 22:00:00+01:00,160,10,150,18.858823274894117,167,9,158,19.047083059371815,8,993,0.3,9
2020-12-12 23:00:00+01:00,81,5,76,13.380409900215524,83,4,79,9.333357558089729,8,993,0.3,9
2020-12-13 00:00:00+01:00,28,1,27,0.9732919408254891,39,1,38,6.913338666308079,6,1009,0.0,12
2020-12-13 01:00:00+01:00,18,0,18,0.014449312499738909,22,0,22,0.10978017057340601,6,1009,0.0,12
2020-12-13 02:00:00+01:00,19,0,19,0.02626420314498215,22,0,22,0.10978017057340601,6,1009,0.0,12
2020-12-13 03:00:00+01:00,31,1,30,0.3699528216625179,36,1,35,2.727177547566476,6,1009,0.0,12
2020-12-13 04:00:00+01:00,40,1,39,6.907029621336792,50,1,49,13.833131991765365,6,1009,0.0,12
2020-12-13 05:00:00+01:00,50,1,49,13.833131991765365,66,2,64,9.595877216947136,6,1009,0.0,12
2020-12-13 06:00:00+01:00,74,2,72,9.886934519670994,108,4,104,15.795702759121413,6,1009,0.0,12
2020-12-13 07:00:00+01:00,115,5,110,14.522258078721798,165,6,159,20.19240679449499,6,1009,0.0,12
2020-12-13 08:00:00+01:00,163,6,157,16.305265165047643,172,6,166,18.863206387348974,6,1009,0.0,12
2020-12-13 09:00:00+01:00,177,6,171,13.959346220493531,190,6,184,20.182913119811044,6,1009,0.0,12
2020-12-13 10:00:00+01:00,150,5,145,19.93003466929675,174,5,169,17.20816352324012,6,1009,0.0,12
2020-12-13 11:00:00+01:00,117,4,113,13.539944397802945,142,5,137,19.57947604189084,6,1009,0.0,12
2020-12-13 12:00:00+01:00,125,5,120,11.899638158178501,141,6,135,17.007652233540448,6,1009,0.0,12
2020-12-13 13:00:00+01:00,135,5,130,20.27811899595658,173,6,167,18.22292561400028,6,1009,0.0,12
2020-12-13 14:00:00+01:00,117,4,113,13.539944397802945,142,5,137,19.57947604189084,6,1009,0.0,12
2020-12-13 15:00:00+01:00,145,5,140,19.922746131926434,182,6,176,16.329362148305133,6,1009,0.0,12
2020-12-13 16:00:00+01:00,135,5,130,20.27811899595658,187,7,180,15.611538170802525,6,1009,0.0,12
2020-12-13 17:00:00+01:00,163,6,157,16.305265165047643,172,6,166,18.863206387348974,6,1009,0.0,12
2020-12-13 18:00:00+01:00,156,5,151,17.899214712227696,179,7,172,21.74229179161351,6,1009,0.0,12
2020-12-13 19:00:00+01:00,115,4,111,14.522258078721798,165,6,159,20.19240679449499,6,1009,0.0,12
2020-12-13 20:00:00+01:00,111,4,107,16.60196152330297,143,5,138,15.49985590484046,6,1009,0.0,12
2020-12-13 21:00:00+01:00,104,4,100,18.50502851366146,100,3,97,12.129363492765288,6,1009,0.0,12
2020-12-13 22:00:00+01:00,80,3,77,12.9514806028411,105,4,101,16.343560716114418,6,1009,0.0,12
2020-12-13 23:00:00+01:00,38,1,37,5.960450042509954,53,2,51,12.671576687621188,6,1009,0.0,12
2020-12-14 00:00:00+01:00,36,3,33,3.0873599992209124,40,3,37,5.275608835029151,9,1008,0.0,19
2020-12-14 01:00:00+01:00,26,2,24,1.5382661455122164,26,2,24,1.5382661455122164,9,1008,0.0,19
2020-12-14 02:00:00+01:00,24,2,22,1.5004308879154395,26,2,24,1.5382661455122164,9,1008,0.0,19
2020-12-14 03:00:00+01:00,37,3,34,2.066086063070793,40,4,36,5.275608835029151,9,1008,0.0,19
2020-12-14 04:00:00+01:00,67,6,61,12.5039951599288,67,7,60,12.5039951599288,9,1008,0.0,19
2020-12-14 05:00:00+01:00,121,12,109,20.317620945183666,121,11,110,20.317620945183666,9,1008,0.0,19
2020-12-14 06:00:00+01:00,136,13,123,16.594078125250377,145,16,129,18.85528596371164,9,1008,0.0,19
2020-12-14 07:00:00+01:00,231,22,209,16.702836426900134,225,22,203,17.07968654570721,9,1008,0.0,19
2020-12-14 08:00:00+01:00,239,22,217,13.74553452780325,241,30,211,21.076687701702674,9,1008,0.0,19
2020-12-14 09:00:00+01:00,155,15,140,19.469409355748308,154,19,135,23.457384968254527,9,1008,0.0,19
2020-12-14 10:00:00+01:00,126,13,113,21.990298593101397,128,15,113,19.601953989978306,9,1008,0.0,19
2020-12-14 11:00:00+01:00,155,14,141,19.469409355748308,154,19,135,23.457384968254527,9,1008,0.0,19
2020-12-14 12:00:00+01:00,126,13,113,21.990298593101397,128,15,113,19.601953989978306,9,1008,0.0,19
2020-12-14 13:00:00+01:00,130,11,119,15.65660051079879,131,12,119,14.183230975852695,9,1008,0.0,19
2020-12-14 14:00:00+01:00,130,11,119,15.65660051079879,131,12,119,14.183230975852695,9,1008,0.0,19
2020-12-14 15:00:00+01:00,143,13,130,22.510370466296816,142,17,125,21.623487252479663,9,1008,0.0,19
2020-12-14 16:00:00+01:00,163,16,147,20.41127666656249,153,15,138,14.915022999208679,9,1008,0.0,19
2020-12-14 17:00:00+01:00,222,20,202,18.77573498601868,217,24,193,21.833662628048735,9,1008,0.0,19
2020-12-14 18:00:00+01:00,226,22,204,20.308697708911414,231,25,206,16.702836426900134,9,1008,0.0,19
2020-12-14 19:00:00+01:00,172,16,156,19.644113972447897,171,21,150,22.137070929890193,9,1008,0.0,19
2020-12-14 20:00:00+01:00,166,15,151,18.57114730689396,174,20,154,14.257286675630954,9,1008,0.0,19
2020-12-14 21:00:00+01:00,131,14,117,14.183230975852695,131,12,119,14.183230975852695,9,1008,0.0,19
2020-12-14 22:00:00+01:00,91,8,83,13.154481673544206,91,8,83,13.154481673544206,9,1008,0.0,19
2020-12-14 23:00:00+01:00,64,5,59,14.414592943793718,67,7,60,12.5039951599288,9,1008,0.0,19
2020-12-15 00:00:00+01:00,38,3,35,11.101073107969722,40,4,36,5.275608835029151,11,1006,5.2,14
2020-12-15 01:00:00+01:00,25,2,23,1.1875344360364632,27,2,25,1.9016023008994223,11,1006,5.2,14
2020-12-15 02:00:00+01:00,25,2,23,1.1875344360364632,27,2,25,1.9016023008994223,11,1006,5.2,14
2020-12-15 03:00:00+01:00,38,3,35,11.101073107969722,40,4,36,5.275608835029151,11,1006,5.2,14
2020-12-15 04:00:00+01:00,62,5,57,14.48690450543278,62,5,57,14.48690450543278,11,1006,5.2,14
2020-12-15 05:00:00+01:00,101,8,93,11.280950715811313,121,12,109,20.317620945183666,11,1006,5.2,14
2020-12-15 06:00:00+01:00,138,11,127,20.21600799483387,138,14,124,20.21600799483387,11,1006,5.2,14
2020-12-15 07:00:00+01:00,192,17,175,21.295822766447603,225,21,204,17.07968654570721,11,1006,5.2,14
2020-12-15 08:00:00+01:00,218,18,200,22.57742359713229,242,27,215,20.990360069331732,11,1006,5.2,14
2020-12-15 09:00:00+01:00,142,13,129,21.623487252479663,164,16,148,22.827361263214527,11,1006,5.2,14
2020-12-15 10:00:00+01:00,129,10,119,17.995114557081255,131,11,120,14.183230975852695,11,1006,5.2,14
2020-12-15 11:00:00+01:00,142,11,131,21.623487252479663,164,16,148,22.827361263214527,11,1006,5.2,14
2020-12-15 12:00:00+01:00,129,10,119,17.995114557081255,131,11,120,14.183230975852695,11,1006,5.2,14
2020-12-15 13:00:00+01:00,119,9,110,22.46945513312648,129,12,117,17.995114557081255,11,1006,5.2,14
2020-12-15 14:00:00+01:00,119,9,110,22.46945513312648,129,12,117,17.995114557081255,11,1006,5.2,14
2020-12-15 15:00:00+01:00,130,10,120,15.65660051079879,144,12,132,22.91915418498221,11,1006,5.2,14
2020-12-15 16:00:00+01:00,139,13,126,18.732486269107348,150,15,135,17.939622434692456,11,1006,5.2,14
2020-12-15 17:00:00+01:00,209,17,192,22.16757043059366,224,19,205,16.30248157536985,11,1006,5.2,14
2020-12-15 18:00:00+01:00,213,17,196,20.488166305452438,246,24,222,17.57126233227549,11,1006,5.2,14
2020-12-15 19:00:00+01:00,153,14,139,14.915022999208679,172,15,157,19.644113972447897,11,1006,5.2,14
2020-12-15 20:00:00+01:00,155,15,140,19.469409355748308,165,18,147,20.56038540292619,11,1006,5.2,14
2020-12-15 21:00:00+01:00,119,11,108,22.46945513312648,129,12,117,17.995114557081255,11,1006,5.2,14
2020-12-15 22:00:00+01:00,83,6,77,18.699193296190067,90,9,81,13.960700117154147,11,1006,5.2,14
2020-12-15 23:00:00+01:00,58,4,54,10.505136369992313,67,7,60,12.5039951599288,11,1006,5.2,14
2020-12-16 00:00:00+01:00,73,9,64,16.437112601261585,73,8,65,16.437112601261585,9,1015,0.0,10
2020-12-16 01:00:00+01:00,48,6,42,9.13890902221218,46,5,41,7.79278142701588,9,1015,0.0,10
2020-12-16 02:00:00+01:00,48,6,42,9.13890902221218,46,5,41,7.79278142701588,9,1015,0.0,10
2020-12-16 03:00:00+01:00,73,9,64,16.437112601261585,73,8,65,16.437112601261585,9,1015,0.0,10
2020-12-16 04:00:00+01:00,123,15,108,15.262138605096247,117,12,105,12.235552510813584,9,1015,0.0,10
2020-12-16 05:00:00+01:00,218,26,192,22.73300845004657,197,24,173,16.840472953316162,9,1015,0.0,10
2020-12-16 06:00:00+01:00,268,32,236,19.54671273578713,262,32,230,22.836816144401386,9,1015,0.0,10
2020-12-16 07:00:00+01:00,417,48,369,19.5232508211744,378,47,331,19.72856450330425,9,1015,0.0,10
2020-12-16 08:00:00+01:00,436,52,384,16.913107095696443,400,43,357,24.218092797619367,9,1015,0.0,10
2020-12-16 09:00:00+01:00,293,35,258,20.77933514509894,286,32,254,22.799042804335677,9,1015,0.0,10
2020-12-16 10:00:00+01:00,245,33,212,21.661045851911695,228,25,203,11.999655172013497,9,1015,0.0,10
2020-12-16 11:00:00+01:00,291,33,258,15.818920682290248,274,28,246,27.25802623834161,9,1015,0.0,10
2020-12-16 12:00:00+01:00,243,28,215,25.380099969640305,231,28,203,18.00711943545906,9,1015,0.0,10
2020-12-16 13:00:00+01:00,241,30,211,22.882071172466965,220,24,196,18.729640796362187,9,1015,0.0,10
2020-12-16 14:00:00+01:00,247,31,216,22.66625775717105,228,25,203,11.999655172013497,9,1015,0.0,10
2020-12-16 15:00:00+01:00,268,30,238,19.54671273578713,262,32,230,22.836816144401386,9,1015,0.0,10
2020-12-16 16:00:00+01:00,293,33,260,20.77933514509894,286,32,254,22.799042804335677,9,1015,0.0,10
2020-12-16 17:00:00+01:00,415,56,359,16.256703031864188,378,47,331,19.72856450330425,9,1015,0.0,10
2020-12-16 18:00:00+01:00,436,52,384,16.913107095696443,400,43,357,24.218092797619367,9,1015,0.0,10
2020-12-16 19:00:00+01:00,316,38,278,12.954823545566947,299,31,268,19.217825841133752,9,1015,0.0,10
2020-12-16 20:00:00+01:00,322,39,283,23.67757984571023,297,29,268,19.43137253304159,9,1015,0.0,10
2020-12-16 21:00:00+01:00,243,28,215,25.380099969640305,231,28,203,18.00711943545906,9,1015,0.0,10
2020-12-16 22:00:00+01:00,168,21,147,18.818575971293154,158,15,143,20.016713756826867,9,1015,0.0,10
2020-12-16 23:00:00+01:00,121,14,107,14.174023637152917,112,14,98,16.537505199847164,9,1015,0.0,10
2020-12-17 00:00:00+01:00,50,4,46,13.688855833793909,54,7,47,10.37826089518735,10,1014,0.0,16
2020-12-17 01:00:00+01:00,33,2,31,5.985660510090718,34,4,30,5.3950651883530085,10,1014,0.0,16
2020-12-17 02:00:00+01:00,33,2,31,5.985660510090718,34,4,30,5.3950651883530085,10,1014,0.0,16
2020-12-17 03:00:00+01:00,50,4,46,13.688855833793909,54,7,47,10.37826089518735,10,1014,0.0,16
2020-12-17 04:00:00+01:00,84,7,77,14.398269762880606,91,14,77,13.154481673544206,10,1014,0.0,16
2020-12-17 05:00:00+01:00,162,14,148,19.08849102929865,158,19,139,21.67102174389251,10,1014,0.0,16
2020-12-17 06:00:00+01:00,181,15,166,20.051163259817507,191,23,168,20.658016380524305,10,1014,0.0,16
2020-12-17 07:00:00+01:00,294,24,270,18.98421464015195,303,43,260,15.98015338859148,10,1014,0.0,16
2020-12-17 08:00:00+01:00,288,22,266,22.858888837585067,306,40,266,17.3472177808044,10,1014,0.0,16
2020-12-17 09:00:00+01:00,191,16,175,20.658016380524305,218,34,184,22.57742359713229,10,1014,0.0,16
2020-12-17 10:00:00+01:00,169,15,154,18.567569965901342,178,28,150,19.804789777436813,10,1014,0.0,16
2020-12-17 11:00:00+01:00,195,14,181,23.83440770251287,218,27,191,22.57742359713229,10,1014,0.0,16
2020-12-17 12:00:00+01:00,169,15,154,18.567569965901342,178,28,150,19.804789777436813,10,1014,0.0,16
2020-12-17 13:00:00+01:00,162,12,150,19.08849102929865,175,21,154,17.666202741429842,10,1014,0.0,16
2020-12-17 14:00:00+01:00,182,16,166,17.128604685093855,173,21,152,20.37647841384157,10,1014,0.0,16
2020-12-17 15:00:00+01:00,198,16,182,18.14522738171017,199,25,174,21.764655927821806,10,1014,0.0,16
2020-12-17 16:00:00+01:00,218,18,200,22.57742359713229,217,34,183,21.833662628048735,10,1014,0.0,16
2020-12-17 17:00:00+01:00,311,23,288,16.325599187415413,300,40,260,19.621479548992166,10,1014,0.0,16
2020-12-17 18:00:00+01:00,283,23,260,21.015453076893927,317,41,276,23.692514426518255,10,1014,0.0,16
2020-12-17 19:00:00+01:00,206,17,189,22.241507594869486,218,30,188,22.57742359713229,10,1014,0.0,16
2020-12-17 20:00:00+01:00,219,19,200,21.009686825041197,228,27,201,15.818609956751573,10,1014,0.0,16
2020-12-17 21:00:00+01:00,156,12,144,23.175119746499636,169,27,142,18.567569965901342,10,1014,0.0,16
2020-12-17 22:00:00+01:00,126,10,116,21.990298593101397,117,17,100,21.891304075969387,10,1014,0.0,16
2020-12-17 23:00:00+01:00,89,7,82,17.562315027840828,87,10,77,17.896548892855574,10,1014,0.0,16
2020-12-18 00:00:00+01:00,64,5,59,14.414592943793718,66,7,59,13.86002207659952,9,1023,0.0,12
2020-12-18 01:00:00+01:00,43,4,39,8.573704494863009,43,4,39,8.573704494863009,9,1023,0.0,12
2020-12-18 02:00:00+01:00,43,4,39,8.573704494863009,43,4,39,8.573704494863009,9,1023,0.0,12
2020-12-18 03:00:00+01:00,64,6,58,14.414592943793718,66,7,59,13.86002207659952,9,1023,0.0,12
2020-12-18 04:00:00+01:00,111,11,100,12.909820125967427,100,9,91,11.502705756568044,9,1023,0.0,12
2020-12-18 05:00:00+01:00,196,20,176,20.04912381427717,198,17,181,18.14522738171017,9,1023,0.0,12
2020-12-18 06:00:00+01:00,240,22,218,16.023164601360044,234,23,211,19.754580108435302,9,1023,0.0,12
2020-12-18 07:00:00+01:00,360,35,325,23.455775768432638,362,41,321,18.208767664177746,9,1023,0.0,12
2020-12-18 08:00:00+01:00,402,43,359,17.230856788696144,382,40,342,19.255057171585772,9,1023,0.0,12
2020-12-18 09:00:00+01:00,254,27,227,21.33413531955627,257,29,228,24.369710124951805,9,1023,0.0,12
2020-12-18 10:00:00+01:00,217,20,197,21.833662628048735,207,20,187,21.877297854955202,9,1023,0.0,12
2020-12-18 11:00:00+01:00,254,24,230,21.33413531955627,257,29,228,24.369710124951805,9,1023,0.0,12
2020-12-18 12:00:00+01:00,217,20,197,21.833662628048735,207,20,187,21.877297854955202,9,1023,0.0,12
2020-12-18 13:00:00+01:00,212,20,192,18.597605283865732,222,22,200,18.77573498601868,9,1023,0.0,12
2020-12-18 14:00:00+01:00,208,21,187,17.851758798784658,215,18,197,23.830284677030114,9,1023,0.0,12
2020-12-18 15:00:00+01:00,240,25,215,16.023164601360044,234,23,211,19.754580108435302,9,1023,0.0,12
2020-12-18 16:00:00+01:00,254,25,229,21.33413531955627,257,29,228,24.369710124951805,9,1023,0.0,12
2020-12-18 17:00:00+01:00,370,34,336,20.548579550699223,356,33,323,20.092398613710877,9,1023,0.0,12
2020-12-18 18:00:00+01:00,386,37,349,18.304254687443294,402,38,364,17.230856788696144,9,1023,0.0,12
2020-12-18 19:00:00+01:00,278,29,249,17.988889489265482,273,26,247,23.61851837889036,9,1023,0.0,12
2020-12-18 20:00:00+01:00,283,25,258,21.015453076893927,278,25,253,17.988889489265482,9,1023,0.0,12
2020-12-18 21:00:00+01:00,214,20,194,18.560318290748608,222,22,200,18.77573498601868,9,1023,0.0,12
2020-12-18 22:00:00+01:00,146,14,132,20.98788244482569,154,13,141,23.457384968254527,9,1023,0.0,12
2020-12-18 23:00:00+01:00,104,11,93,11.935148455597123,109,12,97,14.645038576883659,9,1023,0.0,12
2020-12-19 00:00:00+01:00,51,3,48,13.024781207847502,56,3,53,11.681432660358455,10,1014,0.0,16
2020-12-19 01:00:00+01:00,34,2,32,4.1719622498891535,37,2,35,3.5125252112896685,10,1014,0.0,16
2020-12-19 02:00:00+01:00,35,2,33,5.369702870779087,35,2,33,5.369702870779087,10,1014,0.0,16
2020-12-19 03:00:00+01:00,51,3,48,13.024781207847502,56,3,53,11.681432660358455,10,1014,0.0,16
2020-12-19 04:00:00+01:00,68,4,64,8.84385076442631,74,4,70,9.886934519670994,10,1014,0.0,16
2020-12-19 05:00:00+01:00,90,5,85,10.477669283936715,91,5,86,8.844154374326946,10,1014,0.0,16
2020-12-19 06:00:00+01:00,142,8,134,19.57947604189084,152,9,143,18.686880121910534,10,1014,0.0,16
2020-12-19 07:00:00+01:00,208,12,196,18.807092053665322,225,14,211,16.518156382279376,10,1014,0.0,16
2020-12-19 08:00:00+01:00,296,19,277,18.406113827007673,298,15,283,19.413448672737985,10,1014,0.0,16
2020-12-19 09:00:00+01:00,297,19,278,17.48190242862812,316,20,296,17.068110656006358,10,1014,0.0,16
2020-12-19 10:00:00+01:00,273,18,255,23.139691796211615,281,18,263,18.053311879599764,10,1014,0.0,16
2020-12-19 11:00:00+01:00,208,13,195,18.807092053665322,225,14,211,16.518156382279376,10,1014,0.0,16
2020-12-19 12:00:00+01:00,221,14,207,21.310706623471727,222,11,211,17.594973015311762,10,1014,0.0,16
2020-12-19 13:00:00+01:00,229,15,214,20.858973540615885,244,15,229,18.556057346091794,10,1014,0.0,16
2020-12-19 14:00:00+01:00,215,13,202,14.020699077914754,224,11,213,19.039166559272836,10,1014,0.0,16
2020-12-19 15:00:00+01:00,244,15,229,18.556057346091794,264,15,249,17.866837611646663,10,1014,0.0,16
2020-12-19 16:00:00+01:00,251,14,237,17.440368481170164,264,17,247,17.866837611646663,10,1014,0.0,16
2020-12-19 17:00:00+01:00,287,16,271,13.917461050382924,301,17,284,20.607812327110423,10,1014,0.0,16
2020-12-19 18:00:00+01:00,267,16,251,24.84759596655304,283,14,269,18.945435241048195,10,1014,0.0,16
2020-12-19 19:00:00+01:00,212,12,200,14.709005856097448,225,14,211,16.518156382279376,10,1014,0.0,16
2020-12-19 20:00:00+01:00,202,13,189,21.075229783177793,206,10,196,20.90053052788098,10,1014,0.0,16
2020-12-19 21:00:00+01:00,176,11,165,16.20057962349047,185,9,176,20.88033942284811,10,1014,0.0,16
2020-12-19 22:00:00+01:00,140,8,132,15.157104538016958,152,9,143,18.686880121910534,10,1014,0.0,16
2020-12-19 23:00:00+01:00,68,3,65,8.84385076442631,74,4,70,9.886934519670994,10,1014,0.0,16
2020-12-20 00:00:00+01:00,36,1,35,2.727177547566476,50,1,49,13.833131991765365,9,1017,0.0,12
2020-12-20 01:00:00+01:00,24,0,24,0.16633697306049489,29,1,28,0.5419439371488394,9,1017,0.0,12
2020-12-20 02:00:00+01:00,24,0,24,0.16633697306049489,29,1,28,0.5419439371488394,9,1017,0.0,12
2020-12-20 03:00:00+01:00,36,1,35,2.727177547566476,50,1,49,13.833131991765365,9,1017,0.0,12
2020-12-20 04:00:00+01:00,50,1,49,13.833131991765365,65,2,63,10.13470849860639,9,1017,0.0,12
2020-12-20 05:00:00+01:00,62,2,60,14.019247608895405,79,3,76,13.473204105951462,9,1017,0.0,12
2020-12-20 06:00:00+01:00,93,3,90,7.996959659096201,124,5,119,14.467255533674502,9,1017,0.0,12
2020-12-20 07:00:00+01:00,138,5,133,15.03091255444847,197,7,190,19.118279085736297,9,1017,0.0,12
2020-12-20 08:00:00+01:00,187,7,180,15.611538170802525,267,11,256,24.84759596655304,9,1017,0.0,12
2020-12-20 09:00:00+01:00,209,7,202,16.60419034744366,279,10,269,20.757341864573803,9,1017,0.0,12
2020-12-20 10:00:00+01:00,180,6,174,18.453361889556408,206,7,199,20.90053052788098,9,1017,0.0,12
2020-12-20 11:00:00+01:00,142,5,137,19.57947604189084,201,7,194,21.060930109433922,9,1017,0.0,12
2020-12-20 12:00:00+01:00,156,6,150,17.899214712227696,175,7,168,18.893708159250245,9,1017,0.0,12
2020-12-20 13:00:00+01:00,161,6,155,19.39413115763897,190,7,183,20.182913119811044,9,1017,0.0,12
2020-12-20 14:00:00+01:00,149,5,144,17.937448228249327,163,6,157,16.305265165047643,9,1017,0.0,12
2020-12-20 15:00:00+01:00,182,6,176,16.329362148305133,192,6,186,17.31696395349906,9,1017,0.0,12
2020-12-20 16:00:00+01:00,175,7,168,18.893708159250245,222,9,213,17.594973015311762,9,1017,0.0,12
2020-12-20 17:00:00+01:00,190,8,182,20.182913119811044,253,8,245,17.73107046839405,9,1017,0.0,12
2020-12-20 18:00:00+01:00,189,7,182,20.00253163985096,249,10,239,14.961614479066911,9,1017,0.0,12
2020-12-20 19:00:00+01:00,147,5,142,16.306492316544293,206,8,198,20.90053052788098,9,1017,0.0,12
2020-12-20 20:00:00+01:00,130,5,125,16.267882133132378,154,5,149,19.868163821621103,9,1017,0.0,12
2020-12-20 21:00:00+01:00,114,4,110,16.208309351778738,138,5,133,15.03091255444847,9,1017,0.0,12
2020-12-20 22:00:00+01:00,100,3,97,12.129363492765288,128,5,123,16.268122259148125,9,1017,0.0,12
2020-12-20 23:00:00+01:00,46,1,45,9.91060285131841,55,2,53,10.027044718132117,9,1017,0.0,12
2020-12-21 00:00:00+01:00,69,6,63,19.29595730158091,71,7,64,15.50461576454985,9,1022,0.0,10
2020-12-21 01:00:00+01:00,48,5,43,12.297077384196717,50,5,45,13.688855833793909,9,1022,0.0,10
2020-12-21 02:00:00+01:00,50,4,46,13.688855833793909,50,5,45,13.688855833793909,9,1022,0.0,10
2020-12-21 03:00:00+01:00,75,7,68,14.734681497037354,75,8,67,14.734681497037354,9,1022,0.0,10
2020-12-21 04:00:00+01:00,128,12,116,19.601953989978306,124,12,112,17.53992981591413,9,1022,0.0,10
2020-12-21 05:00:00+01:00,211,22,189,18.759232281731908,221,25,196,20.34114880306217,9,1022,0.0,10
2020-12-21 06:00:00+01:00,269,24,245,17.49919499982951,271,26,245,24.814459053724722,9,1022,0.0,10
2020-12-21 07:00:00+01:00,428,39,389,17.985011931135546,418,41,377,19.740254716385955,9,1022,0.0,10
2020-12-21 08:00:00+01:00,449,48,401,18.601165629732545,442,49,393,20.352399635415985,9,1022,0.0,10
2020-12-21 09:00:00+01:00,290,27,263,18.088844908617002,296,35,261,20.454116986907042,9,1022,0.0,10
2020-12-21 10:00:00+01:00,254,25,229,21.33413531955627,248,31,217,17.312704307039937,9,1022,0.0,10
2020-12-21 11:00:00+01:00,294,30,264,18.98421464015195,298,33,265,18.335119688608,9,1022,0.0,10
2020-12-21 12:00:00+01:00,240,22,218,16.023164601360044,248,27,221,17.312704307039937,9,1022,0.0,10
2020-12-21 13:00:00+01:00,246,25,221,17.57126233227549,246,29,217,17.57126233227549,9,1022,0.0,10
2020-12-21 14:00:00+01:00,244,25,219,17.108671526861457,248,27,221,17.312704307039937,9,1022,0.0,10
2020-12-21 15:00:00+01:00,269,28,241,17.49919499982951,271,26,245,24.814459053724722,9,1022,0.0,10
2020-12-21 16:00:00+01:00,302,27,275,17.71336274061634,290,32,258,18.088844908617002,9,1022,0.0,10
2020-12-21 17:00:00+01:00,417,43,374,23.51661645113794,436,42,394,21.770703310925605,9,1022,0.0,10
2020-12-21 18:00:00+01:00,422,38,384,20.257299015157166,442,55,387,20.352399635415985,9,1022,0.0,10
2020-12-21 19:00:00+01:00,314,29,285,19.381500590217087,321,31,290,23.480156167605287,9,1022,0.0,10
2020-12-21 20:00:00+01:00,333,35,298,26.7685298712925,320,38,282,21.04137400974582,9,1022,0.0,10
2020-12-21 21:00:00+01:00,256,27,229,20.451990100158973,250,24,226,14.642007731534619,9,1022,0.0,10
2020-12-21 22:00:00+01:00,170,17,153,19.775542485132945,178,17,161,19.804789777436813,9,1022,0.0,10
2020-12-21 23:00:00+01:00,120,10,110,16.69246741071004,126,13,113,21.990298593101397,9,1022,0.0,10
2020-12-22 00:00:00+01:00,34,3,31,5.3950651883530085,40,4,36,5.275608835029151,14,1015,0.0,25
2020-12-22 01:00:00+01:00,25,2,23,1.1875344360364632,27,2,25,1.9016023008994223,14,1015,0.0,25
2020-12-22 02:00:00+01:00,25,2,23,1.1875344360364632,27,2,25,1.9016023008994223,14,1015,0.0,25
2020-12-22 03:00:00+01:00,38,3,35,11.101073107969722,40,4,36,5.275608835029151,14,1015,0.0,25
2020-12-22 04:00:00+01:00,62,5,57,14.48690450543278,62,5,57,14.48690450543278,14,1015,0.0,25
2020-12-22 05:00:00+01:00,101,8,93,11.280950715811313,121,12,109,20.317620945183666,14,1015,0.0,25
2020-12-22 06:00:00+01:00,138,11,127,20.21600799483387,138,14,124,20.21600799483387,14,1015,0.0,25
2020-12-22 07:00:00+01:00,192,17,175,21.295822766447603,225,21,204,17.07968654570721,14,1015,0.0,25
2020-12-22 08:00:00+01:00,218,18,200,22.57742359713229,242,27,215,20.990360069331732,14,1015,0.0,25
2020-12-22 09:00:00+01:00,142,13,129,21.623487252479663,164,16,148,22.827361263214527,14,1015,0.0,25
2020-12-22 10:00:00+01:00,129,10,119,17.995114557081255,131,11,120,14.183230975852695,14,1015,0.0,25
2020-12-22 11:00:00+01:00,142,11,131,21.623487252479663,164,16,148,22.827361263214527,14,1015,0.0,25
2020-12-22 12:00:00+01:00,129,10,119,17.995114557081255,131,11,120,14.183230975852695,14,1015,0.0,25
2020-12-22 13:00:00+01:00,119,9,110,22.46945513312648,129,12,117,17.995114557081255,14,1015,0.0,25
2020-12-22 14:00:00+01:00,119,9,110,22.46945513312648,129,12,117,17.995114557081255,14,1015,0.0,25
2020-12-22 15:00:00+01:00,130,10,120,15.65660051079879,144,12,132,22.91915418498221,14,1015,0.0,25
2020-12-22 16:00:00+01:00,139,13,126,18.732486269107348,150,15,135,17.939622434692456,14,1015,0.0,25
2020-12-22 17:00:00+01:00,209,17,192,22.16757043059366,224,19,205,16.30248157536985,14,1015,0.0,25
2020-12-22 18:00:00+01:00,213,17,196,20.488166305452438,246,24,222,17.57126233227549,14,1015,0.0,25
2020-12-22 19:00:00+01:00,153,14,139,14.915022999208679,172,15,157,19.644113972447897,14,1015,0.0,25
2020-12-22 20:00:00+01:00,155,15,140,19.469409355748308,165,18,147,20.56038540292619,14,1015,0.0,25
2020-12-22 21:00:00+01:00,119,11,108,22.46945513312648,129,12,117,17.995114557081255,14,1015,0.0,25
2020-12-22 22:00:00+01:00,83,6,77,18.699193296190067,90,9,81,13.960700117154147,14,1015,0.0,25
2020-12-22 23:00:00+01:00,58,4,54,10.505136369992313,67,7,60,12.5039951599288,14,1015,0.0,25
2020-12-23 00:00:00+01:00,38,4,34,7.590795833711637,34,3,31,11.019687492562438,12,1017,2.2,18
2020-12-23 01:00:00+01:00,25,3,22,4.851536786659508,25,2,23,4.851536786659508,12,1017,2.2,18
2020-12-23 02:00:00+01:00,25,2,23,4.851536786659508,25,2,23,4.851536786659508,12,1017,2.2,18
2020-12-23 03:00:00+01:00,38,4,34,7.590795833711637,34,3,31,11.019687492562438,12,1017,2.2,18
2020-12-23 04:00:00+01:00,63,7,56,13.630126271531418,62,6,56,12.779859753427614,12,1017,2.2,18
2020-12-23 05:00:00+01:00,114,13,101,17.516346710171707,112,12,100,16.537505199847164,12,1017,2.2,18
2020-12-23 06:00:00+01:00,140,19,121,17.88117043007633,141,14,127,16.082921323202,12,1017,2.2,18
2020-12-23 07:00:00+01:00,214,24,190,24.48806340301503,203,19,184,21.5050173548228,12,1017,2.2,18
2020-12-23 08:00:00+01:00,226,28,198,20.105295377891462,220,27,193,18.729640796362187,12,1017,2.2,18
2020-12-23 09:00:00+01:00,153,19,134,18.89706115395996,139,16,123,21.474746575274906,12,1017,2.2,18
2020-12-23 10:00:00+01:00,126,17,109,16.250667590352332,123,13,110,15.262138605096247,12,1017,2.2,18
2020-12-23 11:00:00+01:00,153,18,135,18.89706115395996,139,16,123,21.474746575274906,12,1017,2.2,18
2020-12-23 12:00:00+01:00,126,17,109,16.250667590352332,123,13,110,15.262138605096247,12,1017,2.2,18
2020-12-23 13:00:00+01:00,127,15,112,19.95892802947898,120,14,106,10.291257377501918,12,1017,2.2,18
2020-12-23 14:00:00+01:00,127,16,111,19.95892802947898,120,14,106,10.291257377501918,12,1017,2.2,18
2020-12-23 15:00:00+01:00,140,18,122,17.88117043007633,141,14,127,16.082921323202,12,1017,2.2,18
2020-12-23 16:00:00+01:00,151,17,134,19.198981193831877,149,16,133,18.476483571588744,12,1017,2.2,18
2020-12-23 17:00:00+01:00,217,26,191,20.47500927792046,213,24,189,16.70464389525102,12,1017,2.2,18
2020-12-23 18:00:00+01:00,232,26,206,24.606618615768106,205,22,183,18.29833304368066,12,1017,2.2,18
2020-12-23 19:00:00+01:00,167,22,145,16.493575022686013,154,14,140,25.102227050596255,12,1017,2.2,18
2020-12-23 20:00:00+01:00,167,21,146,16.493575022686013,154,14,140,25.102227050596255,12,1017,2.2,18
2020-12-23 21:00:00+01:00,129,16,113,12.321757402623772,125,13,112,14.698947587184879,12,1017,2.2,18
2020-12-23 22:00:00+01:00,89,11,78,16.127888447212325,79,9,70,16.621554061874914,12,1017,2.2,18
2020-12-23 23:00:00+01:00,63,8,55,13.630126271531418,62,6,56,12.779859753427614,12,1017,2.2,18
2020-12-24 00:00:00+01:00,35,2,33,7.122002820118646,36,5,31,3.0873599992209124,7,1007,0.1,31
2020-12-24 01:00:00+01:00,23,1,22,0.4122417358964417,25,3,22,1.1875344360364632,7,1007,0.1,31
2020-12-24 02:00:00+01:00,25,2,23,1.1875344360364632,25,3,22,1.1875344360364632,7,1007,0.1,31
2020-12-24 03:00:00+01:00,37,3,34,2.066086063070793,38,5,33,11.101073107969722,7,1007,0.1,31
2020-12-24 04:00:00+01:00,59,5,54,10.572210467564378,58,7,51,10.505136369992313,7,1007,0.1,31
2020-12-24 05:00:00+01:00,106,9,97,12.94750706735717,114,18,96,18.09348958441383,7,1007,0.1,31
2020-12-24 06:00:00+01:00,124,11,113,17.53992981591413,129,19,110,17.995114557081255,7,1007,0.1,31
2020-12-24 07:00:00+01:00,195,14,181,23.83440770251287,216,27,189,21.273439412003903,7,1007,0.1,31
2020-12-24 08:00:00+01:00,212,19,193,18.597605283865732,231,33,198,16.702836426900134,7,1007,0.1,31
2020-12-24 09:00:00+01:00,140,10,130,15.331768592489755,140,20,120,15.331768592489755,7,1007,0.1,31
2020-12-24 10:00:00+01:00,109,9,100,14.645038576883659,117,15,102,21.891304075969387,7,1007,0.1,31
2020-12-24 11:00:00+01:00,150,12,138,17.939622434692456,153,18,135,14.915022999208679,7,1007,0.1,31
2020-12-24 12:00:00+01:00,115,8,107,27.52702584121565,121,19,102,20.317620945183666,7,1007,0.1,31
2020-12-24 13:00:00+01:00,122,9,113,20.245567873519157,128,19,109,19.601953989978306,7,1007,0.1,31
2020-12-24 14:00:00+01:00,114,8,106,18.09348958441383,121,19,102,20.317620945183666,7,1007,0.1,31
2020-12-24 15:00:00+01:00,134,10,124,14.701306049248211,135,21,114,21.280002906629502,7,1007,0.1,31
2020-12-24 16:00:00+01:00,149,11,138,20.003285796587473,153,18,135,14.915022999208679,7,1007,0.1,31
2020-12-24 17:00:00+01:00,196,15,181,20.04912381427717,216,27,189,21.273439412003903,7,1007,0.1,31
2020-12-24 18:00:00+01:00,212,19,193,18.597605283865732,231,33,198,16.702836426900134,7,1007,0.1,31
2020-12-24 19:00:00+01:00,152,11,141,20.188330220444417,162,21,141,19.08849102929865,7,1007,0.1,31
2020-12-24 20:00:00+01:00,165,13,152,20.56038540292619,160,24,136,19.89239402952506,7,1007,0.1,31
2020-12-24 21:00:00+01:00,127,10,117,19.116953333289125,117,15,102,21.891304075969387,7,1007,0.1,31
2020-12-24 22:00:00+01:00,87,7,80,17.896548892855574,85,10,75,19.289671453475872,7,1007,0.1,31
2020-12-24 23:00:00+01:00,56,4,52,10.152150256689218,64,8,56,14.414592943793718,7,1007,0.1,31
2020-12-25 00:00:00+01:00,38,3,35,11.101073107969722,38,4,34,11.101073107969722,5,1022,0.1,19
2020-12-25 01:00:00+01:00,25,2,23,1.1875344360364632,25,2,23,1.1875344360364632,5,1022,0.1,19
2020-12-25 02:00:00+01:00,25,2,23,1.1875344360364632,25,2,23,1.1875344360364632,5,1022,0.1,19
2020-12-25 03:00:00+01:00,37,3,34,2.066086063070793,38,4,34,11.101073107969722,5,1022,0.1,19
2020-12-25 04:00:00+01:00,63,6,57,14.929801273937542,58,5,53,10.505136369992313,5,1022,0.1,19
2020-12-25 05:00:00+01:00,113,12,101,20.093188266697116,113,11,102,20.093188266697116,5,1022,0.1,19
2020-12-25 06:00:00+01:00,140,13,127,15.331768592489755,129,13,116,17.995114557081255,5,1022,0.1,19
2020-12-25 07:00:00+01:00,210,19,191,16.3212742992447,212,18,194,18.597605283865732,5,1022,0.1,19
2020-12-25 08:00:00+01:00,228,23,205,15.818609956751573,211,19,192,18.759232281731908,5,1022,0.1,19
2020-12-25 09:00:00+01:00,147,14,133,20.208056467665056,153,13,140,14.915022999208679,5,1022,0.1,19
2020-12-25 10:00:00+01:00,124,11,113,17.53992981591413,117,12,105,21.891304075969387,5,1022,0.1,19
2020-12-25 11:00:00+01:00,153,15,138,14.915022999208679,148,13,135,18.058884943386857,5,1022,0.1,19
2020-12-25 12:00:00+01:00,129,13,116,17.995114557081255,123,10,113,19.074654696202938,5,1022,0.1,19
2020-12-25 13:00:00+01:00,124,12,112,17.53992981591413,117,12,105,21.891304075969387,5,1022,0.1,19
2020-12-25 14:00:00+01:00,128,12,116,19.601953989978306,123,10,113,19.074654696202938,5,1022,0.1,19
2020-12-25 15:00:00+01:00,136,14,122,16.594078125250377,138,14,124,20.21600799483387,5,1022,0.1,19
2020-12-25 16:00:00+01:00,145,14,131,18.85528596371164,154,15,139,23.457384968254527,5,1022,0.1,19
2020-12-25 17:00:00+01:00,207,22,185,21.877297854955202,202,19,183,22.500350864850866,5,1022,0.1,19
2020-12-25 18:00:00+01:00,218,21,197,22.57742359713229,227,25,202,19.269071808142694,5,1022,0.1,19
2020-12-25 19:00:00+01:00,158,15,143,21.67102174389251,159,15,144,17.78748005044877,5,1022,0.1,19
2020-12-25 20:00:00+01:00,160,14,146,19.89239402952506,159,13,146,17.78748005044877,5,1022,0.1,19
2020-12-25 21:00:00+01:00,123,11,112,19.074654696202938,123,12,111,19.074654696202938,5,1022,0.1,19
2020-12-25 22:00:00+01:00,86,8,78,21.204994436842384,85,7,78,19.289671453475872,5,1022,0.1,19
2020-12-25 23:00:00+01:00,61,6,55,12.362973378192347,58,5,53,10.505136369992313,5,1022,0.1,19
2020-12-26 00:00:00+01:00,52,3,49,14.472017643602554,55,3,52,10.027044718132117,4,1030,0.0,10
2020-12-26 01:00:00+01:00,34,2,32,4.1719622498891535,36,2,34,2.727177547566476,4,1030,0.0,10
2020-12-26 02:00:00+01:00,35,2,33,5.369702870779087,35,2,33,5.369702870779087,4,1030,0.0,10
2020-12-26 03:00:00+01:00,51,3,48,13.024781207847502,55,3,52,10.027044718132117,4,1030,0.0,10
2020-12-26 04:00:00+01:00,68,4,64,8.84385076442631,73,4,69,10.015349835153332,4,1030,0.0,10
2020-12-26 05:00:00+01:00,88,5,83,8.437594054986977,90,5,85,10.477669283936715,4,1030,0.0,10
2020-12-26 06:00:00+01:00,137,9,128,15.965917364236809,149,8,141,17.937448228249327,4,1030,0.0,10
2020-12-26 07:00:00+01:00,208,12,196,18.807092053665322,223,14,209,18.802339292525456,4,1030,0.0,10
2020-12-26 08:00:00+01:00,282,18,264,20.995138580232226,295,15,280,14.663901220626496,4,1030,0.0,10
2020-12-26 09:00:00+01:00,295,17,278,14.663901220626496,314,16,298,19.77016372636934,4,1030,0.0,10
2020-12-26 10:00:00+01:00,272,18,254,21.117195423222,278,15,263,19.287262138921047,4,1030,0.0,10
2020-12-26 11:00:00+01:00,210,12,198,17.488096079787415,221,11,210,21.310706623471727,4,1030,0.0,10
2020-12-26 12:00:00+01:00,206,12,194,20.90053052788098,221,13,208,21.310706623471727,4,1030,0.0,10
2020-12-26 13:00:00+01:00,223,13,210,18.802339292525456,241,15,226,17.853279648834448,4,1030,0.0,10
2020-12-26 14:00:00+01:00,206,11,195,20.90053052788098,221,13,208,21.310706623471727,4,1030,0.0,10
2020-12-26 15:00:00+01:00,240,14,226,19.372323114313716,257,12,245,18.99808160477331,4,1030,0.0,10
2020-12-26 16:00:00+01:00,254,15,239,20.69602346457387,261,17,244,17.831444140197515,4,1030,0.0,10
2020-12-26 17:00:00+01:00,289,17,272,18.938144972747136,294,15,279,17.632695676481745,4,1030,0.0,10
2020-12-26 18:00:00+01:00,261,15,246,17.831444140197515,282,15,267,20.995138580232226,4,1030,0.0,10
2020-12-26 19:00:00+01:00,210,12,198,17.488096079787415,221,11,210,21.310706623471727,4,1030,0.0,10
2020-12-26 20:00:00+01:00,189,11,178,20.00253163985096,206,13,193,20.90053052788098,4,1030,0.0,10
2020-12-26 21:00:00+01:00,174,11,163,17.20816352324012,184,9,175,19.759138180971462,4,1030,0.0,10
2020-12-26 22:00:00+01:00,140,8,132,15.157104538016958,150,9,141,19.93003466929675,4,1030,0.0,10
2020-12-26 23:00:00+01:00,69,3,66,11.382640456570568,73,4,69,10.015349835153332,4,1030,0.0,10
2020-12-27 00:00:00+01:00,21,0,21,0.0727095127790566,25,0,25,0.10677168789919293,7,1013,0.0,24
2020-12-27 01:00:00+01:00,14,0,14,0.0,18,0,18,0.014449312499738909,7,1013,0.0,24
2020-12-27 02:00:00+01:00,13,0,13,0.0,18,0,18,0.014449312499738909,7,1013,0.0,24
2020-12-27 03:00:00+01:00,20,0,20,0.04910283862897408,25,0,25,0.10677168789919293,7,1013,0.0,24
2020-12-27 04:00:00+01:00,29,1,28,0.5419439371488394,36,1,35,2.727177547566476,7,1013,0.0,24
2020-12-27 05:00:00+01:00,36,1,35,2.727177547566476,48,1,47,9.964553643509852,7,1013,0.0,24
2020-12-27 06:00:00+01:00,57,2,55,11.247345675463038,74,3,71,9.886934519670994,7,1013,0.0,24
2020-12-27 07:00:00+01:00,87,3,84,9.504121716770046,119,3,116,9.275729661817119,7,1013,0.0,24
2020-12-27 08:00:00+01:00,110,4,106,20.964248322238312,128,4,124,16.268122259148125,7,1013,0.0,24
2020-12-27 09:00:00+01:00,118,4,114,16.65435568776215,166,6,160,16.094287115128708,7,1013,0.0,24
2020-12-27 10:00:00+01:00,106,4,102,19.560878716092326,149,5,144,17.937448228249327,7,1013,0.0,24
2020-12-27 11:00:00+01:00,82,3,79,8.6962433625344,98,3,95,9.366341704429512,7,1013,0.0,24
2020-12-27 12:00:00+01:00,86,3,83,9.565861223121674,119,3,116,9.275729661817119,7,1013,0.0,24
2020-12-27 13:00:00+01:00,89,3,86,10.527801976587284,98,4,94,9.366341704429512,7,1013,0.0,24
2020-12-27 14:00:00+01:00,86,3,83,9.565861223121674,119,3,116,9.275729661817119,7,1013,0.0,24
2020-12-27 15:00:00+01:00,96,4,92,10.792244903732447,127,4,123,18.022773693841014,7,1013,0.0,24
2020-12-27 16:00:00+01:00,97,4,93,12.91170780960746,118,4,114,16.65435568776215,7,1013,0.0,24
2020-12-27 17:00:00+01:00,117,4,113,13.539944397802945,135,5,130,20.27811899595658,7,1013,0.0,24
2020-12-27 18:00:00+01:00,109,4,105,18.214376818550008,139,5,134,19.408576933840735,7,1013,0.0,24
2020-12-27 19:00:00+01:00,89,3,86,10.527801976587284,90,3,87,10.477669283936715,7,1013,0.0,24
2020-12-27 20:00:00+01:00,74,3,71,9.886934519670994,107,4,103,12.742346635562697,7,1013,0.0,24
2020-12-27 21:00:00+01:00,73,2,71,10.015349835153332,86,3,83,9.565861223121674,7,1013,0.0,24
2020-12-27 22:00:00+01:00,59,2,57,11.512224289105106,74,3,71,9.886934519670994,7,1013,0.0,24
2020-12-27 23:00:00+01:00,29,1,28,0.5419439371488394,36,1,35,2.727177547566476,7,1013,0.0,24
2020-12-28 00:00:00+01:00,41,4,37,8.457036189746331,41,4,37,8.457036189746331,5,977,0.0,14
2020-12-28 01:00:00+01:00,27,2,25,1.9016023008994223,27,2,25,1.9016023008994223,5,977,0.0,14
2020-12-28 02:00:00+01:00,25,2,23,1.1875344360364632,27,2,25,1.9016023008994223,5,977,0.0,14
2020-12-28 03:00:00+01:00,39,3,36,6.782457974710225,39,4,35,6.782457974710225,5,977,0.0,14
2020-12-28 04:00:00+01:00,64,6,58,14.414592943793718,70,7,63,13.53852946044019,5,977,0.0,14
2020-12-28 05:00:00+01:00,127,11,116,19.116953333289125,120,12,108,16.69246741071004,5,977,0.0,14
2020-12-28 06:00:00+01:00,155,15,140,19.469409355748308,148,18,130,18.058884943386857,5,977,0.0,14
2020-12-28 07:00:00+01:00,239,21,218,13.74553452780325,238,29,209,16.13336525085207,5,977,0.0,14
2020-12-28 08:00:00+01:00,245,24,221,18.942213831390788,247,29,218,18.30797612224211,5,977,0.0,14
2020-12-28 09:00:00+01:00,156,14,142,23.175119746499636,162,20,142,19.08849102929865,5,977,0.0,14
2020-12-28 10:00:00+01:00,135,12,123,21.280002906629502,141,14,127,21.00935462418931,5,977,0.0,14
2020-12-28 11:00:00+01:00,170,16,154,19.775542485132945,169,16,153,18.567569965901342,5,977,0.0,14
2020-12-28 12:00:00+01:00,137,14,123,18.928795118329443,134,15,119,14.701306049248211,5,977,0.0,14
2020-12-28 13:00:00+01:00,136,14,122,16.594078125250377,138,15,123,20.21600799483387,5,977,0.0,14
2020-12-28 14:00:00+01:00,130,13,117,15.65660051079879,137,13,124,18.928795118329443,5,977,0.0,14
2020-12-28 15:00:00+01:00,142,14,128,21.623487252479663,154,16,138,23.457384968254527,5,977,0.0,14
2020-12-28 16:00:00+01:00,158,17,141,21.67102174389251,164,18,146,22.827361263214527,5,977,0.0,14
2020-12-28 17:00:00+01:00,225,21,204,17.07968654570721,236,23,213,19.106111918840778,5,977,0.0,14
2020-12-28 18:00:00+01:00,248,26,222,17.312704307039937,247,29,218,18.30797612224211,5,977,0.0,14
2020-12-28 19:00:00+01:00,169,15,154,18.567569965901342,179,22,157,19.18236787964663,5,977,0.0,14
2020-12-28 20:00:00+01:00,182,19,163,17.128604685093855,177,17,160,20.028957588616944,5,977,0.0,14
2020-12-28 21:00:00+01:00,141,14,127,21.00935462418931,140,15,125,15.331768592489755,5,977,0.0,14
2020-12-28 22:00:00+01:00,91,9,82,13.154481673544206,95,9,86,11.735389228725284,5,977,0.0,14
2020-12-28 23:00:00+01:00,67,6,61,12.5039951599288,70,7,63,13.53852946044019,5,977,0.0,14
2020-12-29 00:00:00+01:00,37,3,34,2.066086063070793,40,4,36,5.275608835029151,4,977,3.0,12
2020-12-29 01:00:00+01:00,25,2,23,1.1875344360364632,27,2,25,1.9016023008994223,4,977,3.0,12
2020-12-29 02:00:00+01:00,25,2,23,1.1875344360364632,27,2,25,1.9016023008994223,4,977,3.0,12
2020-12-29 03:00:00+01:00,38,3,35,11.101073107969722,40,4,36,5.275608835029151,4,977,3.0,12
2020-12-29 04:00:00+01:00,62,5,57,14.48690450543278,62,5,57,14.48690450543278,4,977,3.0,12
2020-12-29 05:00:00+01:00,101,8,93,11.280950715811313,121,12,109,20.317620945183666,4,977,3.0,12
2020-12-29 06:00:00+01:00,138,11,127,20.21600799483387,138,14,124,20.21600799483387,4,977,3.0,12
2020-12-29 07:00:00+01:00,192,17,175,21.295822766447603,225,21,204,17.07968654570721,4,977,3.0,12
2020-12-29 08:00:00+01:00,218,18,200,22.57742359713229,242,27,215,20.990360069331732,4,977,3.0,12
2020-12-29 09:00:00+01:00,142,13,129,21.623487252479663,164,16,148,22.827361263214527,4,977,3.0,12
2020-12-29 10:00:00+01:00,129,10,119,17.995114557081255,131,11,120,14.183230975852695,4,977,3.0,12
2020-12-29 11:00:00+01:00,142,11,131,21.623487252479663,164,16,148,22.827361263214527,4,977,3.0,12
2020-12-29 12:00:00+01:00,129,10,119,17.995114557081255,131,11,120,14.183230975852695,4,977,3.0,12
2020-12-29 13:00:00+01:00,119,9,110,22.46945513312648,129,12,117,17.995114557081255,4,977,3.0,12
2020-12-29 14:00:00+01:00,119,9,110,22.46945513312648,129,12,117,17.995114557081255,4,977,3.0,12
2020-12-29 15:00:00+01:00,130,10,120,15.65660051079879,144,12,132,22.91915418498221,4,977,3.0,12
2020-12-29 16:00:00+01:00,139,13,126,18.732486269107348,150,15,135,17.939622434692456,4,977,3.0,12
2020-12-29 17:00:00+01:00,209,17,192,22.16757043059366,224,19,205,16.30248157536985,4,977,3.0,12
2020-12-29 18:00:00+01:00,213,17,196,20.488166305452438,246,24,222,17.57126233227549,4,977,3.0,12
2020-12-29 19:00:00+01:00,153,14,139,14.915022999208679,172,15,157,19.644113972447897,4,977,3.0,12
2020-12-29 20:00:00+01:00,155,15,140,19.469409355748308,165,18,147,20.56038540292619,4,977,3.0,12
2020-12-29 21:00:00+01:00,119,11,108,22.46945513312648,129,12,117,17.995114557081255,4,977,3.0,12
2020-12-29 22:00:00+01:00,83,6,77,18.699193296190067,90,9,81,13.960700117154147,4,977,3.0,12
2020-12-29 23:00:00+01:00,58,4,54,10.505136369992313,67,7,60,12.5039951599288,4,977,3.0,12
2020-12-30 00:00:00+01:00,56,7,49,12.708841385488384,55,6,49,10.403440874465877,4,997,0.1,8
2020-12-30 01:00:00+01:00,37,5,32,6.04430554421965,37,4,33,6.04430554421965,4,997,0.1,8
2020-12-30 02:00:00+01:00,37,4,33,6.04430554421965,37,4,33,6.04430554421965,4,997,0.1,8
2020-12-30 03:00:00+01:00,56,7,49,12.708841385488384,55,6,49,10.403440874465877,4,997,0.1,8
2020-12-30 04:00:00+01:00,93,12,81,19.729575953685952,92,11,81,14.440667881435587,4,997,0.1,8
2020-12-30 05:00:00+01:00,171,22,149,19.53129553547978,150,14,136,18.780420376145724,4,997,0.1,8
2020-12-30 06:00:00+01:00,208,25,183,20.206401668793205,187,19,168,11.97608953103999,4,997,0.1,8
2020-12-30 07:00:00+01:00,317,36,281,19.022172849432163,300,31,269,17.719869170359154,4,997,0.1,8
2020-12-30 08:00:00+01:00,340,42,298,16.168500597987954,326,36,290,21.984406154034474,4,997,0.1,8
2020-12-30 09:00:00+01:00,223,29,194,21.50234050401794,217,26,191,20.47500927792046,4,997,0.1,8
2020-12-30 10:00:00+01:00,190,24,166,19.462300258952972,174,16,158,15.22838843742414,4,997,0.1,8
2020-12-30 11:00:00+01:00,229,26,203,20.440115346834332,203,24,179,21.5050173548228,4,997,0.1,8
2020-12-30 12:00:00+01:00,186,23,163,14.511740402245575,181,21,160,22.79969312673797,4,997,0.1,8
2020-12-30 13:00:00+01:00,187,25,162,11.97608953103999,169,16,153,17.772634846256242,4,997,0.1,8
2020-12-30 14:00:00+01:00,186,21,165,14.511740402245575,181,21,160,22.79969312673797,4,997,0.1,8
2020-12-30 15:00:00+01:00,206,27,179,26.316276075539704,187,21,166,11.97608953103999,4,997,0.1,8
2020-12-30 16:00:00+01:00,223,25,198,21.50234050401794,217,26,191,20.47500927792046,4,997,0.1,8
2020-12-30 17:00:00+01:00,324,41,283,25.318103431421573,291,32,259,15.818920682290248,4,997,0.1,8
2020-12-30 18:00:00+01:00,338,40,298,25.380150029874855,309,29,280,20.356115411910114,4,997,0.1,8
2020-12-30 19:00:00+01:00,242,28,214,18.29710618225889,247,30,217,22.66625775717105,4,997,0.1,8
2020-12-30 20:00:00+01:00,244,30,214,19.94485885962816,229,25,204,20.440115346834332,4,997,0.1,8
2020-12-30 21:00:00+01:00,186,24,162,14.511740402245575,181,21,160,22.79969312673797,4,997,0.1,8
2020-12-30 22:00:00+01:00,131,17,114,20.374527680152948,117,13,104,12.235552510813584,4,997,0.1,8
2020-12-30 23:00:00+01:00,92,11,81,14.440667881435587,92,11,81,14.440667881435587,4,997,0.1,8
2020-12-31 00:00:00+01:00,37,3,34,2.066086063070793,38,5,33,11.101073107969722,5,1004,0.0,18
2020-12-31 01:00:00+01:00,23,2,21,0.4122417358964417,25,3,22,1.1875344360364632,5,1004,0.0,18
2020-12-31 02:00:00+01:00,25,2,23,1.1875344360364632,25,3,22,1.1875344360364632,5,1004,0.0,18
2020-12-31 03:00:00+01:00,37,3,34,2.066086063070793,38,5,33,11.101073107969722,5,1004,0.0,18
2020-12-31 04:00:00+01:00,59,5,54,10.572210467564378,58,7,51,10.505136369992313,5,1004,0.0,18
2020-12-31 05:00:00+01:00,106,9,97,12.94750706735717,114,18,96,18.09348958441383,5,1004,0.0,18
2020-12-31 06:00:00+01:00,124,11,113,17.53992981591413,129,19,110,17.995114557081255,5,1004,0.0,18
2020-12-31 07:00:00+01:00,195,14,181,23.83440770251287,216,27,189,21.273439412003903,5,1004,0.0,18
2020-12-31 08:00:00+01:00,212,19,193,18.597605283865732,231,33,198,16.702836426900134,5,1004,0.0,18
2020-12-31 09:00:00+01:00,140,10,130,15.331768592489755,140,20,120,15.331768592489755,5,1004,0.0,18
2020-12-31 10:00:00+01:00,109,9,100,14.645038576883659,117,15,102,21.891304075969387,5,1004,0.0,18
2020-12-31 11:00:00+01:00,150,12,138,17.939622434692456,153,18,135,14.915022999208679,5,1004,0.0,18
2020-12-31 12:00:00+01:00,115,8,107,27.52702584121565,121,19,102,20.317620945183666,5,1004,0.0,18
2020-12-31 13:00:00+01:00,122,9,113,20.245567873519157,128,19,109,19.601953989978306,5,1004,0.0,18
2020-12-31 14:00:00+01:00,114,8,106,18.09348958441383,121,19,102,20.317620945183666,5,1004,0.0,18
2020-12-31 15:00:00+01:00,134,10,124,14.701306049248211,135,21,114,21.280002906629502,5,1004,0.0,18
2020-12-31 16:00:00+01:00,149,11,138,20.003285796587473,153,18,135,14.915022999208679,5,1004,0.0,18
2020-12-31 17:00:00+01:00,196,15,181,20.04912381427717,216,27,189,21.273439412003903,5,1004,0.0,18
2020-12-31 18:00:00+01:00,212,19,193,18.597605283865732,231,33,198,16.702836426900134,5,1004,0.0,18
2020-12-31 19:00:00+01:00,152,11,141,20.188330220444417,162,21,141,19.08849102929865,5,1004,0.0,18
2020-12-31 20:00:00+01:00,165,13,152,20.56038540292619,160,24,136,19.89239402952506,5,1004,0.0,18
2020-12-31 21:00:00+01:00,127,10,117,19.116953333289125,117,15,102,21.891304075969387,5,1004,0.0,18
2020-12-31 22:00:00+01:00,87,7,80,17.896548892855574,85,10,75,19.289671453475872,5,1004,0.0,18
2020-12-31 23:00:00+01:00,56,4,52,10.152150256689218,64,8,56,14.414592943793718,5,1004,0.0,18
